city_name,employed_total,employed_male,employed_female,population,state_code,place_code
"Abanda CDP, Alabama",169,120,49,335,01,00100
"Abbeville city, Alabama",761,713,48,2309,01,00124
"Adamsville city, Alabama",1983,1847,136,4325,01,00460
"Addison town, Alabama",368,365,3,665,01,00484
"Akron town, Alabama",141,138,3,310,01,00676
"Alabaster city, Alabama",17829,17292,537,33417,01,00820
"Albertville city, Alabama",9636,9054,582,22433,01,00988
"Alexander City city, Alabama",5806,5332,474,14788,01,01132
"Alexandria CDP, Alabama",1864,1848,16,3748,01,01180
"Aliceville city, Alabama",942,794,148,2325,01,01228
"Allgood town, Alabama",490,353,137,953,01,01396
"Altoona town, Alabama",683,660,23,1358,01,01660
"Andalusia city, Alabama",3803,3551,252,8841,01,01708
"Anderson town, Alabama",99,92,7,241,01,01756
"Anniston city, Alabama",9015,8515,500,21502,01,01852
"Arab city, Alabama",3896,3778,118,8552,01,02116
"Ardmore town, Alabama",584,574,10,1304,01,02260
"Argo town, Alabama",2450,2441,9,4416,01,02320
"Ariton town, Alabama",326,290,36,795,01,02428
"Arley town, Alabama",221,221,0,569,01,02500
"Ashford town, Alabama",1007,969,38,2476,01,02836
"Ashland town, Alabama",608,554,54,1674,01,02860
"Ashville city, Alabama",1115,1107,8,2438,01,02908
"Athens city, Alabama",12322,11795,527,26179,01,02956
"Atmore city, Alabama",2344,2150,194,8465,01,03004
"Attalla city, Alabama",2748,2678,70,5849,01,03028
"Auburn city, Alabama",37723,36585,1138,76660,01,03076
"Autaugaville town, Alabama",409,376,33,1047,01,03220
"Avon town, Alabama",211,201,10,450,01,03364
"Axis CDP, Alabama",164,104,60,269,01,03508
"Babbie town, Alabama",273,273,0,575,01,03556
"Baileyton town, Alabama",471,459,12,982,01,03676
"Bakerhill town, Alabama",113,111,2,245,01,03724
"Ballplay CDP, Alabama",598,521,77,1181,01,03820
"Banks town, Alabama",180,152,28,302,01,03940
"Bay Minette city, Alabama",3449,3138,311,8159,01,04660
"Bayou La Batre city, Alabama",864,843,21,2215,01,04684
"Bear Creek town, Alabama",614,534,80,1549,01,04852
"Beatrice town, Alabama",26,19,7,175,01,04900
"Beaverton town, Alabama",62,48,14,187,01,04948
"Belgreen CDP, Alabama",30,30,0,30,01,05140
"Belk town, Alabama",148,106,42,347,01,05164
"Bellamy CDP, Alabama",27,27,0,113,01,05188
"Belle Fontaine CDP, Alabama",310,240,70,699,01,05212
"Benton town, Alabama",17,17,0,27,01,05692
"Berlin town, Alabama",261,254,7,532,01,05812
"Berry town, Alabama",373,355,18,983,01,05932
"Bessemer city, Alabama",10420,9299,1121,25890,01,05980
"Billingsley town, Alabama",29,23,6,64,01,06460
"Birmingham city, Alabama",95629,88455,7174,200431,01,07000
"Black town, Alabama",207,205,2,423,01,07120
"Blountsville town, Alabama",776,755,21,1837,01,07456
"Blue Ridge CDP, Alabama",530,520,10,1282,01,07588
"Blue Springs town, Alabama",47,44,3,106,01,07672
"Boaz city, Alabama",4414,4326,88,10248,01,07912
"Boligee town, Alabama",96,47,49,271,01,08104
"Bon Air town, Alabama",13,13,0,58,01,08248
"Bon Secour CDP, Alabama",1777,1666,111,2791,01,08272
"Boykin CDP, Alabama",108,108,0,305,01,08680
"Brantley town, Alabama",264,260,4,927,01,09016
"Brantleyville CDP, Alabama",317,277,40,716,01,09064
"Brent city, Alabama",442,406,36,2994,01,09136
"Brewton city, Alabama",2240,2127,113,5257,01,09208
"Bridgeport city, Alabama",881,811,70,2366,01,09328
"Brighton city, Alabama",1259,1103,156,2983,01,09400
"Brilliant town, Alabama",427,361,66,1145,01,09424
"Bristow Cove CDP, Alabama",33,33,0,219,01,09457
"Brook Highland CDP, Alabama",5223,5161,62,8008,01,09500
"Brookside town, Alabama",539,504,35,1157,01,09736
"Brookwood town, Alabama",1385,1364,21,2420,01,09808
"Broomtown CDP, Alabama",97,70,27,211,01,09880
"Brundidge city, Alabama",779,700,79,2309,01,10240
"Bucks CDP, Alabama",0,0,0,20,01,10456
"Butler town, Alabama",963,952,11,2428,01,11032
"Calera city, Alabama",9412,9314,98,16644,01,11416
"Calvert CDP, Alabama",0,0,0,70,01,11488
"Camden city, Alabama",787,695,92,2149,01,11512
"Camp Hill town, Alabama",308,241,67,1321,01,11680
"Carbon Hill city, Alabama",617,597,20,1472,01,12016
"Cardiff town, Alabama",14,14,0,26,01,12040
"Carlisle-Rockledge CDP, Alabama",1129,1062,67,2232,01,12070
"Carlton CDP, Alabama",12,12,0,57,01,12112
"Carolina town, Alabama",121,121,0,279,01,12160
"Carrollton town, Alabama",437,400,37,1043,01,12304
"Castleberry town, Alabama",152,130,22,350,01,12496
"Catherine CDP, Alabama",0,0,0,0,01,12544
"Cedar Bluff town, Alabama",583,524,59,1672,01,12760
"Center Point city, Alabama",7505,6757,748,16279,01,13264
"Centre city, Alabama",1393,1289,104,3609,01,13648
"Centreville city, Alabama",1214,1170,44,2782,01,13672
"Chatom town, Alabama",248,240,8,702,01,14008
"Chelsea city, Alabama",7470,7166,304,15201,01,14104
"Cherokee town, Alabama",322,298,24,890,01,14152
"Chickasaw city, Alabama",2860,2726,134,6398,01,14392
"Childersburg city, Alabama",2069,1899,170,4743,01,14464
"Choccolocco CDP, Alabama",1028,1028,0,2776,01,14728
"Chunchula CDP, Alabama",39,39,0,152,01,14968
"Citronelle city, Alabama",1648,1553,95,3930,01,15064
"Clanton city, Alabama",3596,3381,215,8776,01,15136
"Clay city, Alabama",5090,4966,124,10315,01,15256
"Clayhatchee town, Alabama",195,184,11,427,01,15304
"Clayton town, Alabama",322,310,12,2230,01,15376
"Cleveland town, Alabama",625,586,39,1252,01,15472
"Clio city, Alabama",450,426,24,1415,01,15640
"Coaling town, Alabama",1220,1074,146,2203,01,16000
"Coats Bend CDP, Alabama",642,627,15,1353,01,16080
"Coffee Springs town, Alabama",93,93,0,196,01,16240
"Coffeeville town, Alabama",79,37,42,216,01,16264
"Coker town, Alabama",445,445,0,1006,01,16312
"Collinsville town, Alabama",742,732,10,2036,01,16600
"Colony town, Alabama",132,122,10,257,01,16684
"Columbia town, Alabama",326,309,17,805,01,16744
"Columbiana city, Alabama",1813,1797,16,4552,01,16768
"Concord CDP, Alabama",917,894,23,1698,01,16936
"Coosada town, Alabama",551,526,25,1088,01,17176
"Cordova city, Alabama",626,596,30,1971,01,17368
"Cottondale CDP, Alabama",1496,1416,80,3211,01,17704
"Cottonwood town, Alabama",459,451,8,1244,01,17824
"County Line town, Alabama",161,161,0,278,01,17968
"Courtland town, Alabama",198,193,5,769,01,18040
"Cowarts town, Alabama",880,853,27,2174,01,18088
"Creola city, Alabama",948,882,66,2428,01,18304
"Crossville town, Alabama",860,843,17,2043,01,18856
"Cuba town, Alabama",140,138,2,327,01,18952
"Cullman city, Alabama",8842,8610,232,18434,01,18976
"Cullomburg CDP, Alabama",60,53,7,238,01,19024
"Cusseta town, Alabama",81,81,0,140,01,19216
"Dadeville city, Alabama",1202,867,335,3062,01,19336
"Daleville city, Alabama",2391,2229,162,4901,01,19360
"Daphne city, Alabama",13488,13114,374,27861,01,19648
"Dauphin Island town, Alabama",774,656,118,1793,01,19744
"Daviston town, Alabama",94,94,0,245,01,19816
"Dayton town, Alabama",24,17,7,67,01,19912
"Deatsville town, Alabama",1328,1260,68,2514,01,20008
"Decatur city, Alabama",26976,25610,1366,57525,01,20104
"Deer Park CDP, Alabama",42,42,0,83,01,20152
"Delta CDP, Alabama",59,59,0,130,01,20272
"Demopolis city, Alabama",3331,3331,0,7080,01,20296
"Detroit town, Alabama",105,92,13,300,01,20392
"Dodge City town, Alabama",210,210,0,527,01,20955
"Dora city, Alabama",1011,935,76,2718,01,21136
"Dothan city, Alabama",31990,30351,1639,70699,01,21184
"Double Springs town, Alabama",535,473,62,1361,01,21280
"Douglas town, Alabama",373,364,9,1001,01,21328
"Dozier town, Alabama",169,169,0,502,01,21448
"Dunnavant CDP, Alabama",690,690,0,1134,01,21890
"Dutton town, Alabama",197,189,8,451,01,21952
"Eagle Point CDP, Alabama",1337,1308,29,2746,01,22088
"East Brewton city, Alabama",1501,1105,396,3215,01,22216
"East Point CDP, Alabama",170,165,5,339,01,22504
"Eclectic town, Alabama",526,483,43,1108,01,22816
"Edgewater CDP, Alabama",347,321,26,793,01,23032
"Edwardsville town, Alabama",97,93,4,225,01,23176
"Egypt CDP, Alabama",493,462,31,1282,01,23224
"Elba city, Alabama",1300,1155,145,3463,01,23296
"Elberta town, Alabama",1113,1066,47,2140,01,23320
"Eldridge town, Alabama",32,31,1,93,01,23344
"Elkmont town, Alabama",168,166,2,321,01,23488
"Elmore town, Alabama",801,706,95,1573,01,23656
"Emelle town, Alabama",27,27,0,74,01,23872
"Emerald Mountain CDP, Alabama",1975,1937,38,3569,01,23880
"Enterprise city, Alabama",11426,10961,465,28513,01,24184
"Epes town, Alabama",187,152,35,579,01,24256
"Equality CDP, Alabama",41,41,0,107,01,24280
"Ethelsville town, Alabama",61,59,2,85,01,24472
"Eufaula city, Alabama",4973,4713,260,12746,01,24568
"Eunola CDP, Alabama",76,76,0,129,01,24616
"Eutaw town, Alabama",957,957,0,2890,01,24664
"Eva town, Alabama",368,367,1,733,01,24688
"Evergreen city, Alabama",1053,984,69,3497,01,24808
"Excel town, Alabama",174,174,0,473,01,24880
"Fairfield city, Alabama",4304,3948,356,9975,01,25120
"Fairford CDP, Alabama",99,99,0,187,01,25216
"Fairhope city, Alabama",9348,8922,426,22605,01,25240
"Fairview town, Alabama",255,226,29,681,01,25384
"Falkville town, Alabama",560,536,24,1422,01,25648
"Faunsdale town, Alabama",55,55,0,136,01,25816
"Fayette city, Alabama",1658,1383,275,4266,01,25840
"Fayetteville CDP, Alabama",560,560,0,1222,01,25864
"Fitzpatrick CDP, Alabama",0,0,0,0,01,26152
"Five Points town, Alabama",58,56,2,155,01,26200
"Flomaton town, Alabama",640,581,59,1606,01,26824
"Florala town, Alabama",627,611,16,1745,01,26848
"Florence city, Alabama",18820,17752,1068,40781,01,26896
"Foley city, Alabama",8865,8435,430,21113,01,26992
"Forestdale CDP, Alabama",5050,4627,423,9138,01,27088
"Forkland town, Alabama",205,191,14,995,01,27376
"Fort Deposit town, Alabama",594,460,134,1734,01,27520
"Fort Payne city, Alabama",6370,5979,391,14815,01,27616
"Fort Rucker CDP, Alabama",690,579,111,5422,01,27640
"Franklin town, Alabama",420,329,91,773,01,28024
"Fredonia CDP, Alabama",48,48,0,232,01,28120
"Frisco City town, Alabama",587,475,112,1656,01,28312
"Fruitdale CDP, Alabama",28,28,0,121,01,28408
"Fruithurst town, Alabama",90,90,0,426,01,28432
"Fulton town, Alabama",194,185,9,437,01,28504
"Fultondale city, Alabama",5079,4942,137,9756,01,28552
"Fyffe town, Alabama",476,449,27,1232,01,28672
"Gadsden city, Alabama",15219,13874,1345,33881,01,28696
"Gainesville town, Alabama",99,99,0,276,01,28768
"Gallant CDP, Alabama",362,347,15,1111,01,28816
"Gantt town, Alabama",125,123,2,222,01,28936
"Garden City town, Alabama",223,212,11,598,01,29032
"Gardendale city, Alabama",7961,7817,144,16051,01,29056
"Gaylesville town, Alabama",71,62,9,164,01,29296
"Geiger town, Alabama",116,99,17,286,01,29392
"Geneva city, Alabama",1748,1602,146,4235,01,29464
"Georgiana town, Alabama",409,385,24,1423,01,29560
"Geraldine town, Alabama",484,474,10,1122,01,29608
"Gilbertown town, Alabama",380,355,25,809,01,29704
"Glen Allen town, Alabama",189,183,6,396,01,29944
"Glencoe city, Alabama",2523,2486,37,5343,01,29992
"Glenwood town, Alabama",80,80,0,197,01,30160
"Goldville town, Alabama",37,37,0,79,01,30448
"Good Hope city, Alabama",1174,1138,36,2502,01,30496
"Goodwater town, Alabama",310,301,9,1117,01,30640
"Gordo town, Alabama",982,937,45,1874,01,30736
"Gordon town, Alabama",157,121,36,356,01,30760
"Gordonville town, Alabama",123,119,4,287,01,30808
"Goshen town, Alabama",192,182,10,447,01,30880
"Graham CDP, Alabama",28,28,0,66,01,31000
"Grand Bay CDP, Alabama",1808,1729,79,3607,01,31024
"Grant town, Alabama",691,676,15,1667,01,31096
"Grayson Valley CDP, Alabama",2906,2723,183,5696,01,31348
"Graysville city, Alabama",1380,1254,126,2700,01,31384
"Greensboro city, Alabama",969,875,94,2417,01,31720
"Greenville city, Alabama",3068,2836,232,7326,01,31912
"Grimes town, Alabama",297,242,55,529,01,32056
"Grove Hill town, Alabama",852,741,111,1995,01,32080
"Guin city, Alabama",1210,1030,180,2636,01,32224
"Gulfcrest CDP, Alabama",0,0,0,58,01,32248
"Gulf Shores city, Alabama",8154,7958,196,15178,01,32272
"Guntersville city, Alabama",3387,3261,126,8644,01,32416
"Gurley town, Alabama",238,231,7,580,01,32440
"Gu-Win town, Alabama",73,71,2,134,01,32536
"Hackleburg town, Alabama",567,528,39,1463,01,32560
"Hackneyville CDP, Alabama",177,154,23,594,01,32584
"Haleburg town, Alabama",66,61,5,157,01,32656
"Haleyville city, Alabama",1931,1817,114,4339,01,32704
"Hamilton city, Alabama",2546,2370,176,6880,01,32848
"Hammondville town, Alabama",170,164,6,409,01,32896
"Hanceville city, Alabama",1419,1303,116,3216,01,32968
"Hanover CDP, Alabama",143,143,0,195,01,33064
"Harpersville town, Alabama",742,702,40,1654,01,33256
"Hartford city, Alabama",1042,1036,6,2660,01,33424
"Hartselle city, Alabama",7278,6993,285,15414,01,33448
"Harvest CDP, Alabama",2844,2761,83,6328,01,33472
"Hatton CDP, Alabama",148,148,0,336,01,33544
"Hayden town, Alabama",642,628,14,1579,01,33640
"Hayneville town, Alabama",349,314,35,900,01,33712
"Hazel Green CDP, Alabama",1996,1769,227,3971,01,33808
"Headland city, Alabama",2774,2664,110,5027,01,33856
"Heath town, Alabama",102,91,11,264,01,33904
"Heflin city, Alabama",1165,1118,47,3440,01,33976
"Helena city, Alabama",11237,10997,240,21036,01,34024
"Henagar city, Alabama",1097,998,99,2559,01,34096
"Highland Lake town, Alabama",174,166,8,444,01,34480
"Highland Lakes CDP, Alabama",3163,3074,89,5628,01,34490
"Hillsboro town, Alabama",346,332,14,559,01,34816
"Hissop CDP, Alabama",65,65,0,121,01,34984
"Hobson CDP, Alabama",120,95,25,132,01,35130
"Hobson City town, Alabama",474,453,21,978,01,35152
"Hodges town, Alabama",133,124,9,315,01,35200
"Hokes Bluff city, Alabama",2519,2414,105,4449,01,35392
"Hollins CDP, Alabama",68,68,0,421,01,35512
"Hollis Crossroads CDP, Alabama",239,239,0,607,01,35536
"Holly Pond town, Alabama",319,313,6,761,01,35560
"Hollywood town, Alabama",438,430,8,967,01,35632
"Holt CDP, Alabama",1600,1455,145,3665,01,35704
"Holtville CDP, Alabama",2025,1941,84,4986,01,35752
"Homewood city, Alabama",14547,14256,291,27557,01,35800
"Hoover city, Alabama",49365,47464,1901,91995,01,35896
"Horn Hill town, Alabama",146,142,4,251,01,36088
"Hueytown city, Alabama",8011,7389,622,16655,01,36448
"Huguley CDP, Alabama",1445,1408,37,3020,01,36592
"Huntsville city, Alabama",112027,106869,5158,215025,01,37000
"Hurtsboro town, Alabama",223,222,1,506,01,37096
"Hytop town, Alabama",277,270,7,544,01,37264
"Ider town, Alabama",261,249,12,626,01,37312
"Indian Springs Village city, Alabama",1125,1097,28,2341,01,37465
"Irondale city, Alabama",7416,6724,692,13455,01,37864
"Ivalee CDP, Alabama",240,240,0,688,01,38032
"Jackson city, Alabama",1660,1344,316,4719,01,38152
"Jacksons' Gap town, Alabama",229,188,41,537,01,38248
"Jacksonville city, Alabama",7065,6579,486,14227,01,38272
"Jasper city, Alabama",6230,5898,332,14453,01,38416
"Jemison city, Alabama",1094,1037,57,2671,01,38608
"Joppa CDP, Alabama",219,219,0,378,01,39064
"Kansas town, Alabama",46,46,0,109,01,39280
"Kellyton town, Alabama",91,89,2,179,01,39472
"Kennedy town, Alabama",207,202,5,427,01,39520
"Killen town, Alabama",634,618,16,1344,01,39784
"Kimberly city, Alabama",2192,2176,16,4045,01,39856
"Kinsey town, Alabama",1180,1126,54,2254,01,40072
"Kinston town, Alabama",375,298,77,797,01,40096
"Ladonia CDP, Alabama",1518,1503,15,4025,01,40648
"La Fayette city, Alabama",926,892,34,2700,01,40672
"Lakeview town, Alabama",27,27,0,91,01,40888
"Lake View town, Alabama",1898,1819,79,3611,01,40928
"Lanett city, Alabama",3024,2856,168,6880,01,41296
"Langston town, Alabama",108,93,15,240,01,41368
"Leeds city, Alabama",6331,6245,86,12292,01,41968
"Leesburg town, Alabama",432,410,22,756,01,42016
"Leighton town, Alabama",305,295,10,734,01,42160
"Leroy CDP, Alabama",420,386,34,1061,01,42304
"Lester town, Alabama",66,60,6,141,01,42352
"Level Plains town, Alabama",942,914,28,1889,01,42472
"Lexington town, Alabama",352,339,13,806,01,42640
"Libertyville town, Alabama",59,59,0,111,01,42808
"Lillian CDP, Alabama",821,821,0,1946,01,42928
"Lincoln city, Alabama",3515,3255,260,6968,01,43120
"Linden city, Alabama",823,757,66,2070,01,43240
"Lineville city, Alabama",1011,938,73,2733,01,43264
"Lipscomb city, Alabama",1221,1162,59,2390,01,43336
"Lisman town, Alabama",134,133,1,453,01,43384
"Littleville town, Alabama",351,343,8,821,01,43648
"Livingston city, Alabama",1444,1283,161,3297,01,43720
"Loachapoka town, Alabama",135,127,8,227,01,43744
"Lockhart town, Alabama",113,98,15,313,01,43816
"Locust Fork town, Alabama",522,494,28,1316,01,43888
"Lookout Mountain CDP, Alabama",353,353,0,1287,01,44160
"Louisville town, Alabama",350,338,12,612,01,44344
"Lowndesboro town, Alabama",51,51,0,92,01,44536
"Loxley town, Alabama",1859,1840,19,3757,01,44608
"Luverne city, Alabama",1072,1003,69,2728,01,44728
"Lynn town, Alabama",299,289,10,908,01,44800
"McCalla CDP, Alabama",7160,6907,253,14509,01,45040
"McDonald Chapel CDP, Alabama",389,262,127,686,01,45208
"Macedonia CDP, Alabama",141,116,25,215,01,45316
"McIntosh town, Alabama",110,106,4,315,01,45472
"McKenzie town, Alabama",244,238,6,711,01,45496
"McMullen town, Alabama",2,0,2,17,01,45640
"Madison city, Alabama",28081,27242,839,56967,01,45784
"Madrid town, Alabama",110,110,0,259,01,45904
"Magnolia Springs town, Alabama",620,606,14,1325,01,46072
"Malcolm CDP, Alabama",0,0,0,44,01,46192
"Malvern town, Alabama",857,838,19,1926,01,46264
"Maplesville town, Alabama",348,342,6,812,01,46504
"Marbury CDP, Alabama",949,923,26,2126,01,46600
"Margaret town, Alabama",2599,2510,89,5294,01,46696
"Marion city, Alabama",895,728,167,3128,01,46768
"Maytown town, Alabama",109,104,5,287,01,47728
"Meadowbrook CDP, Alabama",5429,5314,115,9338,01,47740
"Megargel CDP, Alabama",0,0,0,6,01,47848
"Memphis town, Alabama",11,11,0,23,01,48052
"Mentone town, Alabama",108,106,2,342,01,48064
"Meridianville CDP, Alabama",5049,4684,365,9528,01,48112
"Midfield city, Alabama",2257,2104,153,5159,01,48376
"Midland City town, Alabama",898,882,16,1823,01,48400
"Midway town, Alabama",243,204,39,507,01,48424
"Mignon CDP, Alabama",293,285,8,681,01,48616
"Millbrook city, Alabama",7979,7619,360,16631,01,48712
"Millerville CDP, Alabama",174,174,0,473,01,48784
"Millport town, Alabama",597,588,9,1288,01,48808
"Millry town, Alabama",169,160,9,563,01,48832
"Minor CDP, Alabama",408,359,49,965,01,49072
"Mobile city, Alabama",87168,81489,5679,186316,01,50000
"Monroeville city, Alabama",2140,1829,311,5917,01,50192
"Montevallo city, Alabama",3777,3344,433,7288,01,50312
"Montgomery city, Alabama",92264,85621,6643,199819,01,51000
"Moody city, Alabama",6441,6189,252,13235,01,51096
"Moores Mill CDP, Alabama",3223,3132,91,6007,01,51216
"Mooresville town, Alabama",35,35,0,93,01,51264
"Morris town, Alabama",1167,1117,50,2273,01,51456
"Morrison Crossroads CDP, Alabama",95,95,0,169,01,51469
"Mosses town, Alabama",245,225,20,789,01,51520
"Moulton city, Alabama",1324,1212,112,3392,01,51600
"Moundville town, Alabama",1549,1518,31,3173,01,51648
"Mountain Brook city, Alabama",9987,9897,90,22259,01,51696
"Mount Olive CDP (Coosa County), Alabama",147,147,0,331,01,52320
"Mount Olive CDP (Jefferson County), Alabama",2062,2045,17,4224,01,52344
"Mount Vernon town, Alabama",610,605,5,1463,01,52608
"Movico CDP, Alabama",0,0,0,47,01,52680
"Mulga town, Alabama",333,324,9,720,01,52776
"Munford town, Alabama",848,785,63,1743,01,52848
"Muscle Shoals city, Alabama",8356,8089,267,16334,01,53016
"Myrtlewood town, Alabama",65,62,3,107,01,53112
"Nanafalia CDP, Alabama",13,13,0,23,01,53208
"Nances Creek CDP, Alabama",255,232,23,459,01,53232
"Napier Field town, Alabama",202,184,18,430,01,53256
"Natural Bridge town, Alabama",15,15,0,21,01,53376
"Nauvoo town, Alabama",53,51,2,168,01,53400
"Nectar town, Alabama",200,181,19,476,01,53448
"Needham town, Alabama",51,51,0,89,01,53472
"Newbern town, Alabama",144,117,27,310,01,53784
"New Brockton town, Alabama",543,520,23,1282,01,53856
"New Hope city, Alabama",1408,1297,111,2875,01,54168
"New Market CDP, Alabama",605,594,11,1095,01,54312
"New Site town, Alabama",303,293,10,746,01,54432
"Newton town, Alabama",571,548,23,1528,01,54480
"New Union CDP, Alabama",360,360,0,811,01,54582
"Newville town, Alabama",161,146,15,503,01,54600
"Nixburg CDP, Alabama",149,149,0,410,01,54696
"North Courtland town, Alabama",205,184,21,494,01,55044
"North Johns town, Alabama",48,48,0,144,01,55152
"Northport city, Alabama",16059,15156,903,30714,01,55200
"Notasulga town, Alabama",378,364,14,966,01,55440
"Oak Grove town, Alabama",436,416,20,930,01,55752
"Oak Hill town, Alabama",7,7,0,19,01,55848
"Oakman town, Alabama",265,244,21,898,01,55992
"Odenville city, Alabama",2375,2313,62,4873,01,56400
"Ohatchee town, Alabama",418,404,14,988,01,56472
"Oneonta city, Alabama",2292,2131,161,6925,01,57000
"Onycha town, Alabama",56,56,0,197,01,57024
"Opelika city, Alabama",15033,14272,761,31361,01,57048
"Opp city, Alabama",3078,2892,186,6741,01,57120
"Orange Beach city, Alabama",4331,4141,190,8048,01,57144
"Orrville town, Alabama",46,28,18,151,01,57240
"Our Town CDP, Alabama",471,471,0,738,01,57384
"Owens Cross Roads town, Alabama",1308,1205,103,2567,01,57504
"Oxford city, Alabama",10953,10450,503,22019,01,57576
"Ozark city, Alabama",5487,4933,554,14373,01,57648
"Paint Rock town, Alabama",100,96,4,208,01,57696
"Panola CDP, Alabama",7,7,0,86,01,57912
"Parrish town, Alabama",606,489,117,1433,01,58272
"Pea Ridge CDP, Alabama",307,307,0,807,01,58680
"Pelham city, Alabama",13167,12932,235,24221,01,58848
"Pell City city, Alabama",6984,6466,518,13148,01,58896
"Pennington town, Alabama",202,185,17,628,01,58968
"Penton CDP, Alabama",27,27,0,65,01,59016
"Perdido CDP, Alabama",254,239,15,621,01,59064
"Perdido Beach town, Alabama",200,194,6,464,01,59088
"Peterman CDP, Alabama",8,8,0,31,01,59232
"Petrey town, Alabama",31,31,0,47,01,59328
"Phenix City city, Alabama",17489,16256,1233,38413,01,59472
"Phil Campbell town, Alabama",260,250,10,717,01,59496
"Pickensville town, Alabama",308,295,13,706,01,59592
"Piedmont city, Alabama",2296,2194,102,4761,01,59640
"Pike Road town, Alabama",4962,4875,87,9651,01,59760
"Pinckard town, Alabama",354,351,3,724,01,59832
"Pine Apple town, Alabama",48,48,0,162,01,59880
"Pine Hill town, Alabama",319,313,6,846,01,60240
"Pine Level CDP, Alabama",2048,1957,91,3881,01,60264
"Pine Ridge town, Alabama",319,311,8,635,01,60372
"Pinson city, Alabama",3813,3648,165,7209,01,60648
"Pisgah town, Alabama",414,392,22,1053,01,60720
"Pleasant Grove city, Alabama",5080,4846,234,9549,01,61008
"Pleasant Groves town, Alabama",254,241,13,539,01,61038
"Point Clear CDP, Alabama",429,429,0,1755,01,61488
"Pollard town, Alabama",46,46,0,110,01,61536
"Powell town, Alabama",362,351,11,989,01,62075
"Prattville city, Alabama",18063,17654,409,38124,01,62328
"Priceville town, Alabama",1536,1533,3,3561,01,62472
"Prichard city, Alabama",6782,6068,714,19353,01,62496
"Providence town, Alabama",56,54,2,122,01,62688
"Putnam CDP, Alabama",34,34,0,61,01,62952
"Ragland town, Alabama",520,427,93,1552,01,63216
"Rainbow City city, Alabama",4776,4379,397,10184,01,63288
"Rainsville city, Alabama",2597,2567,30,5545,01,63336
"Ranburne town, Alabama",248,242,6,547,01,63408
"Ray CDP, Alabama",323,249,74,466,01,63495
"Red Bay city, Alabama",1261,1215,46,3210,01,63576
"Redland CDP, Alabama",2679,2644,35,4960,01,63730
"Red Level town, Alabama",263,220,43,476,01,63768
"Redstone Arsenal CDP, Alabama",436,411,25,991,01,63912
"Reece City town, Alabama",318,310,8,711,01,63984
"Reeltown CDP, Alabama",256,222,34,462,01,64040
"Reform town, Alabama",762,735,27,1913,01,64104
"Rehobeth town, Alabama",870,834,36,1896,01,64152
"Remlap CDP, Alabama",1244,1093,151,2555,01,64248
"Repton town, Alabama",107,103,4,289,01,64368
"Ridgeville town, Alabama",70,60,10,155,01,64656
"River Falls town, Alabama",210,145,65,500,01,64776
"Riverside city, Alabama",1191,1128,63,2409,01,64920
"Riverview town, Alabama",49,49,0,197,01,65016
"Roanoke city, Alabama",2255,2179,76,5346,01,65040
"Robertsdale city, Alabama",3354,3304,50,6793,01,65208
"Rock Creek CDP, Alabama",733,705,28,1446,01,65412
"Rockford town, Alabama",214,191,23,845,01,65472
"Rock Mills CDP, Alabama",131,128,3,430,01,65592
"Rockville CDP, Alabama",0,0,0,0,01,65784
"Rogersville town, Alabama",662,639,23,1350,01,66216
"Rosa town, Alabama",277,274,3,763,01,66408
"Russellville city, Alabama",4938,4766,172,10767,01,67056
"Rutledge town, Alabama",101,101,0,237,01,67176
"St. Florian town, Alabama",290,277,13,636,01,67536
"St. Stephens CDP, Alabama",9,9,0,471,01,67584
"Saks CDP, Alabama",4930,4495,435,10523,01,67608
"Samson city, Alabama",590,516,74,1513,01,67800
"Sand Rock town, Alabama",296,282,14,720,01,67920
"Sanford town, Alabama",84,81,3,273,01,68016
"Saraland city, Alabama",7363,7059,304,16109,01,68160
"Sardis City town, Alabama",857,820,37,1941,01,68280
"Satsuma city, Alabama",3326,3129,197,6740,01,68352
"Scottsboro city, Alabama",6516,6268,248,15543,01,68736
"Section town, Alabama",316,305,11,828,01,69000
"Selma city, Alabama",7144,6221,923,17875,01,69120
"Selmont-West Selmont CDP, Alabama",780,757,23,1894,01,69180
"Semmes city, Alabama",2157,2107,50,5123,01,69240
"Sheffield city, Alabama",4172,4012,160,9330,01,69648
"Shelby CDP, Alabama",275,275,0,799,01,69672
"Shiloh town, Alabama",148,146,2,422,01,69840
"Shoal Creek CDP, Alabama",489,474,15,1171,01,69978
"Shorter town, Alabama",84,73,11,344,01,70128
"Silas town, Alabama",151,145,6,387,01,70416
"Silverhill town, Alabama",443,441,2,711,01,70536
"Sims Chapel CDP, Alabama",0,0,0,0,01,70632
"Sipsey town, Alabama",62,62,0,216,01,70704
"Skyline town, Alabama",355,339,16,1114,01,70896
"Slocomb city, Alabama",884,847,37,1860,01,71040
"Smiths Station city, Alabama",2216,2144,72,5441,01,71190
"Smoke Rise CDP, Alabama",798,725,73,1504,01,71201
"Snead town, Alabama",566,556,10,1227,01,71280
"Somerville town, Alabama",299,276,23,671,01,71496
"Southside city, Alabama",4260,4114,146,9358,01,71832
"South Vinemont town, Alabama",368,349,19,865,01,71900
"Spanish Fort city, Alabama",4651,4562,89,10083,01,71976
"Spring Garden CDP, Alabama",29,29,0,140,01,72408
"Springville city, Alabama",2138,2106,32,4824,01,72600
"Spruce Pine CDP, Alabama",64,64,0,109,01,72672
"Standing Rock CDP, Alabama",9,9,0,62,01,72720
"Stapleton CDP, Alabama",1089,1089,0,2392,01,72816
"Steele town, Alabama",680,640,40,1515,01,72888
"Sterrett CDP, Alabama",377,327,50,733,01,73056
"Stevenson city, Alabama",887,826,61,2071,01,73080
"Stewartville CDP, Alabama",757,745,12,1669,01,73152
"Stockton CDP, Alabama",238,238,0,420,01,73272
"Sulligent city, Alabama",391,386,5,1459,01,73728
"Sumiton city, Alabama",1353,1273,80,2516,01,73848
"Summerdale town, Alabama",739,731,8,1497,01,73872
"Susan Moore town, Alabama",662,638,24,1311,01,74160
"Sweet Water town, Alabama",114,103,11,239,01,74304
"Sylacauga city, Alabama",5609,5110,499,12465,01,74352
"Sylvania town, Alabama",999,965,34,1971,01,74400
"Sylvan Springs town, Alabama",633,581,52,1521,01,74424
"Talladega city, Alabama",5567,4773,794,15071,01,74592
"Talladega Springs town, Alabama",75,75,0,184,01,74616
"Tallassee city, Alabama",2423,2216,207,5174,01,74688
"Tarrant city, Alabama",3006,2810,196,6077,01,74976
"Taylor town, Alabama",1269,1224,45,2891,01,75096
"Theodore CDP, Alabama",2349,2269,80,5123,01,75768
"Thomaston town, Alabama",180,172,8,377,01,75936
"Thomasville city, Alabama",1423,1284,139,3656,01,75960
"Thorsby town, Alabama",1022,968,54,2552,01,76080
"Tibbie CDP, Alabama",16,16,0,70,01,76200
"Tidmore Bend CDP, Alabama",473,464,9,1007,01,76208
"Tillmans Corner CDP, Alabama",7941,7064,877,18018,01,76320
"Town Creek town, Alabama",420,386,34,1040,01,76584
"Toxey town, Alabama",68,66,2,165,01,76632
"Trafford town, Alabama",123,118,5,511,01,76680
"Triana town, Alabama",1633,1433,200,3114,01,76824
"Trinity town, Alabama",1315,1283,32,2510,01,76872
"Troy city, Alabama",7921,7642,279,17757,01,76920
"Trussville city, Alabama",13403,13032,371,25621,01,76944
"Tuscaloosa city, Alabama",52037,48515,3522,105797,01,77256
"Tuscumbia city, Alabama",3693,3648,45,9029,01,77280
"Tuskegee city, Alabama",3731,3308,423,9173,01,77304
"Twin town, Alabama",158,151,7,314,01,77352
"Underwood-Petersville CDP, Alabama",1602,1524,78,3077,01,77580
"Union town, Alabama",78,78,0,267,01,77616
"Union Grove town, Alabama",23,23,0,75,01,77784
"Union Springs city, Alabama",1389,1284,105,3341,01,77880
"Uniontown town, Alabama",563,445,118,1754,01,77904
"Uriah CDP, Alabama",147,142,5,397,01,78120
"Valley city, Alabama",5112,4990,122,10442,01,78204
"Valley Grande city, Alabama",1952,1890,62,4147,01,78232
"Valley Head town, Alabama",282,263,19,810,01,78240
"Vance town, Alabama",866,846,20,1646,01,78264
"Vandiver CDP, Alabama",428,399,29,1166,01,78312
"Vernon city, Alabama",674,645,29,1801,01,78480
"Vestavia Hills city, Alabama",19799,19494,305,38600,01,78552
"Vina town, Alabama",120,120,0,389,01,78984
"Vincent town, Alabama",715,598,117,1679,01,79008
"Vinegar Bend CDP, Alabama",74,74,0,241,01,79032
"Vredenburgh town, Alabama",40,19,21,140,01,79272
"Wadley town, Alabama",291,264,27,950,01,79344
"Waldo town, Alabama",133,113,20,294,01,79488
"Walnut Grove town, Alabama",383,379,4,873,01,79728
"Warrior city, Alabama",1027,935,92,3206,01,79944
"Waterloo town, Alabama",25,25,0,104,01,80064
"Waverly town, Alabama",119,117,2,248,01,80256
"Weaver city, Alabama",1458,1402,56,3312,01,80352
"Webb town, Alabama",567,543,24,1395,01,80376
"Wedowee town, Alabama",283,278,5,906,01,80496
"Weogufka CDP, Alabama",155,155,0,397,01,80736
"West Blocton town, Alabama",524,485,39,1561,01,80928
"West End-Cobb Town CDP, Alabama",1540,1284,256,3322,01,81084
"West Jefferson town, Alabama",189,180,9,507,01,81336
"Westover town, Alabama",1174,1145,29,2404,01,81504
"West Point town, Alabama",304,274,30,613,01,81528
"Wetumpka city, Alabama",3051,2885,166,7129,01,81720
"Whatley CDP, Alabama",112,66,46,215,01,81744
"White Hall town, Alabama",287,272,15,752,01,81912
"White Plains CDP, Alabama",331,271,60,815,01,82104
"Whitesboro CDP, Alabama",1001,981,20,2134,01,82176
"Wilsonville town, Alabama",911,746,165,1998,01,82848
"Wilton town, Alabama",329,307,22,685,01,82872
"Winfield city, Alabama",2302,2242,60,4832,01,82992
"Woodland town, Alabama",247,240,7,568,01,83400
"Woodstock town, Alabama",617,535,82,1391,01,83640
"Woodville town, Alabama",439,391,48,1053,01,83664
"Yellow Bluff town, Alabama",42,19,23,140,01,83976
"York city, Alabama",1069,981,88,2423,01,84096
"Adak city, Alaska",196,193,3,248,02,00065
"Akhiok city, Alaska",29,19,10,98,02,00650
"Akiachak CDP, Alaska",107,94,13,415,02,00760
"Akiak city, Alaska",118,87,31,298,02,00870
"Akutan city, Alaska",819,784,35,911,02,01090
"Alakanuk city, Alaska",342,248,94,1138,02,01200
"Alatna CDP, Alaska",21,21,0,36,02,01305
"Alcan Border CDP, Alaska",18,18,0,178,02,01390
"Aleknagik city, Alaska",46,32,14,121,02,01420
"Aleneva CDP, Alaska",0,0,0,0,02,01560
"Allakaket city, Alaska",88,72,16,220,02,01860
"Ambler city, Alaska",88,69,19,277,02,01970
"Anaktuvuk Pass city, Alaska",70,57,13,222,02,02080
"Anchorage municipality, Alaska",150082,142335,7747,290674,02,03000
"Anchor Point CDP, Alaska",898,804,94,2260,02,03110
"Anderson city, Alaska",50,47,3,173,02,03220
"Angoon city, Alaska",186,134,52,419,02,03440
"Aniak city, Alaska",328,304,24,551,02,03550
"Anvik city, Alaska",39,34,5,74,02,03880
"Arctic Village CDP, Alaska",38,36,2,199,02,03990
"Atka city, Alaska",9,9,0,28,02,04210
"Atmautluak CDP, Alaska",11,6,5,34,02,04430
"Atqasuk city, Alaska",50,46,4,119,02,04500
"Attu Station CDP, Alaska",17,17,0,17,02,04670
"Badger CDP, Alaska",9134,8533,601,19182,02,05000
"Bear Creek CDP, Alaska",583,583,0,1283,02,05585
"Beaver CDP, Alaska",51,48,3,87,02,05750
"Beluga CDP, Alaska",2,2,0,4,02,06245
"Bethel city, Alaska",3061,2790,271,6312,02,06520
"Bettles city, Alaska",0,0,0,0,02,06630
"Big Delta CDP, Alaska",243,183,60,545,02,06850
"Big Lake CDP, Alaska",1579,1480,99,3232,02,07070
"Birch Creek CDP, Alaska",3,3,0,3,02,07620
"Brevig Mission city, Alaska",190,151,39,625,02,08740
"Buckland city, Alaska",203,148,55,644,02,09600
"Buffalo Soapstone CDP, Alaska",423,365,58,959,02,09657
"Butte CDP, Alaska",1910,1826,84,3752,02,09710
"Cantwell CDP, Alaska",39,32,7,117,02,10150
"Central CDP, Alaska",33,33,0,105,02,11690
"Chalkyitsik CDP, Alaska",55,52,3,95,02,11800
"Chase CDP, Alaska",0,0,0,26,02,12350
"Chefornak city, Alaska",162,117,45,476,02,12680
"Chena Ridge CDP, Alaska",2999,2815,184,5321,02,12920
"Chenega CDP, Alaska",25,25,0,58,02,12970
"Chevak city, Alaska",245,212,33,432,02,13230
"Chickaloon CDP, Alaska",85,65,20,283,02,13340
"Chicken CDP, Alaska",0,0,0,0,02,13450
"Chignik city, Alaska",28,25,3,54,02,13550
"Chignik Lagoon CDP, Alaska",14,14,0,39,02,13670
"Chignik Lake CDP, Alaska",10,10,0,30,02,13780
"Chiniak CDP, Alaska",0,0,0,0,02,13860
"Chisana CDP, Alaska",0,0,0,0,02,13890
"Chistochina CDP, Alaska",24,24,0,45,02,14000
"Chitina CDP, Alaska",19,19,0,71,02,14110
"Chuathbaluk city, Alaska",40,35,5,92,02,14330
"Circle CDP, Alaska",15,12,3,45,02,14880
"Clam Gulch CDP, Alaska",147,127,20,279,02,15320
"Clark's Point city, Alaska",12,9,3,31,02,15430
"Coffman Cove city, Alaska",87,80,7,201,02,16360
"Cohoe CDP, Alaska",633,562,71,1520,02,16420
"Cold Bay city, Alaska",96,96,0,143,02,16530
"Coldfoot CDP, Alaska",270,270,0,270,02,16630
"College CDP, Alaska",5773,5666,107,12376,02,16750
"Cooper Landing CDP, Alaska",104,104,0,224,02,17190
"Copper Center CDP, Alaska",152,126,26,329,02,17300
"Cordova city, Alaska",1227,1078,149,2507,02,17410
"Covenant Life CDP, Alaska",25,25,0,25,02,17670
"Craig city, Alaska",663,625,38,1073,02,17740
"Crooked Creek CDP, Alaska",13,2,11,28,02,17850
"Crown Point CDP, Alaska",41,28,13,62,02,17960
"Deering city, Alaska",69,53,16,189,02,18510
"Delta Junction city, Alaska",512,491,21,1126,02,18620
"Deltana CDP, Alaska",868,840,28,2059,02,18675
"Denali Park CDP, Alaska",780,780,0,817,02,18805
"Diamond Ridge CDP, Alaska",608,594,14,1397,02,18925
"Dillingham city, Alaska",1160,1078,82,2175,02,18950
"Diomede city, Alaska",19,16,3,47,02,19060
"Dot Lake CDP, Alaska",0,0,0,0,02,19720
"Dot Lake Village CDP, Alaska",0,0,0,0,02,19750
"Dry Creek CDP, Alaska",121,121,0,202,02,20020
"Eagle city, Alaska",42,27,15,99,02,20380
"Eagle Village CDP, Alaska",16,8,8,68,02,20600
"Eareckson Station CDP, Alaska",147,147,0,166,02,20716
"Edna Bay city, Alaska",21,21,0,21,02,20970
"Eek city, Alaska",205,146,59,475,02,21040
"Egegik city, Alaska",46,46,0,46,02,21150
"Eielson AFB CDP, Alaska",620,523,97,3071,02,21370
"Ekwok city, Alaska",14,12,2,51,02,21810
"Elfin Cove CDP, Alaska",12,12,0,16,02,22140
"Elim city, Alaska",108,60,48,293,02,22250
"Emmonak city, Alaska",570,470,100,1293,02,22910
"Ester CDP, Alaska",1649,1592,57,2989,02,23460
"Eureka Roadhouse CDP, Alaska",0,0,0,0,02,23720
"Evansville CDP, Alaska",24,24,0,27,02,23790
"Excursion Inlet CDP, Alaska",47,47,0,62,02,23900
"Fairbanks city, Alaska",13159,12244,915,32496,02,24230
"False Pass city, Alaska",53,53,0,103,02,24660
"Farmers Loop CDP, Alaska",2352,2264,88,4179,02,24980
"Farm Loop CDP, Alaska",1342,1237,105,2561,02,25000
"Ferry CDP, Alaska",0,0,0,26,02,25220
"Fishhook CDP, Alaska",2283,2127,156,5115,02,25550
"Flat CDP, Alaska",0,0,0,0,02,25880
"Fort Greely CDP, Alaska",37,37,0,158,02,26100
"Fort Yukon city, Alaska",208,157,51,476,02,26760
"Four Mile Road CDP, Alaska",5,5,0,5,02,26835
"Fox CDP, Alaska",67,67,0,195,02,26870
"Fox River CDP, Alaska",239,202,37,712,02,26910
"Fritz Creek CDP, Alaska",1078,1036,42,2163,02,27090
"Funny River CDP, Alaska",454,431,23,1072,02,27145
"Gakona CDP, Alaska",46,38,8,155,02,27420
"Galena city, Alaska",361,336,25,627,02,27530
"Gambell city, Alaska",181,124,57,426,02,27640
"Game Creek CDP, Alaska",0,0,0,0,02,27700
"Gateway CDP, Alaska",2980,2821,159,6241,02,28200
"Glacier View CDP, Alaska",99,99,0,216,02,28590
"Glennallen CDP, Alaska",332,314,18,522,02,28740
"Goldstream CDP, Alaska",1944,1867,77,2798,02,29130
"Golovin city, Alaska",97,81,16,185,02,29180
"Goodnews Bay city, Alaska",49,46,3,118,02,29290
"Grayling city, Alaska",92,63,29,210,02,30060
"Gulkana CDP, Alaska",42,33,9,69,02,30500
"Gustavus city, Alaska",473,452,21,710,02,30940
"Haines CDP, Alaska",665,629,36,1762,02,31050
"Halibut Cove CDP, Alaska",64,64,0,211,02,31270
"Happy Valley CDP, Alaska",244,224,20,748,02,31710
"Harding-Birch Lakes CDP, Alaska",104,99,5,285,02,31765
"Healy CDP, Alaska",437,421,16,865,02,32150
"Healy Lake CDP, Alaska",9,9,0,26,02,32310
"Hobart Bay CDP, Alaska",0,0,0,0,02,32550
"Hollis CDP, Alaska",34,34,0,138,02,32810
"Holy Cross city, Alaska",123,108,15,277,02,33030
"Homer city, Alaska",2783,2533,250,5623,02,33140
"Hoonah city, Alaska",533,434,99,896,02,33360
"Hooper Bay city, Alaska",337,250,87,801,02,33470
"Hope CDP, Alaska",71,48,23,133,02,33580
"Houston city, Alaska",794,694,100,1613,02,33800
"Hughes city, Alaska",14,12,2,34,02,33910
"Huslia city, Alaska",72,58,14,182,02,34350
"Hydaburg city, Alaska",150,135,15,328,02,34460
"Hyder CDP, Alaska",16,16,0,16,02,34570
"Igiugig CDP, Alaska",32,30,2,69,02,34790
"Iliamna CDP, Alaska",17,14,3,28,02,35120
"Ivanof Bay CDP, Alaska",0,0,0,0,02,35890
"Juneau city and borough, Alaska",17107,16345,762,32108,02,36400
"Kachemak city, Alaska",335,310,25,787,02,36540
"Kake city, Alaska",203,184,19,473,02,36770
"Kaktovik city, Alaska",89,74,15,201,02,36990
"Kalifornsky CDP, Alaska",4076,3972,104,8380,02,37250
"Kaltag city, Alaska",149,111,38,197,02,37430
"Karluk CDP, Alaska",19,16,3,27,02,37540
"Kasaan city, Alaska",46,44,2,82,02,37650
"Kasigluk CDP, Alaska",123,90,33,389,02,37975
"Kasilof CDP, Alaska",154,113,41,279,02,38090
"Kenai city, Alaska",3775,3451,324,7477,02,38420
"Kenny Lake CDP, Alaska",69,69,0,222,02,38910
"Ketchikan city, Alaska",4345,4125,220,8168,02,38970
"Kiana city, Alaska",152,108,44,422,02,39300
"King Cove city, Alaska",711,662,49,1108,02,39410
"King Salmon CDP, Alaska",218,212,6,383,02,39630
"Kipnuk CDP, Alaska",186,137,49,572,02,39740
"Kivalina city, Alaska",258,200,58,769,02,39960
"Klawock city, Alaska",402,361,41,804,02,40400
"Klukwan CDP, Alaska",29,27,2,67,02,40510
"Knik-Fairview CDP, Alaska",8107,7663,444,18619,02,40645
"Knik River CDP, Alaska",425,415,10,822,02,40670
"Kobuk city, Alaska",33,31,2,133,02,40840
"Kodiak city, Alaska",3073,2926,147,5584,02,40950
"Kodiak Station CDP, Alaska",501,501,0,2113,02,41210
"Kokhanok CDP, Alaska",53,45,8,115,02,41280
"Koliganek CDP, Alaska",73,53,20,234,02,41500
"Kongiganak CDP, Alaska",114,89,25,353,02,41610
"Kotlik city, Alaska",415,322,93,1272,02,41720
"Kotzebue city, Alaska",1520,1433,87,3088,02,41830
"Koyuk city, Alaska",84,70,14,300,02,41940
"Koyukuk city, Alaska",46,41,5,74,02,42050
"Kupreanof city, Alaska",2,2,0,10,02,42160
"Kwethluk city, Alaska",180,152,28,561,02,42380
"Kwigillingok CDP, Alaska",230,183,47,589,02,42490
"Lake Louise CDP, Alaska",0,0,0,0,02,42805
"Lake Minchumina CDP, Alaska",11,11,0,14,02,42820
"Larsen Bay city, Alaska",33,31,2,46,02,43040
"Lazy Mountain CDP, Alaska",815,763,52,1639,02,43260
"Levelock CDP, Alaska",17,12,5,28,02,43810
"Lime Village CDP, Alaska",4,2,2,9,02,44030
"Livengood CDP, Alaska",6,6,0,13,02,44580
"Loring CDP, Alaska",0,0,0,0,02,45020
"Lowell Point CDP, Alaska",0,0,0,0,02,45295
"Lower Kalskag city, Alaska",90,65,25,261,02,45460
"Lutak CDP, Alaska",0,0,0,12,02,45700
"McCarthy CDP, Alaska",2,2,0,2,02,45790
"McGrath city, Alaska",106,87,19,226,02,46010
"Manley Hot Springs CDP, Alaska",14,14,0,17,02,46780
"Manokotak city, Alaska",232,195,37,629,02,46890
"Marshall city, Alaska",75,60,15,215,02,47000
"Meadow Lakes CDP, Alaska",3931,3708,223,8773,02,47735
"Mekoryuk city, Alaska",127,107,20,315,02,47990
"Mendeltna CDP, Alaska",15,15,0,89,02,48200
"Mentasta Lake CDP, Alaska",49,49,0,165,02,48540
"Mertarvik CDP, Alaska",0,0,0,0,02,48590
"Metlakatla CDP, Alaska",684,602,82,1437,02,48870
"Mill Bay CDP, Alaska",1944,1798,146,3617,02,49200
"Minto CDP, Alaska",50,39,11,113,02,49530
"Moose Creek CDP, Alaska",245,244,1,584,02,50080
"Moose Pass CDP, Alaska",177,170,7,199,02,50190
"Mosquito Lake CDP, Alaska",88,88,0,154,02,50800
"Mountain Village city, Alaska",246,209,37,884,02,51180
"Mud Bay CDP, Alaska",15,15,0,62,02,51455
"Nabesna CDP, Alaska",0,0,0,0,02,51960
"Naknek CDP, Alaska",205,199,6,418,02,52060
"Nanwalek CDP, Alaska",71,71,0,172,02,52210
"Napakiak city, Alaska",193,118,75,692,02,52390
"Napaskiak city, Alaska",151,111,40,582,02,52720
"Naukati Bay CDP, Alaska",77,77,0,120,02,52845
"Nelchina CDP, Alaska",46,46,0,135,02,52915
"Nelson Lagoon CDP, Alaska",52,52,0,94,02,52940
"Nenana city, Alaska",163,150,13,508,02,53050
"Newhalen city, Alaska",44,36,8,92,02,53270
"New Stuyahok city, Alaska",276,236,40,603,02,53710
"Newtok CDP, Alaska",39,29,10,96,02,53820
"Nightmute city, Alaska",32,24,8,70,02,53930
"Nikiski CDP, Alaska",1534,1460,74,4405,02,54050
"Nikolaevsk CDP, Alaska",70,61,9,204,02,54085
"Nikolai city, Alaska",57,57,0,87,02,54150
"Nikolski CDP, Alaska",2,2,0,12,02,54260
"Ninilchik CDP, Alaska",352,331,21,964,02,54480
"Noatak CDP, Alaska",197,127,70,536,02,54700
"Nome city, Alaska",2003,1834,169,3710,02,54920
"Nondalton city, Alaska",29,17,12,40,02,55030
"Noorvik city, Alaska",190,126,64,654,02,55140
"North Lakes CDP, Alaska",4525,4208,317,10262,02,55745
"North Pole city, Alaska",1281,1232,49,2816,02,55910
"Northway CDP, Alaska",38,38,0,252,02,56220
"Nuiqsut city, Alaska",251,194,57,564,02,56320
"Nulato city, Alaska",121,99,22,249,02,56350
"Nunam Iqua city, Alaska",18,12,6,59,02,56600
"Nunapitchuk city, Alaska",289,241,48,827,02,56680
"Old Harbor city, Alaska",78,56,22,155,02,57340
"Oscarville CDP, Alaska",34,22,12,88,02,58330
"Ouzinkie city, Alaska",58,46,12,90,02,58550
"Palmer city, Alaska",2846,2572,274,6091,02,58660
"Paxson CDP, Alaska",0,0,0,0,02,59320
"Pedro Bay CDP, Alaska",8,6,2,13,02,59540
"Pelican city, Alaska",42,36,6,57,02,59650
"Perryville CDP, Alaska",38,29,9,85,02,60200
"Petersburg CDP, Alaska",1720,1657,63,3317,02,60310
"Petersville CDP, Alaska",13,13,0,38,02,60460
"Pilot Point city, Alaska",35,35,0,72,02,60640
"Pilot Station city, Alaska",133,105,28,380,02,60750
"Pitkas Point CDP, Alaska",74,57,17,239,02,60860
"Platinum city, Alaska",14,14,0,23,02,61080
"Pleasant Valley CDP, Alaska",316,316,0,623,02,61120
"Point Baker CDP, Alaska",0,0,0,0,02,61190
"Point Hope city, Alaska",197,143,54,649,02,61630
"Point Lay CDP, Alaska",67,62,5,172,02,61700
"Point MacKenzie CDP, Alaska",192,178,14,1707,02,61788
"Point Possession CDP, Alaska",0,0,0,0,02,61825
"Pope-Vannoy Landing CDP, Alaska",0,0,0,0,02,62125
"Portage Creek CDP, Alaska",3,3,0,3,02,62285
"Port Alexander city, Alaska",16,12,4,39,02,62510
"Port Alsworth CDP, Alaska",117,104,13,158,02,62620
"Port Clarence CDP, Alaska",0,0,0,40,02,63170
"Port Graham CDP, Alaska",68,68,0,142,02,63280
"Port Heiden city, Alaska",27,19,8,63,02,63390
"Port Lions city, Alaska",64,59,5,124,02,63610
"Port Protection CDP, Alaska",0,0,0,14,02,63870
"Primrose CDP, Alaska",68,68,0,84,02,64240
"Prudhoe Bay CDP, Alaska",1977,1959,18,1986,02,64380
"Quinhagak city, Alaska",344,257,87,1079,02,64600
"Rampart CDP, Alaska",12,8,4,41,02,64820
"Red Devil CDP, Alaska",6,6,0,6,02,64930
"Red Dog Mine CDP, Alaska",0,0,0,0,02,64980
"Ridgeway CDP, Alaska",1158,1080,78,2749,02,65345
"Ruby city, Alaska",79,79,0,194,02,65590
"Russian Mission city, Alaska",10,10,0,51,02,65700
"St. George city, Alaska",28,28,0,57,02,65800
"St. Mary's city, Alaska",423,330,93,992,02,66140
"St. Michael city, Alaska",111,70,41,308,02,66360
"St. Paul city, Alaska",137,133,4,349,02,66470
"Salamatof CDP, Alaska",424,289,135,1189,02,66510
"Salcha CDP, Alaska",288,288,0,689,02,66550
"Sand Point city, Alaska",680,658,22,1048,02,67020
"Savoonga city, Alaska",286,195,91,823,02,67460
"Saxman city, Alaska",121,104,17,361,02,67570
"Scammon Bay city, Alaska",165,121,44,506,02,67680
"Selawik city, Alaska",136,91,45,557,02,68230
"Seldovia city, Alaska",91,86,5,182,02,68340
"Seldovia Village CDP, Alaska",81,81,0,209,02,68370
"Seward city, Alaska",1145,1090,55,2768,02,68560
"Shageluk city, Alaska",32,32,0,65,02,68670
"Shaktoolik city, Alaska",123,80,43,312,02,68890
"Shishmaref city, Alaska",194,139,55,568,02,69770
"Shungnak city, Alaska",101,79,22,244,02,70100
"Silver Springs CDP, Alaska",67,67,0,106,02,70320
"Sitka city and borough, Alaska",4617,4387,230,8462,02,70540
"Skagway CDP, Alaska",827,733,94,1179,02,70760
"Skwentna CDP, Alaska",17,11,6,63,02,70870
"Slana CDP, Alaska",22,12,10,81,02,70930
"Sleetmute CDP, Alaska",36,30,6,73,02,71090
"Soldotna city, Alaska",2188,2065,123,4394,02,71640
"South Lakes CDP, Alaska",3159,2922,237,6414,02,72135
"South Naknek CDP, Alaska",14,14,0,53,02,72190
"South Van Horn CDP, Alaska",221,208,13,478,02,72230
"Stebbins city, Alaska",266,193,73,654,02,72960
"Steele Creek CDP, Alaska",3641,3540,101,6542,02,72985
"Sterling CDP, Alaska",3112,2784,328,6307,02,73070
"Stevens Village CDP, Alaska",6,3,3,9,02,73290
"Stony River CDP, Alaska",18,15,3,41,02,73400
"Sunrise CDP, Alaska",14,14,0,14,02,73950
"Susitna CDP, Alaska",0,0,0,0,02,74340
"Susitna North CDP, Alaska",703,604,99,1543,02,74350
"Sutton-Alpine CDP, Alaska",402,349,53,1323,02,74525
"Takotna CDP, Alaska",21,21,0,58,02,74610
"Talkeetna CDP, Alaska",567,543,24,1044,02,74830
"Tanacross CDP, Alaska",35,35,0,136,02,75050
"Tanaina CDP, Alaska",4889,4578,311,9682,02,75077
"Tanana city, Alaska",100,93,7,214,02,75160
"Tatitlek CDP, Alaska",15,15,0,40,02,75380
"Tazlina CDP, Alaska",208,201,7,439,02,75480
"Teller city, Alaska",96,86,10,279,02,75930
"Tenakee Springs city, Alaska",75,64,11,136,02,76260
"Tetlin CDP, Alaska",51,39,12,201,02,76590
"Thorne Bay city, Alaska",225,220,5,482,02,77140
"Togiak city, Alaska",287,249,38,842,02,77690
"Tok CDP, Alaska",581,531,50,1352,02,77800
"Toksook Bay city, Alaska",330,268,62,914,02,78240
"Tolsona CDP, Alaska",29,29,0,29,02,78297
"Tonsina CDP, Alaska",16,16,0,16,02,78350
"Trapper Creek CDP, Alaska",142,130,12,303,02,78680
"Tuluksak CDP, Alaska",389,383,6,456,02,78790
"Tuntutuliak CDP, Alaska",391,305,86,820,02,79120
"Tununak CDP, Alaska",201,137,64,450,02,79230
"Twin Hills CDP, Alaska",23,20,3,53,02,79780
"Two Rivers CDP, Alaska",277,277,0,424,02,79830
"Tyonek CDP, Alaska",158,126,32,270,02,79890
"Ugashik CDP, Alaska",0,0,0,0,02,80100
"Unalakleet city, Alaska",426,393,33,743,02,80660
"Unalaska city, Alaska",3133,3030,103,4342,02,80770
"Upper Kalskag city, Alaska",95,70,25,253,02,81320
"Utqiaġvik city, Alaska",2363,2092,271,4876,02,81920
"Valdez city, Alaska",2238,2092,146,3935,02,82200
"Venetie CDP, Alaska",44,41,3,109,02,82420
"Wainwright city, Alaska",323,297,26,621,02,82750
"Wales city, Alaska",116,99,17,294,02,82860
"Wasilla city, Alaska",4087,3690,397,9267,02,83080
"Whale Pass city, Alaska",51,48,3,98,02,84000
"White Mountain city, Alaska",95,70,25,194,02,84070
"Whitestone CDP, Alaska",19,19,0,38,02,84120
"Whitestone Logging Camp CDP, Alaska",0,0,0,0,02,84200
"Whittier city, Alaska",192,167,25,377,02,84510
"Willow CDP, Alaska",680,626,54,1952,02,85280
"Willow Creek CDP, Alaska",48,48,0,123,02,85290
"Wiseman CDP, Alaska",19,19,0,19,02,85610
"Womens Bay CDP, Alaska",629,603,26,1063,02,85680
"Wrangell city and borough, Alaska",844,815,29,2134,02,86380
"Yakutat CDP, Alaska",328,322,6,564,02,86490
"Aguila CDP, Arizona",167,147,20,362,04,00730
"Ajo CDP, Arizona",1191,1102,89,2922,04,00870
"Ak Chin CDP, Arizona",0,0,0,0,04,00940
"Ak-Chin Village CDP, Arizona",455,390,65,1178,04,01090
"Alamo Lake CDP, Arizona",9,9,0,10,04,01170
"Ali Chuk CDP, Arizona",14,14,0,120,04,01560
"Ali Chukson CDP, Arizona",25,25,0,73,04,01570
"Ali Molina CDP, Arizona",12,12,0,88,04,01620
"Alpine CDP, Arizona",17,17,0,141,04,01920
"Amado CDP, Arizona",0,0,0,40,04,01990
"Anegam CDP, Arizona",44,29,15,115,04,02270
"Antares CDP, Arizona",0,0,0,94,04,02410
"Anthem CDP, Arizona",11363,10936,427,22708,04,02430
"Apache Junction city, Arizona",16081,14657,1424,38855,04,02830
"Arivaca CDP, Arizona",246,225,21,524,04,03320
"Arivaca Junction CDP, Arizona",358,332,26,606,04,03380
"Arizona City CDP, Arizona",2998,2880,118,8541,04,03530
"Arizona Village CDP, Arizona",230,215,15,630,04,03915
"Arlington CDP, Arizona",52,52,0,102,04,04020
"Ash Fork CDP, Arizona",136,100,36,466,04,04440
"Avenue B and C CDP, Arizona",1490,1170,320,3850,04,04710
"Avondale city, Arizona",45967,43767,2200,89214,04,04720
"Avra Valley CDP, Arizona",3024,2729,295,6281,04,04880
"Aztec CDP, Arizona",0,0,0,0,04,04930
"Bagdad CDP, Arizona",1095,1095,0,2661,04,05140
"Bear Flat CDP, Arizona",0,0,0,0,04,05450
"Beaver Dam CDP, Arizona",1060,978,82,2013,04,05490
"Beaver Valley CDP, Arizona",42,42,0,133,04,05495
"Bellemont CDP, Arizona",900,900,0,1275,04,05700
"Benson city, Arizona",2283,2104,179,5318,04,05770
"Beyerville CDP, Arizona",35,26,9,61,04,05970
"Bisbee city, Arizona",1736,1661,75,4972,04,06260
"Bitter Springs CDP, Arizona",168,122,46,374,04,06470
"Black Canyon City CDP, Arizona",921,803,118,2408,04,06610
"Blackwater CDP, Arizona",508,477,31,2128,04,06820
"Blue Ridge CDP, Arizona",321,317,4,1073,04,06997
"Bluewater CDP, Arizona",325,318,7,791,04,07025
"Bouse CDP, Arizona",152,146,6,1026,04,07310
"Bowie CDP, Arizona",128,123,5,438,04,07380
"Brenda CDP, Arizona",93,93,0,716,04,07590
"Bryce CDP, Arizona",50,50,0,183,04,07915
"Buckeye city, Arizona",40477,38438,2039,95042,04,07940
"Buckshot CDP, Arizona",0,0,0,7,04,08020
"Bullhead City city, Arizona",17268,15539,1729,41593,04,08220
"Burnside CDP, Arizona",145,145,0,505,04,08535
"Bylas CDP, Arizona",403,354,49,1552,04,08710
"Cactus Flats CDP, Arizona",385,378,7,1238,04,08920
"Cactus Forest CDP, Arizona",177,177,0,588,04,08990
"Cameron CDP, Arizona",346,281,65,780,04,09340
"Campo Bonito CDP, Arizona",45,0,45,91,04,09580
"Camp Verde town, Arizona",4971,4703,268,12132,04,09690
"Cane Beds CDP, Arizona",113,113,0,246,04,09900
"Canyon Day CDP, Arizona",275,239,36,1621,04,10040
"Carefree town, Arizona",1536,1505,31,3671,04,10180
"Carrizo CDP, Arizona",42,37,5,285,04,10320
"Casa Blanca CDP, Arizona",407,372,35,1137,04,10460
"Casa Grande city, Arizona",24688,22999,1689,55186,04,10530
"Casas Adobes CDP, Arizona",36076,34292,1784,69917,04,10670
"Catalina CDP, Arizona",2926,2829,97,6371,04,11160
"Catalina Foothills CDP, Arizona",23705,22773,932,50573,04,11230
"Cave Creek town, Arizona",2301,2198,103,4966,04,11300
"Cedar Creek CDP, Arizona",209,192,17,396,04,11370
"Centennial Park CDP, Arizona",586,550,36,1490,04,11500
"Central CDP, Arizona",224,224,0,375,04,11580
"Central Heights-Midland City CDP, Arizona",947,847,100,2380,04,11720
"Chandler city, Arizona",156211,150276,5935,275618,04,12000
"Charco CDP, Arizona",14,4,10,21,04,12150
"Chiawuli Tak CDP, Arizona",11,11,0,90,04,12560
"Chilchinbito CDP, Arizona",230,175,55,849,04,12630
"Chinle CDP, Arizona",1261,1117,144,3888,04,12770
"Chino Valley town, Arizona",5393,5113,280,13120,04,12840
"Chloride CDP, Arizona",62,62,0,287,04,12910
"Christopher Creek CDP, Arizona",54,54,0,118,04,13140
"Chuichu CDP, Arizona",46,46,0,204,04,13190
"Cibecue CDP, Arizona",405,339,66,1419,04,13400
"Cibola CDP, Arizona",38,38,0,171,04,13470
"Cienega Springs CDP, Arizona",522,510,12,1441,04,13540
"Circle City CDP, Arizona",289,289,0,687,04,13610
"Citrus Park CDP, Arizona",2780,2737,43,5569,04,13820
"Clacks Canyon CDP, Arizona",47,47,0,92,04,13850
"Clarkdale town, Arizona",2009,2005,4,4528,04,13890
"Claypool CDP, Arizona",674,601,73,1252,04,13960
"Clay Springs CDP, Arizona",104,88,16,300,04,14030
"Clifton town, Arizona",1820,1799,21,3869,04,14380
"Colorado City town, Arizona",891,819,72,2628,04,14870
"Comobabi CDP, Arizona",0,0,0,0,04,15080
"Concho CDP, Arizona",0,0,0,0,04,15150
"Congress CDP, Arizona",327,327,0,1512,04,15220
"Coolidge city, Arizona",6180,5007,1173,14175,04,15500
"Copper Hill CDP, Arizona",76,76,0,110,04,15600
"Cordes Lakes CDP, Arizona",1804,1443,361,3308,04,15765
"Cornfields CDP, Arizona",51,46,5,281,04,15850
"Cornville CDP, Arizona",2251,2021,230,3582,04,15920
"Corona de Tucson CDP, Arizona",4055,3909,146,8742,04,16030
"Cottonwood CDP, Arizona",81,66,15,158,04,16360
"Cottonwood city, Arizona",5221,5074,147,12314,04,16410
"Cowlic CDP, Arizona",0,0,0,0,04,16830
"Crozier CDP, Arizona",12,12,0,73,04,17460
"Crystal Beach CDP, Arizona",104,92,12,282,04,17500
"Cutter CDP, Arizona",33,33,0,189,04,17810
"Dateland CDP, Arizona",126,124,2,341,04,18160
"Deer Creek CDP, Arizona",57,57,0,122,04,18448
"Del Muerto CDP, Arizona",119,119,0,515,04,18490
"Dennehotso CDP, Arizona",169,141,28,560,04,18580
"Desert Hills CDP, Arizona",893,825,68,2651,04,18740
"Dewey-Humboldt town, Arizona",1392,1279,113,4363,04,19145
"Dilkon CDP, Arizona",439,408,31,1326,04,19280
"Dolan Springs CDP, Arizona",375,366,9,1397,04,19630
"Doney Park CDP, Arizona",2519,2476,43,5056,04,19740
"Donovan Estates CDP, Arizona",327,299,28,696,04,19790
"Douglas city, Arizona",5193,4572,621,16301,04,20050
"Dragoon CDP, Arizona",105,105,0,160,04,20330
"Drexel Heights CDP, Arizona",14403,13732,671,30254,04,20540
"Dripping Springs CDP, Arizona",92,92,0,230,04,20560
"Drysdale CDP, Arizona",38,38,0,128,04,20570
"Dudleyville CDP, Arizona",163,163,0,478,04,20680
"Duncan town, Arizona",230,210,20,879,04,20750
"Eagar town, Arizona",1608,1594,14,4425,04,20960
"East Fork CDP, Arizona",182,167,15,439,04,21310
"East Globe CDP, Arizona",94,86,8,246,04,21410
"East Verde Estates CDP, Arizona",85,72,13,149,04,21545
"Ehrenberg CDP, Arizona",423,382,41,1012,04,21800
"El Capitan CDP, Arizona",0,0,0,10,04,21900
"Elephant Head CDP, Arizona",124,121,3,517,04,21980
"Elfrida CDP, Arizona",101,96,5,288,04,22080
"Elgin CDP, Arizona",54,54,0,169,04,22150
"El Mirage city, Arizona",18358,17283,1075,35652,04,22220
"Eloy city, Arizona",3737,3428,309,16075,04,22360
"El Prado Estates CDP, Arizona",234,234,0,391,04,22400
"First Mesa CDP, Arizona",462,436,26,1454,04,23512
"Flagstaff city, Arizona",42113,39334,2779,76177,04,23620
"Florence town, Arizona",4957,4582,375,25783,04,23760
"Flowing Springs CDP, Arizona",19,19,0,60,04,23955
"Flowing Wells CDP, Arizona",8510,7621,889,17188,04,23960
"Forest Lakes CDP, Arizona",45,45,0,222,04,24100
"Fort Apache CDP, Arizona",43,43,0,185,04,24250
"Fort Defiance CDP, Arizona",1452,1318,134,3528,04,24460
"Fort Mohave CDP, Arizona",6133,5537,596,16038,04,24895
"Fort Thomas CDP, Arizona",121,118,3,340,04,24950
"Fortuna Foothills CDP, Arizona",8217,7585,632,27552,04,25030
"Fort Valley CDP, Arizona",715,693,22,1734,04,25045
"Fountain Hills town, Arizona",11135,10564,571,23739,04,25300
"Franklin CDP, Arizona",69,69,0,93,04,25650
"Fredonia town, Arizona",375,365,10,1009,04,25720
"Freedom Acres CDP, Arizona",113,113,0,133,04,25735
"Gadsden CDP, Arizona",348,322,26,781,04,26070
"Ganado CDP, Arizona",275,275,0,737,04,26210
"Geronimo Estates CDP, Arizona",11,0,11,21,04,26780
"Gila Bend town, Arizona",901,901,0,1783,04,27050
"Gila Crossing CDP, Arizona",358,303,55,965,04,27260
"Gilbert town, Arizona",142993,137930,5063,267267,04,27400
"Gisela CDP, Arizona",126,126,0,516,04,27540
"Glendale city, Arizona",122998,116001,6997,248083,04,27820
"Globe city, Arizona",3158,3058,100,7230,04,28030
"Gold Canyon CDP, Arizona",3372,3235,137,11565,04,28140
"Golden Shores CDP, Arizona",188,188,0,772,04,28190
"Golden Valley CDP, Arizona",2360,2189,171,7900,04,28195
"Goodyear city, Arizona",45713,43207,2506,97542,04,28380
"Goodyear Village CDP, Arizona",162,133,29,332,04,28465
"Grand Canyon Village CDP, Arizona",1349,1349,0,1914,04,28981
"Grand Canyon West CDP, Arizona",0,0,0,0,04,28985
"Greasewood CDP, Arizona",78,62,16,281,04,29430
"Greenehaven CDP, Arizona",222,222,0,382,04,29603
"Green Valley CDP, Arizona",3143,2965,178,20937,04,29710
"Greer CDP, Arizona",0,0,0,0,04,29850
"Guadalupe town, Arizona",2730,2607,123,5335,04,30270
"Gu Oidak CDP, Arizona",24,11,13,187,04,30550
"Hackberry CDP, Arizona",169,169,0,319,04,30830
"Haigler Creek CDP, Arizona",0,0,0,29,04,30840
"Haivana Nakya CDP, Arizona",29,29,0,158,04,30850
"Hard Rock CDP, Arizona",11,9,2,118,04,31182
"Hayden town, Arizona",210,139,71,525,04,32020
"Heber-Overgaard CDP, Arizona",946,693,253,2651,04,32310
"Holbrook city, Arizona",1662,1598,64,4842,04,33280
"Hondah CDP, Arizona",286,286,0,837,04,33440
"Hotevilla-Bacavi CDP, Arizona",161,136,25,678,04,33945
"Houck CDP, Arizona",252,242,10,777,04,33980
"Huachuca City town, Arizona",797,709,88,1865,04,34120
"Hunter Creek CDP, Arizona",0,0,0,21,04,34700
"Icehouse Canyon CDP, Arizona",153,153,0,532,04,34980
"Indian Wells CDP, Arizona",106,85,21,357,04,35310
"Jakes Corner CDP, Arizona",70,70,0,206,04,36010
"Jeddito CDP, Arizona",49,40,9,211,04,36150
"Jerome town, Arizona",206,193,13,363,04,36290
"Joseph City CDP, Arizona",782,741,41,2058,04,36430
"J-Six Ranchettes CDP, Arizona",231,215,16,588,04,36440
"Kachina Village CDP, Arizona",1794,1780,14,3057,04,36475
"Kaibab CDP, Arizona",72,65,7,135,04,36500
"Kaibab Estates West CDP, Arizona",422,369,53,1613,04,36535
"Kaibito CDP, Arizona",626,526,100,1718,04,36640
"Kaka CDP, Arizona",11,11,0,24,04,36780
"Katherine CDP, Arizona",59,59,0,153,04,36920
"Kayenta CDP, Arizona",1759,1631,128,5366,04,36990
"Keams Canyon CDP, Arizona",120,120,0,436,04,37130
"Kearny town, Arizona",1009,966,43,2327,04,37200
"Kingman city, Arizona",13149,12321,828,33052,04,37620
"Kino Springs CDP, Arizona",54,46,8,154,04,37935
"Klagetoh CDP, Arizona",36,33,3,165,04,38250
"Kleindale CDP, Arizona",47,47,0,47,04,38290
"Kohatk CDP, Arizona",0,0,0,0,04,38530
"Kohls Ranch CDP, Arizona",0,0,0,73,04,38600
"Komatke CDP, Arizona",242,242,0,806,04,38655
"Ko Vaya CDP, Arizona",0,0,0,39,04,38950
"Kykotsmovi Village CDP, Arizona",343,317,26,887,04,39100
"Lake Havasu City city, Arizona",22826,21483,1343,57294,04,39370
"Lake Montezuma CDP, Arizona",1799,1748,51,4526,04,39720
"Lake of the Woods CDP, Arizona",1619,1402,217,3426,04,39790
"La Paz Valley CDP, Arizona",44,44,0,469,04,40160
"Lazy Y U CDP, Arizona",173,173,0,368,04,40400
"LeChee CDP, Arizona",705,637,68,1453,04,40415
"Leupp CDP, Arizona",482,420,62,1179,04,40630
"Linden CDP, Arizona",907,870,37,2452,04,41085
"Litchfield Park city, Arizona",3401,3331,70,6794,04,41330
"Littlefield CDP, Arizona",0,0,0,82,04,41470
"Lower Santan Village CDP, Arizona",47,47,0,226,04,42460
"Low Mountain CDP, Arizona",180,114,66,644,04,42590
"Lukachukai CDP, Arizona",446,358,88,1706,04,42660
"Lupton CDP, Arizona",3,0,3,5,04,42940
"McConnico CDP, Arizona",0,0,0,0,04,43150
"McNary CDP, Arizona",309,276,33,980,04,43430
"McNeal CDP, Arizona",51,49,2,180,04,43570
"Maish Vaya CDP, Arizona",25,25,0,61,04,43920
"Mammoth town, Arizona",354,293,61,1014,04,43990
"Many Farms CDP, Arizona",233,230,3,693,04,44200
"Marana town, Arizona",25647,24594,1053,52542,04,44270
"Maricopa city, Arizona",28795,27793,1002,59605,04,44410
"Maricopa Colony CDP, Arizona",71,71,0,615,04,44450
"Martinez Lake CDP, Arizona",29,29,0,49,04,44830
"Mayer CDP, Arizona",541,541,0,920,04,45180
"Mead Ranch CDP, Arizona",42,42,0,131,04,45275
"Meadview CDP, Arizona",122,58,64,1629,04,45285
"Mesa city, Arizona",261147,248761,12386,503390,04,46000
"Mesa del Caballo CDP, Arizona",532,506,26,1194,04,46005
"Mescal CDP, Arizona",456,456,0,1468,04,46070
"Mesquite Creek CDP, Arizona",134,129,5,494,04,46087
"Miami town, Arizona",566,476,90,1353,04,46350
"Miracle Valley CDP, Arizona",246,246,0,704,04,46840
"Moccasin CDP, Arizona",29,29,0,118,04,47190
"Moenkopi CDP, Arizona",355,315,40,1064,04,47330
"Mohave Valley CDP, Arizona",1164,1108,56,2724,04,47400
"Mojave Ranch Estates CDP, Arizona",3,3,0,39,04,47495
"Morenci CDP, Arizona",958,915,43,1467,04,47610
"Mormon Lake CDP, Arizona",64,64,0,235,04,47680
"Morristown CDP, Arizona",97,81,16,238,04,47750
"Mountainaire CDP, Arizona",623,583,40,945,04,47820
"Mountain View Ranches CDP, Arizona",802,764,38,1478,04,47925
"Munds Park CDP, Arizona",337,295,42,950,04,48170
"Naco CDP, Arizona",416,395,21,1189,04,48310
"Nazlini CDP, Arizona",103,93,10,468,04,49010
"Nelson CDP, Arizona",117,117,0,387,04,49100
"New Kingman-Butler CDP, Arizona",5175,4997,178,13247,04,49270
"New River CDP, Arizona",10314,10084,230,18422,04,49360
"Nogales city, Arizona",8978,7801,1177,19761,04,49640
"Nolic CDP, Arizona",0,0,0,0,04,49710
"North Fork CDP, Arizona",777,700,77,1689,04,50000
"Nutrioso CDP, Arizona",0,0,0,410,04,50340
"Oak Creek Canyon CDP, Arizona",155,155,0,262,04,50362
"Oak Springs CDP, Arizona",7,6,1,33,04,50480
"Oatman CDP, Arizona",0,0,0,94,04,50620
"Oljato-Monument Valley CDP, Arizona",22,22,0,73,04,51142
"Oracle CDP, Arizona",1395,1371,24,3146,04,51180
"Orange Grove Mobile Manor CDP, Arizona",125,125,0,165,04,51465
"Oro Valley town, Arizona",19086,18537,549,47053,04,51600
"Oxbow Estates CDP, Arizona",66,66,0,110,04,51775
"Padre Ranchitos CDP, Arizona",13,13,0,32,04,51800
"Page city, Arizona",3673,3213,460,7444,04,51810
"Palominas CDP, Arizona",144,144,0,275,04,52230
"Paradise Valley town, Arizona",5493,5355,138,12672,04,52930
"Parker town, Arizona",1705,1631,74,3357,04,53070
"Parker Strip CDP, Arizona",213,187,26,814,04,53210
"Parks CDP, Arizona",532,526,6,1352,04,53350
"Patagonia town, Arizona",340,316,24,896,04,53490
"Paulden CDP, Arizona",1989,1863,126,4518,04,53560
"Payson town, Arizona",6241,5804,437,16363,04,53700
"Peach Springs CDP, Arizona",507,412,95,1482,04,53770
"Peeples Valley CDP, Arizona",200,180,20,642,04,53910
"Peoria city, Arizona",93921,90303,3618,191292,04,54050
"Peridot CDP, Arizona",374,222,152,1465,04,54190
"Phoenix city, Arizona",857767,813556,44211,1609456,04,55000
"Picacho CDP, Arizona",123,102,21,289,04,55210
"Picture Rocks CDP, Arizona",3517,3393,124,9258,04,55300
"Pima town, Arizona",1330,1306,24,2847,04,55560
"Pinal CDP, Arizona",162,162,0,342,04,55630
"Pine CDP, Arizona",456,456,0,1526,04,55700
"Pinedale CDP, Arizona",222,222,0,543,04,55840
"Pine Lake CDP, Arizona",24,24,0,68,04,55845
"Pinetop Country Club CDP, Arizona",410,376,34,1769,04,55880
"Pinetop-Lakeside town, Arizona",1831,1741,90,4080,04,55980
"Pinion Pines CDP, Arizona",0,0,0,183,04,55983
"Pinon CDP, Arizona",430,353,77,1018,04,56120
"Pirtleville CDP, Arizona",606,478,128,1483,04,56400
"Pisinemo CDP, Arizona",104,67,37,353,04,56470
"Poston CDP, Arizona",65,65,0,147,04,57170
"Prescott city, Arizona",16905,16028,877,46054,04,57380
"Prescott Valley town, Arizona",21254,20354,900,47015,04,57450
"Quartzsite town, Arizona",684,418,266,2141,04,58010
"Queen Creek town, Arizona",30206,28919,1287,61788,04,58150
"Queen Valley CDP, Arizona",196,196,0,746,04,58290
"Rainbow City CDP, Arizona",107,62,45,596,04,58620
"Rancho Mesa Verde CDP, Arizona",87,42,45,599,04,58870
"Red Lake CDP, Arizona",810,795,15,1500,04,59372
"Red Mesa CDP, Arizona",214,183,31,494,04,59550
"Red Rock CDP (Apache County), Arizona",14,14,0,75,04,59690
"Red Rock CDP (Pinal County), Arizona",1468,1384,84,3173,04,59760
"Rillito CDP, Arizona",0,0,0,0,04,59900
"Rincon Valley CDP, Arizona",2471,2427,44,5712,04,60120
"Rio Rico CDP, Arizona",9878,9120,758,21447,04,60180
"Rio Verde CDP, Arizona",684,684,0,2422,04,60250
"Rock House CDP, Arizona",4,4,0,115,04,60770
"Rock Point CDP, Arizona",145,132,13,489,04,60880
"Roosevelt CDP, Arizona",0,0,0,0,04,61300
"Roosevelt Estates CDP, Arizona",86,54,32,620,04,61302
"Rough Rock CDP, Arizona",142,138,4,423,04,61370
"Round Rock CDP, Arizona",187,165,22,590,04,61440
"Round Valley CDP, Arizona",118,118,0,506,04,61448
"Rye CDP, Arizona",0,0,0,18,04,61690
"Sacate Village CDP, Arizona",115,115,0,171,04,61715
"Sacaton CDP, Arizona",598,542,56,2713,04,61720
"Sacaton Flats Village CDP, Arizona",245,212,33,385,04,61800
"Saddlebrooke CDP, Arizona",2204,1879,325,12014,04,61940
"Safford city, Arizona",4828,4578,250,10112,04,62000
"Sahuarita town, Arizona",14131,13187,944,34238,04,62140
"St. David CDP, Arizona",476,476,0,1300,04,62280
"St. Johns city, Arizona",934,913,21,3419,04,62350
"St. Johns CDP, Arizona",170,153,17,478,04,62362
"St. Michaels CDP, Arizona",253,225,28,774,04,62420
"Salome CDP, Arizona",279,279,0,708,04,62700
"San Carlos CDP, Arizona",1483,1193,290,4405,04,62910
"Sanders CDP, Arizona",239,236,3,696,04,63050
"San Jose CDP, Arizona",240,235,5,614,04,63260
"San Luis city, Arizona",13188,11850,1338,35189,04,63470
"San Manuel CDP, Arizona",1419,1278,141,3535,04,63540
"San Miguel CDP, Arizona",88,69,19,314,04,63610
"San Simon CDP, Arizona",66,50,16,221,04,63820
"Santa Cruz CDP, Arizona",14,14,0,89,04,63960
"San Tan Valley CDP, Arizona",50429,48141,2288,101207,04,64210
"Santa Rosa CDP, Arizona",215,189,26,749,04,64310
"Sawmill CDP, Arizona",229,172,57,794,04,64590
"Scenic CDP, Arizona",332,258,74,1840,04,64650
"Scottsdale city, Arizona",131524,126957,4567,240537,04,65000
"Seba Dalkai CDP, Arizona",26,26,0,132,04,65167
"Second Mesa CDP, Arizona",541,432,109,1372,04,65280
"Sedona city, Arizona",4609,4253,356,9739,04,65350
"Sehili CDP, Arizona",43,25,18,156,04,65400
"Seligman CDP, Arizona",350,350,0,770,04,65420
"Sells CDP, Arizona",651,550,101,2422,04,65490
"Seven Mile CDP, Arizona",281,218,63,1032,04,65780
"Shongopovi CDP, Arizona",329,236,93,1151,04,66190
"Shonto CDP, Arizona",154,146,8,387,04,66260
"Show Low city, Arizona",4739,4433,306,11767,04,66470
"Shumway CDP, Arizona",42,42,0,157,04,66540
"Sierra Vista city, Arizona",17703,16701,1002,45212,04,66820
"Sierra Vista Southeast CDP, Arizona",5425,5208,217,14398,04,66845
"Six Shooter Canyon CDP, Arizona",528,516,12,1325,04,67295
"Snowflake town, Arizona",2083,1923,160,6192,04,67800
"So-Hi CDP, Arizona",205,186,19,483,04,67920
"Solomon CDP, Arizona",206,206,0,479,04,68010
"Somerton city, Arizona",6171,5800,371,14278,04,68080
"Sonoita CDP, Arizona",204,171,33,741,04,68220
"South Komelik CDP, Arizona",55,55,0,169,04,68670
"South Tucson city, Arizona",1736,1489,247,4642,04,68850
"Springerville town, Arizona",740,726,14,2006,04,68990
"Spring Valley CDP, Arizona",461,451,10,1514,04,69060
"Stanfield CDP, Arizona",220,177,43,457,04,69130
"Star Valley town, Arizona",1199,1173,26,2490,04,69480
"Steamboat CDP, Arizona",127,97,30,417,04,69585
"Stotonic Village CDP, Arizona",287,287,0,470,04,69872
"Strawberry CDP, Arizona",355,355,0,1003,04,70040
"Summerhaven CDP, Arizona",18,18,0,26,04,70175
"Summit CDP, Arizona",2383,1715,668,5022,04,70240
"Sun City CDP, Arizona",7040,6640,400,37748,04,70320
"Sun City West CDP, Arizona",3413,3312,101,26639,04,70355
"Sunizona CDP, Arizona",57,57,0,217,04,70460
"Sun Lakes CDP, Arizona",2894,2718,176,14147,04,70530
"Sunsites CDP, Arizona",256,246,10,732,04,71020
"Sun Valley CDP, Arizona",57,35,22,105,04,71160
"Sunwest CDP, Arizona",0,0,0,0,04,71220
"Supai CDP, Arizona",0,0,0,0,04,71230
"Superior town, Arizona",1175,1094,81,2639,04,71300
"Surprise city, Arizona",64974,61988,2986,145591,04,71510
"Sweet Water Village CDP, Arizona",34,10,24,114,04,71642
"Swift Trail Junction CDP, Arizona",849,849,0,2907,04,71650
"Tacna CDP, Arizona",258,237,21,524,04,71790
"Tanque Verde CDP, Arizona",6399,6092,307,14815,04,72000
"Tat Momoli CDP, Arizona",0,0,0,0,04,72280
"Taylor town, Arizona",1496,1422,74,4062,04,72420
"Teec Nos Pos CDP, Arizona",284,207,77,884,04,72560
"Tees Toh CDP, Arizona",188,143,45,452,04,72630
"Tempe city, Arizona",111825,105461,6364,181005,04,73000
"Thatcher town, Arizona",2323,2194,129,5281,04,73420
"Theba CDP, Arizona",46,46,0,97,04,73490
"Three Points CDP, Arizona",1509,1435,74,5100,04,73700
"Timberline-Fernwood CDP, Arizona",1528,1464,64,2685,04,73890
"Tolani Lake CDP, Arizona",178,169,9,494,04,74120
"Tolleson city, Arizona",2874,2804,70,7221,04,74190
"Tombstone city, Arizona",417,405,12,1046,04,74400
"Tonalea CDP, Arizona",32,28,4,167,04,74470
"Tonopah CDP, Arizona",13,0,13,13,04,74540
"Tonto Basin CDP, Arizona",221,221,0,1380,04,74610
"Tonto Village CDP, Arizona",21,21,0,140,04,74665
"Topawa CDP, Arizona",67,67,0,441,04,74680
"Topock CDP, Arizona",0,0,0,0,04,74750
"Top-of-the-World CDP, Arizona",35,35,0,227,04,74820
"Toyei CDP, Arizona",0,0,0,0,04,75310
"Truxton CDP, Arizona",33,26,7,104,04,75590
"Tsaile CDP, Arizona",519,494,25,1482,04,75660
"Tubac CDP, Arizona",412,396,16,1375,04,75940
"Tuba City CDP, Arizona",3230,2893,337,8372,04,76010
"Tucson city, Arizona",269266,251679,17587,541033,04,77000
"Tucson Estates CDP, Arizona",4612,4460,152,12795,04,77035
"Tucson Mountains CDP, Arizona",5651,5526,125,11171,04,77179
"Tumacacori-Carmen CDP, Arizona",22,22,0,81,04,77367
"Turkey Creek CDP, Arizona",118,106,12,457,04,77415
"Tusayan town, Arizona",274,274,0,394,04,77490
"Upper Santan Village CDP, Arizona",324,297,27,733,04,78300
"Utting CDP, Arizona",7,7,0,38,04,78400
"Vail CDP, Arizona",7607,7462,145,15248,04,78540
"Vaiva Vo CDP, Arizona",75,30,45,143,04,78680
"Valencia West CDP, Arizona",6357,6151,206,13692,04,78760
"Valentine CDP, Arizona",19,13,6,46,04,78820
"Valle CDP, Arizona",104,103,1,248,04,78855
"Valle Vista CDP, Arizona",757,671,86,2633,04,78865
"Ventana CDP, Arizona",58,19,39,122,04,79590
"Verde Village CDP, Arizona",6261,5979,282,12005,04,79830
"Vernon CDP, Arizona",71,71,0,331,04,79870
"Vicksburg CDP, Arizona",227,219,8,602,04,79940
"Village of Oak Creek (Big Park) CDP, Arizona",2208,2149,59,5915,04,80095
"Wagon Wheel CDP, Arizona",673,652,21,1406,04,80380
"Wahak Hotrontk CDP, Arizona",23,13,10,46,04,80430
"Wall Lane CDP, Arizona",125,108,17,312,04,80790
"Walnut Creek CDP, Arizona",255,255,0,642,04,80825
"Washington Park CDP, Arizona",0,0,0,7,04,81175
"Wellton town, Arizona",587,581,6,2447,04,81480
"Wellton Hills CDP, Arizona",93,87,6,193,04,81490
"Wenden CDP, Arizona",275,250,25,469,04,81550
"Wet Camp Village CDP, Arizona",145,105,40,171,04,82060
"Wheatfields CDP, Arizona",272,263,9,457,04,82120
"Whetstone CDP, Arizona",835,788,47,2724,04,82156
"Whispering Pines CDP, Arizona",23,23,0,126,04,82270
"Whitecone CDP, Arizona",203,162,41,892,04,82390
"White Hills CDP, Arizona",86,71,15,265,04,82425
"White Mountain Lake CDP, Arizona",876,770,106,2817,04,82450
"Whiteriver CDP, Arizona",1115,1011,104,4284,04,82530
"Why CDP, Arizona",31,31,0,102,04,82670
"Wickenburg town, Arizona",3018,2987,31,7600,04,82740
"Wide Ruins CDP, Arizona",0,0,0,7,04,82810
"Wikieup CDP, Arizona",4,4,0,32,04,82880
"Wilhoit CDP, Arizona",360,360,0,1009,04,82950
"Willcox city, Arizona",1461,1216,245,3232,04,83090
"Williams city, Arizona",1405,1328,77,3275,04,83160
"Williamson CDP, Arizona",1887,1851,36,5999,04,83388
"Willow Canyon CDP, Arizona",0,0,0,0,04,83475
"Willow Valley CDP, Arizona",178,154,24,819,04,83570
"Window Rock CDP, Arizona",812,724,88,2056,04,83720
"Winkelman town, Arizona",56,46,10,249,04,83790
"Winslow city, Arizona",3344,3022,322,8943,04,83930
"Winslow West CDP, Arizona",136,121,15,343,04,83960
"Wintersburg CDP, Arizona",70,70,0,110,04,84000
"Wittmann CDP, Arizona",202,202,0,343,04,84140
"Woodruff CDP, Arizona",0,0,0,62,04,84350
"Yarnell CDP, Arizona",177,177,0,579,04,84980
"York CDP, Arizona",126,126,0,475,04,85260
"Young CDP, Arizona",118,118,0,407,04,85330
"Youngtown town, Arizona",3229,3064,165,6980,04,85400
"Yucca CDP, Arizona",4,4,0,65,04,85470
"Yuma city, Arizona",41779,38557,3222,96314,04,85540
"Yuma Proving Ground CDP, Arizona",120,90,30,313,04,85680
"Acorn CDP, Arkansas",96,89,7,125,05,00190
"Adona city, Arkansas",42,38,4,94,05,00250
"Alexander city, Arkansas",1936,1787,149,3444,05,00580
"Alicia town, Arkansas",53,49,4,122,05,00700
"Alix CDP, Arkansas",21,21,0,73,05,00730
"Alleene CDP, Arkansas",46,46,0,82,05,00820
"Allport town, Arkansas",15,12,3,76,05,00940
"Alma city, Arkansas",2053,1906,147,5837,05,00970
"Almyra town, Arkansas",90,90,0,182,05,01030
"Alpena town, Arkansas",183,181,2,404,05,01060
"Alpine CDP, Arkansas",44,44,0,71,05,01090
"Altheimer city, Arkansas",209,209,0,625,05,01150
"Altus city, Arkansas",393,355,38,1008,05,01210
"Amagon town, Arkansas",24,24,0,77,05,01270
"Amity city, Arkansas",362,352,10,957,05,01360
"Anthonyville town, Arkansas",18,12,6,61,05,01457
"Antoine town, Arkansas",67,63,4,207,05,01540
"Aplin CDP, Arkansas",37,37,0,159,05,01630
"Appleton CDP, Arkansas",66,66,0,118,05,01660
"Arkadelphia city, Arkansas",4825,4653,172,10354,05,01870
"Arkansas City city, Arkansas",179,174,5,510,05,01990
"Armorel CDP, Arkansas",277,277,0,409,05,02230
"Ashdown city, Arkansas",1969,1762,207,4264,05,02380
"Ash Flat city, Arkansas",486,468,18,1349,05,02470
"Atkins city, Arkansas",1171,1098,73,2865,05,02590
"Aubrey town, Arkansas",38,28,10,105,05,02680
"Augusta city, Arkansas",897,843,54,1995,05,02740
"Austin city, Arkansas",1805,1766,39,3659,05,02860
"Avilla CDP, Arkansas",833,833,0,1461,05,03010
"Avoca town, Arkansas",267,263,4,725,05,03040
"Bald Knob city, Arkansas",983,917,66,2548,05,03280
"Banks town, Arkansas",83,71,12,183,05,03430
"Barling city, Arkansas",2496,2395,101,4833,05,03640
"Bassett town, Arkansas",49,45,4,125,05,03940
"Batavia CDP, Arkansas",144,144,0,400,05,03970
"Batesville city, Arkansas",4714,4473,241,11163,05,04030
"Bauxite town, Arkansas",379,364,15,961,05,04090
"Bay city, Arkansas",1027,959,68,2392,05,04180
"Bearden city, Arkansas",263,263,0,833,05,04420
"Beaver town, Arkansas",42,36,6,98,05,04540
"Beebe city, Arkansas",3817,3767,50,8447,05,04600
"Bee Branch CDP, Arkansas",39,39,0,103,05,04630
"Beedeville town, Arkansas",45,43,2,66,05,04720
"Beirne CDP, Arkansas",0,0,0,0,05,04750
"Bella Vista city, Arkansas",13703,13186,517,30297,05,04840
"Bellefonte town, Arkansas",212,201,11,521,05,04900
"Belleville city, Arkansas",251,239,12,541,05,04960
"Ben Lomond town, Arkansas",86,85,1,218,05,05260
"Benton city, Arkansas",18249,17557,692,35318,05,05290
"Bentonville city, Arkansas",29831,28881,950,54513,05,05320
"Bergman town, Arkansas",315,312,3,634,05,05440
"Berryville city, Arkansas",2155,2028,127,5667,05,05560
"Bethesda CDP, Arkansas",82,82,0,92,05,05770
"Bigelow town, Arkansas",174,156,18,436,05,05920
"Big Flat town, Arkansas",37,26,11,64,05,05980
"Biggers town, Arkansas",197,179,18,466,05,06040
"Birdsong town, Arkansas",8,8,0,28,05,06340
"Bismarck CDP, Arkansas",99,99,0,126,05,06460
"Black Oak town, Arkansas",100,100,0,225,05,06610
"Black Rock city, Arkansas",359,318,41,846,05,06700
"Black Springs town, Arkansas",22,18,4,89,05,06730
"Blevins city, Arkansas",128,114,14,331,05,07030
"Blue Eye town, Arkansas",5,5,0,32,05,07150
"Blue Mountain town, Arkansas",43,40,3,153,05,07210
"Bluff City town, Arkansas",56,56,0,283,05,07270
"Blytheville city, Arkansas",6738,5822,916,13276,05,07330
"Board Camp CDP, Arkansas",43,43,0,70,05,07420
"Bodcaw town, Arkansas",71,71,0,143,05,07450
"Boles CDP, Arkansas",76,71,5,127,05,07510
"Bonanza city, Arkansas",240,218,22,522,05,07540
"Bono city, Arkansas",1172,1052,120,2497,05,07630
"Booneville city, Arkansas",1907,1746,161,3819,05,07720
"Bowman CDP, Arkansas",59,59,0,59,05,08020
"Bradford city, Arkansas",196,182,14,553,05,08260
"Bradley city, Arkansas",206,185,21,500,05,08290
"Branch city, Arkansas",159,159,0,337,05,08440
"Briarcliff city, Arkansas",105,96,9,209,05,08665
"Brinkley city, Arkansas",1086,873,213,2693,05,08950
"Brookland city, Arkansas",2404,2264,140,4057,05,09100
"Bryant city, Arkansas",11091,10691,400,20750,05,09460
"Buckner city, Arkansas",118,118,0,320,05,09550
"Buffalo City CDP, Arkansas",0,0,0,0,05,09700
"Bull Shoals city, Arkansas",627,558,69,1790,05,09790
"Burdette town, Arkansas",70,67,3,173,05,09880
"Cabot city, Arkansas",12689,12270,419,26543,05,10300
"Caddo Gap CDP, Arkansas",44,44,0,63,05,10330
"Caddo Valley town, Arkansas",333,304,29,763,05,10360
"Caldwell town, Arkansas",188,183,5,506,05,10450
"Cale town, Arkansas",24,24,0,69,05,10480
"Calico Rock city, Arkansas",331,316,15,1822,05,10570
"Calion city, Arkansas",184,175,9,401,05,10600
"Camden city, Arkansas",4309,4058,251,10587,05,10720
"Cammack Village city, Arkansas",480,477,3,933,05,10780
"Campbell Station city, Arkansas",218,207,11,311,05,10900
"Canehill CDP, Arkansas",38,38,0,90,05,11080
"Caraway city, Arkansas",448,426,22,1174,05,11410
"Carlisle city, Arkansas",939,881,58,2329,05,11500
"Carthage city, Arkansas",51,49,2,178,05,11830
"Casa town, Arkansas",67,63,4,119,05,11890
"Cash town, Arkansas",97,93,4,285,05,11920
"Caulksville town, Arkansas",54,52,2,144,05,12190
"Cave City city, Arkansas",762,729,33,2038,05,12280
"Cave Springs city, Arkansas",2752,2717,35,5521,05,12340
"Cedarville city, Arkansas",725,716,9,1548,05,12520
"Center Point CDP, Arkansas",33,33,0,82,05,12700
"Center Ridge CDP, Arkansas",102,102,0,199,05,12790
"Centerton city, Arkansas",10618,10519,99,18655,05,12820
"Centerville CDP, Arkansas",0,0,0,0,05,12940
"Central City town, Arkansas",416,395,21,729,05,13120
"Charleston city, Arkansas",1274,1220,54,2585,05,13300
"Cherokee City CDP, Arkansas",16,16,0,31,05,13420
"Cherokee Village city, Arkansas",1718,1512,206,5061,05,13450
"Cherry Valley city, Arkansas",269,260,9,600,05,13540
"Chester town, Arkansas",14,14,0,80,05,13570
"Chidester city, Arkansas",113,113,0,397,05,13750
"Cincinnati CDP, Arkansas",469,459,10,619,05,13960
"Clarendon city, Arkansas",383,341,42,1366,05,13990
"Clarkedale city, Arkansas",250,244,6,446,05,14050
"Clarksville city, Arkansas",4087,3991,96,9453,05,14140
"Clinton city, Arkansas",941,917,24,2508,05,14260
"Coal Hill city, Arkansas",236,234,2,791,05,14500
"College Station CDP, Arkansas",168,168,0,230,05,14860
"Collins CDP, Arkansas",89,89,0,169,05,14920
"Colt city, Arkansas",202,186,16,449,05,14950
"Concord town, Arkansas",52,49,3,112,05,15100
"Conway city, Arkansas",32902,31915,987,65159,05,15190
"Corinth town, Arkansas",19,18,1,39,05,15310
"Corning city, Arkansas",1512,1406,106,3202,05,15460
"Cotter city, Arkansas",367,352,15,1004,05,15490
"Cotton Plant city, Arkansas",156,139,17,425,05,15550
"Cove town, Arkansas",153,129,24,324,05,15700
"Coy town, Arkansas",33,33,0,73,05,15790
"Crawfordsville town, Arkansas",230,217,13,478,05,15940
"Crossett city, Arkansas",1783,1701,82,4805,05,16240
"Crystal Springs CDP, Arkansas",139,130,9,258,05,16690
"Cushman city, Arkansas",227,211,16,447,05,16930
"Daisy town, Arkansas",86,86,0,144,05,17140
"Damascus town, Arkansas",132,129,3,361,05,17290
"Danville city, Arkansas",1188,1112,76,2384,05,17320
"Dardanelle city, Arkansas",2167,2019,148,4544,05,17380
"Datto town, Arkansas",23,22,1,59,05,17410
"Decatur city, Arkansas",595,574,21,1491,05,17740
"Deer CDP, Arkansas",55,55,0,79,05,17860
"Delaplaine town, Arkansas",39,39,0,93,05,18010
"Delight city, Arkansas",94,79,15,259,05,18100
"Dell town, Arkansas",101,92,9,222,05,18160
"Dennard CDP, Arkansas",187,187,0,415,05,18340
"Denning town, Arkansas",107,95,12,275,05,18370
"De Queen city, Arkansas",2829,2759,70,6132,05,18490
"Dermott city, Arkansas",721,591,130,2655,05,18520
"Des Arc city, Arkansas",555,538,17,1400,05,18550
"Desha CDP, Arkansas",465,455,10,775,05,18580
"De Valls Bluff city, Arkansas",145,145,0,560,05,18640
"DeWitt city, Arkansas",1265,1149,116,3017,05,18790
"Diamond City city, Arkansas",378,373,5,888,05,18850
"Diaz city, Arkansas",444,382,62,1103,05,18940
"Dierks city, Arkansas",213,194,19,663,05,18970
"Donaldson town, Arkansas",243,239,4,387,05,19450
"Dora CDP, Arkansas",35,35,0,84,05,19540
"Dover city, Arkansas",580,549,31,1800,05,19600
"Drasco CDP, Arkansas",149,149,0,226,05,19720
"Dumas city, Arkansas",1586,1444,142,3965,05,19990
"Dyer city, Arkansas",392,366,26,917,05,20200
"Dyess town, Arkansas",122,108,14,278,05,20230
"Earle city, Arkansas",663,550,113,1759,05,20320
"East Camden town, Arkansas",533,497,36,1174,05,20440
"East End CDP, Arkansas",3320,3165,155,6147,05,20470
"Edgemont CDP, Arkansas",10,10,0,35,05,20800
"Edmondson town, Arkansas",114,106,8,318,05,20830
"Egypt town, Arkansas",26,21,5,73,05,20920
"Elaine city, Arkansas",288,196,92,544,05,20950
"El Dorado city, Arkansas",7659,7329,330,17606,05,21070
"Elkins city, Arkansas",1864,1838,26,3635,05,21190
"Elm Springs city, Arkansas",1363,1351,12,2699,05,21430
"El Paso CDP, Arkansas",271,271,0,713,05,21520
"Emerson town, Arkansas",128,128,0,320,05,21580
"Emmet city, Arkansas",278,223,55,588,05,21610
"England city, Arkansas",1173,1108,65,2562,05,21730
"Enola town, Arkansas",289,288,1,614,05,21820
"Etowah town, Arkansas",142,122,20,282,05,22120
"Eudora city, Arkansas",828,668,160,2161,05,22180
"Eureka Springs city, Arkansas",821,812,9,2053,05,22240
"Evansville CDP, Arkansas",9,9,0,74,05,22300
"Evening Shade city, Arkansas",118,107,11,360,05,22360
"Everton town, Arkansas",29,25,4,70,05,22450
"Fairfield Bay city, Arkansas",624,614,10,2291,05,22660
"Fair Oaks CDP, Arkansas",24,24,0,49,05,22720
"Fargo town, Arkansas",23,23,0,61,05,23140
"Farmington city, Arkansas",3327,3314,13,7991,05,23170
"Fayetteville city, Arkansas",52376,49624,2752,95022,05,23290
"Felsenthal town, Arkansas",8,8,0,38,05,23320
"Fifty-Six city, Arkansas",54,40,14,176,05,23680
"Fisher city, Arkansas",63,60,3,179,05,23800
"Flippin city, Arkansas",565,512,53,1366,05,24010
"Floral CDP, Arkansas",14,14,0,50,05,24070
"Floyd CDP, Arkansas",369,369,0,811,05,24130
"Fordyce city, Arkansas",1511,1379,132,3386,05,24220
"Foreman city, Arkansas",398,355,43,1214,05,24250
"Forrest City city, Arkansas",3987,3617,370,13010,05,24430
"Fort Smith city, Arkansas",43192,40561,2631,89315,05,24550
"Fouke city, Arkansas",270,250,20,728,05,24640
"Fountain Hill town, Arkansas",78,73,5,131,05,24670
"Fountain Lake town, Arkansas",249,239,10,621,05,24700
"Fourche town, Arkansas",0,0,0,16,05,24760
"Fox CDP, Arkansas",120,111,9,242,05,24910
"Franklin town, Arkansas",57,49,8,184,05,25030
"Fredonia (Biscoe) town, Arkansas",84,78,6,221,05,25060
"Friendship town, Arkansas",91,89,2,211,05,25180
"Fulton town, Arkansas",76,76,0,208,05,25360
"Gamaliel CDP, Arkansas",0,0,0,17,05,25630
"Garfield town, Arkansas",219,218,1,456,05,25750
"Garland town, Arkansas",111,111,0,260,05,25780
"Garner town, Arkansas",138,136,2,225,05,25900
"Gassville city, Arkansas",1215,1110,105,2466,05,26050
"Gateway town, Arkansas",121,119,2,270,05,26110
"Genoa CDP, Arkansas",275,275,0,1003,05,26260
"Gentry city, Arkansas",1847,1847,0,3912,05,26290
"Georgetown town, Arkansas",16,16,0,74,05,26440
"Gibson CDP, Arkansas",1727,1585,142,3515,05,26710
"Gilbert town, Arkansas",0,0,0,4,05,26800
"Gillett city, Arkansas",257,219,38,491,05,26980
"Gillham town, Arkansas",99,87,12,227,05,27010
"Gilmore city, Arkansas",99,55,44,202,05,27040
"Glenwood city, Arkansas",690,677,13,1739,05,27310
"Goodwin CDP, Arkansas",42,42,0,121,05,27610
"Goshen town, Arkansas",1166,1149,17,2632,05,27670
"Gosnell city, Arkansas",1145,1145,0,2896,05,27700
"Gould city, Arkansas",170,121,49,453,05,27730
"Grady city, Arkansas",56,56,0,220,05,27790
"Grannis city, Arkansas",266,244,22,511,05,27970
"Gravette city, Arkansas",1668,1642,26,3565,05,28360
"Greenbrier city, Arkansas",2492,2446,46,5755,05,28510
"Green Forest city, Arkansas",1583,1529,54,3033,05,28600
"Greenland city, Arkansas",853,826,27,1424,05,28660
"Greenway city, Arkansas",51,51,0,171,05,28720
"Greenwood city, Arkansas",4567,4418,149,9544,05,28780
"Greers Ferry city, Arkansas",359,351,8,905,05,28810
"Gregory CDP, Arkansas",8,8,0,13,05,28840
"Griffithville town, Arkansas",140,136,4,321,05,28990
"Grubbs city, Arkansas",190,182,8,378,05,29020
"Guion town, Arkansas",54,54,0,79,05,29080
"Gum Springs town, Arkansas",43,38,5,84,05,29140
"Gurdon city, Arkansas",680,646,34,1756,05,29200
"Guy city, Arkansas",287,256,31,619,05,29230
"Hackett city, Arkansas",351,335,16,836,05,29290
"Hagarville CDP, Arkansas",53,53,0,84,05,29320
"Halley CDP, Arkansas",0,0,0,13,05,29380
"Hamburg city, Arkansas",947,868,79,2792,05,29500
"Hampton city, Arkansas",441,414,27,1354,05,29650
"Hardy city, Arkansas",299,288,11,763,05,29920
"Harrell town, Arkansas",110,95,15,281,05,30310
"Harrisburg city, Arkansas",1091,1020,71,2700,05,30400
"Harrison city, Arkansas",5786,5417,369,13154,05,30460
"Hartford city, Arkansas",219,205,14,500,05,30490
"Hartman city, Arkansas",244,238,6,597,05,30520
"Haskell city, Arkansas",1782,1775,7,3996,05,30640
"Hatfield town, Arkansas",259,251,8,499,05,30700
"Hattieville CDP, Arkansas",122,122,0,159,05,30730
"Havana city, Arkansas",205,200,5,566,05,30790
"Haynes town, Arkansas",50,36,14,113,05,30880
"Hazen city, Arkansas",793,767,26,1738,05,30940
"Heber Springs city, Arkansas",2970,2803,167,7066,05,31090
"Hector town, Arkansas",166,163,3,379,05,31150
"Helena-West Helena city, Arkansas",3576,2989,587,9470,05,31190
"Henderson CDP, Arkansas",40,40,0,393,05,31270
"Hensley CDP, Arkansas",20,20,0,42,05,31390
"Hermitage city, Arkansas",136,128,8,484,05,31540
"Hickory Ridge city, Arkansas",105,103,2,267,05,31900
"Higden town, Arkansas",37,30,7,94,05,32080
"Higginson town, Arkansas",562,540,22,981,05,32140
"Highfill town, Arkansas",990,983,7,1679,05,32200
"Highland city, Arkansas",501,481,20,1186,05,32257
"Hindsville town, Arkansas",59,59,0,120,05,32470
"Holiday Island town, Arkansas",1015,977,38,2358,05,32650
"Holland city, Arkansas",325,304,21,712,05,32710
"Holly Grove city, Arkansas",207,184,23,632,05,32800
"Hope city, Arkansas",3707,3564,143,8921,05,33190
"Horatio city, Arkansas",363,328,35,899,05,33310
"Horseshoe Bend city, Arkansas",720,603,117,2423,05,33370
"Horseshoe Lake town, Arkansas",222,205,17,393,05,33375
"Hot Springs city, Arkansas",17371,16428,943,38025,05,33400
"Hot Springs Village CDP, Arkansas",4389,4184,205,16843,05,33482
"Houston town, Arkansas",75,75,0,233,05,33490
"Hoxie city, Arkansas",1079,1002,77,2623,05,33580
"Hughes city, Arkansas",387,364,23,1051,05,33760
"Humnoke city, Arkansas",53,53,0,135,05,33820
"Humphrey city, Arkansas",97,95,2,238,05,33850
"Hunter town, Arkansas",87,87,0,142,05,33910
"Huntington city, Arkansas",188,176,12,490,05,33940
"Huntsville city, Arkansas",1203,1132,71,2973,05,33970
"Huttig city, Arkansas",247,181,66,508,05,34090
"Imboden town, Arkansas",319,275,44,742,05,34150
"Indian Bay CDP, Arkansas",0,0,0,0,05,34220
"Ivan CDP, Arkansas",42,42,0,87,05,34540
"Jacksonport town, Arkansas",30,30,0,99,05,34720
"Jacksonville city, Arkansas",13314,12127,1187,29332,05,34750
"Jasper city, Arkansas",176,170,6,618,05,34900
"Jennette town, Arkansas",40,37,3,67,05,35040
"Jericho town, Arkansas",49,46,3,96,05,35140
"Jerome CDP, Arkansas",27,26,1,75,05,35170
"Jerusalem CDP, Arkansas",10,0,10,30,05,35260
"Johnson city, Arkansas",1843,1825,18,3605,05,35500
"Joiner city, Arkansas",225,163,62,477,05,35650
"Jonesboro city, Arkansas",38553,35987,2566,78379,05,35710
"Jones Mills CDP, Arkansas",32,32,0,62,05,35770
"Judsonia city, Arkansas",848,834,14,2204,05,36040
"Junction City city, Arkansas",254,247,7,641,05,36130
"Keiser city, Arkansas",308,269,39,791,05,36310
"Kensett city, Arkansas",739,684,55,2044,05,36430
"Keo town, Arkansas",110,103,7,278,05,36550
"Kibler city, Arkansas",463,443,20,1141,05,36670
"Kingsland city, Arkansas",306,306,0,529,05,36880
"Kingston CDP, Arkansas",49,49,0,126,05,36910
"Kirby CDP, Arkansas",273,267,6,645,05,37060
"Knobel city, Arkansas",122,122,0,197,05,37240
"Knoxville town, Arkansas",301,273,28,746,05,37300
"Lacey CDP, Arkansas",150,109,41,561,05,37450
"Lafe town, Arkansas",167,151,16,421,05,37660
"LaGrange town, Arkansas",18,18,0,30,05,37720
"Lake City city, Arkansas",1287,1180,107,2389,05,37780
"Lake Hamilton CDP, Arkansas",825,825,0,2031,05,37930
"Lakeview city, Arkansas",303,293,10,949,05,38050
"Lake View city, Arkansas",126,94,32,454,05,38110
"Lake Village city, Arkansas",876,828,48,2084,05,38170
"Lamar city, Arkansas",666,647,19,1731,05,38290
"Landmark CDP, Arkansas",1451,1385,66,3620,05,38540
"Lavaca city, Arkansas",1402,1375,27,2467,05,38890
"Lawson CDP, Arkansas",80,80,0,119,05,38950
"Leachville city, Arkansas",864,829,35,2132,05,39010
"Lead Hill town, Arkansas",148,131,17,321,05,39040
"Leola town, Arkansas",191,165,26,521,05,39310
"Lepanto city, Arkansas",611,557,54,1706,05,39370
"Leslie city, Arkansas",129,123,6,483,05,39460
"Letona town, Arkansas",97,97,0,211,05,39520
"Lewisville city, Arkansas",351,314,37,881,05,39640
"Lexa town, Arkansas",51,51,0,92,05,39670
"Lincoln city, Arkansas",1084,1040,44,2754,05,39970
"Little Flock city, Arkansas",1831,1674,157,3019,05,40120
"Little Rock city, Arkansas",103185,98595,4590,202218,05,41000
"Lockesburg city, Arkansas",395,390,5,874,05,41090
"London city, Arkansas",512,488,24,1113,05,41270
"Lonoke city, Arkansas",2178,1894,284,4261,05,41420
"Lonsdale town, Arkansas",73,73,0,248,05,41450
"Lost Bridge Village CDP, Arkansas",125,119,6,289,05,41555
"Louann town, Arkansas",92,76,16,165,05,41630
"Lowell city, Arkansas",4943,4899,44,10005,05,41720
"Luxora city, Arkansas",392,353,39,1004,05,42170
"Lynn town, Arkansas",95,95,0,219,05,42260
"McAlmont CDP, Arkansas",488,259,229,1584,05,42350
"McCaskill town, Arkansas",27,27,0,70,05,42410
"McCrory city, Arkansas",667,644,23,1738,05,42500
"McDougal town, Arkansas",25,24,1,81,05,42560
"McGehee city, Arkansas",1329,1310,19,3812,05,42770
"McNab town, Arkansas",49,45,4,89,05,43070
"McNeil city, Arkansas",252,252,0,489,05,43100
"McRae city, Arkansas",375,368,7,853,05,43220
"Madison city, Arkansas",337,329,8,813,05,43280
"Magazine city, Arkansas",411,389,22,969,05,43310
"Magness town, Arkansas",66,66,0,114,05,43370
"Magnet Cove CDP, Arkansas",620,482,138,1205,05,43430
"Magnolia city, Arkansas",4608,4435,173,11044,05,43460
"Malvern city, Arkansas",3950,3656,294,10859,05,43610
"Mammoth Spring city, Arkansas",411,396,15,1037,05,43670
"Manila city, Arkansas",1744,1656,88,3659,05,43820
"Mansfield city, Arkansas",565,511,54,1326,05,43880
"Marianna city, Arkansas",1330,1050,280,3575,05,44120
"Marie town, Arkansas",32,32,0,51,05,44150
"Marion city, Arkansas",7096,6700,396,13635,05,44180
"Marked Tree city, Arkansas",852,795,57,2321,05,44210
"Marmaduke city, Arkansas",690,650,40,1513,05,44240
"Marshall city, Arkansas",426,412,14,1384,05,44300
"Marvell city, Arkansas",471,390,81,1100,05,44420
"Maumelle city, Arkansas",9738,9283,455,19183,05,44600
"Mayflower city, Arkansas",1111,1055,56,2172,05,44750
"Maynard town, Arkansas",178,164,14,425,05,44780
"Maysville CDP, Arkansas",112,112,0,222,05,44810
"Melbourne city, Arkansas",908,854,54,2430,05,45080
"Mellwood CDP, Arkansas",0,0,0,0,05,45110
"Mena city, Arkansas",2701,2415,286,5605,05,45170
"Menifee town, Arkansas",118,112,6,234,05,45200
"Midland town, Arkansas",156,150,6,314,05,45500
"Midway CDP, Arkansas",612,612,0,1226,05,45530
"Midway town, Arkansas",426,426,0,754,05,45560
"Mineral Springs city, Arkansas",528,506,22,1291,05,46040
"Minturn town, Arkansas",24,17,7,41,05,46100
"Mitchellville city, Arkansas",69,63,6,209,05,46190
"Monette city, Arkansas",588,561,27,1346,05,46400
"Monroe CDP, Arkansas",21,21,0,47,05,46460
"Monticello city, Arkansas",3435,3299,136,8443,05,46580
"Montrose city, Arkansas",65,61,4,238,05,46670
"Moorefield town, Arkansas",57,53,4,117,05,46730
"Moro town, Arkansas",120,120,0,254,05,46910
"Morrilton city, Arkansas",3077,2775,302,6980,05,46970
"Morrison Bluff town, Arkansas",24,24,0,48,05,47030
"Morrow CDP, Arkansas",114,114,0,350,05,47090
"Mountainburg city, Arkansas",254,242,12,544,05,47300
"Mountain Home city, Arkansas",5304,4953,351,12876,05,47390
"Mountain Pine city, Arkansas",226,221,5,550,05,47450
"Mountain View city, Arkansas",772,772,0,2868,05,47540
"Mount Holly CDP, Arkansas",142,142,0,184,05,47660
"Mount Ida city, Arkansas",408,379,29,1410,05,47690
"Mount Judea CDP, Arkansas",29,29,0,65,05,47720
"Mount Olive CDP, Arkansas",0,0,0,75,05,47810
"Mount Pleasant town, Arkansas",69,67,2,279,05,47900
"Mount Vernon town, Arkansas",92,87,5,277,05,48020
"Mulberry city, Arkansas",553,535,18,1616,05,48200
"Murfreesboro city, Arkansas",747,694,53,1703,05,48290
"Nashville city, Arkansas",2030,1827,203,4156,05,48560
"Natural Steps CDP, Arkansas",273,273,0,580,05,48680
"Newark city, Arkansas",503,488,15,1421,05,49010
"New Blaine CDP, Arkansas",156,156,0,378,05,49070
"New Edinburg CDP, Arkansas",73,73,0,157,05,49220
"Newhope CDP, Arkansas",245,245,0,343,05,49370
"Newport city, Arkansas",2712,2356,356,7984,05,49580
"Nimmons town, Arkansas",20,18,2,58,05,49820
"Norfork city, Arkansas",145,143,2,554,05,50000
"Norman town, Arkansas",196,188,8,379,05,50030
"Norphlet city, Arkansas",334,325,9,728,05,50060
"North Crossett CDP, Arkansas",1043,994,49,2751,05,50240
"North Little Rock city, Arkansas",32827,30654,2173,64454,05,50450
"Oak Grove town, Arkansas",138,138,0,365,05,50810
"Oak Grove CDP, Arkansas",40,40,0,87,05,50990
"Oak Grove Heights town, Arkansas",654,648,6,1263,05,51060
"Oakhaven town, Arkansas",31,31,0,57,05,51080
"Oakland CDP, Arkansas",0,0,0,91,05,51110
"Oark CDP, Arkansas",19,19,0,19,05,51230
"Oden town, Arkansas",112,105,7,335,05,51290
"Ogden city, Arkansas",72,70,2,183,05,51350
"Oil Trough town, Arkansas",84,84,0,243,05,51410
"O'Kean town, Arkansas",45,42,3,149,05,51500
"Okolona town, Arkansas",176,136,40,315,05,51530
"Ola city, Arkansas",345,322,23,869,05,51560
"Omaha town, Arkansas",46,44,2,127,05,52160
"Oneida CDP, Arkansas",0,0,0,0,05,52280
"Oppelo city, Arkansas",510,468,42,993,05,52430
"Osceola city, Arkansas",3101,2669,432,6911,05,52580
"Oxford city, Arkansas",317,298,19,922,05,52880
"Ozan town, Arkansas",51,51,0,79,05,52940
"Ozark city, Arkansas",1390,1227,163,3546,05,52970
"Ozark Acres CDP, Arkansas",225,191,34,780,05,53000
"Ozone CDP, Arkansas",0,0,0,0,05,53060
"Palestine city, Arkansas",324,297,27,768,05,53150
"Pangburn city, Arkansas",288,270,18,585,05,53240
"Paragould city, Arkansas",13894,12714,1180,29690,05,53390
"Paris city, Arkansas",1638,1513,125,3214,05,53480
"Parkdale city, Arkansas",31,28,3,116,05,53510
"Parkin city, Arkansas",274,232,42,694,05,53600
"Patmos town, Arkansas",11,11,0,65,05,53900
"Patterson city, Arkansas",127,122,5,292,05,53990
"Payneway CDP, Arkansas",36,36,0,173,05,54110
"Peach Orchard city, Arkansas",37,37,0,80,05,54140
"Pearcy CDP, Arkansas",324,324,0,569,05,54170
"Pea Ridge city, Arkansas",3348,3288,60,6851,05,54200
"Pencil Bluff CDP, Arkansas",14,14,0,39,05,54410
"Perla town, Arkansas",76,69,7,225,05,54620
"Perry town, Arkansas",114,101,13,305,05,54650
"Perrytown town, Arkansas",192,192,0,415,05,54680
"Perryville city, Arkansas",511,491,20,1302,05,54710
"Piggott city, Arkansas",1647,1598,49,3610,05,55130
"Pindall town, Arkansas",57,57,0,154,05,55280
"Pine Bluff city, Arkansas",17312,15616,1696,41172,05,55310
"Pineville town, Arkansas",61,40,21,172,05,55580
"Piney CDP, Arkansas",2214,2084,130,4563,05,55610
"Plainview city, Arkansas",183,183,0,450,05,55970
"Pleasant Grove CDP, Arkansas",73,68,5,255,05,56060
"Pleasant Plains town, Arkansas",81,77,4,164,05,56270
"Plumerville city, Arkansas",374,359,15,802,05,56480
"Pocahontas city, Arkansas",3048,2780,268,7384,05,56540
"Pollard city, Arkansas",104,88,16,198,05,56600
"Ponca CDP, Arkansas",102,102,0,111,05,56630
"Poplar Grove CDP, Arkansas",0,0,0,51,05,56690
"Portia town, Arkansas",253,232,21,521,05,56720
"Portland city, Arkansas",202,202,0,509,05,56750
"Pottsville city, Arkansas",1554,1532,22,3141,05,56990
"Powhatan town, Arkansas",73,61,12,176,05,57050
"Poyen town, Arkansas",134,132,2,336,05,57080
"Prairie Creek CDP, Arkansas",1194,1108,86,2379,05,57125
"Prairie Grove city, Arkansas",3374,3233,141,7131,05,57170
"Prattsville town, Arkansas",168,150,18,404,05,57230
"Prescott city, Arkansas",1331,1257,74,3079,05,57260
"Princeton CDP, Arkansas",5,5,0,5,05,57530
"Pyatt town, Arkansas",39,34,5,77,05,57890
"Quitman city, Arkansas",337,290,47,730,05,57950
"Ratcliff city, Arkansas",77,66,11,142,05,58160
"Ravenden town, Arkansas",146,126,20,432,05,58250
"Ravenden Springs town, Arkansas",96,90,6,207,05,58280
"Reader CDP, Arkansas",5,5,0,52,05,58400
"Rector city, Arkansas",765,720,45,1793,05,58490
"Redfield city, Arkansas",571,538,33,1408,05,58580
"Reed town, Arkansas",48,48,0,159,05,58880
"Reyno city, Arkansas",219,198,21,423,05,59180
"Rison city, Arkansas",221,218,3,917,05,59480
"Rivervale CDP, Arkansas",24,24,0,67,05,59630
"Rockport city, Arkansas",383,378,5,884,05,60020
"Rockwell CDP, Arkansas",1920,1736,184,4205,05,60110
"Roe town, Arkansas",55,47,8,138,05,60380
"Rogers city, Arkansas",37474,36373,1101,69961,05,60410
"Roland CDP, Arkansas",429,410,19,999,05,60470
"Rondo town, Arkansas",34,24,10,134,05,60590
"Rose Bud town, Arkansas",245,222,23,467,05,60770
"Rosston town, Arkansas",224,220,4,411,05,61040
"Rover CDP, Arkansas",20,20,0,74,05,61190
"Rudy town, Arkansas",28,28,0,119,05,61460
"Russell town, Arkansas",76,70,6,289,05,61640
"Russellville city, Arkansas",13676,12952,724,28946,05,61670
"Rye CDP, Arkansas",52,52,0,185,05,61730
"St. Charles town, Arkansas",84,78,6,270,05,61940
"St. Francis city, Arkansas",109,105,4,240,05,61970
"St. Joe town, Arkansas",112,102,10,207,05,62030
"St. Paul town, Arkansas",53,46,7,123,05,62060
"Salado CDP, Arkansas",165,165,0,568,05,62120
"Salem city, Arkansas",510,505,5,1483,05,62150
"Salem CDP, Arkansas",1556,1547,9,2476,05,62210
"Salesville city, Arkansas",231,223,8,492,05,62240
"Saratoga CDP, Arkansas",0,0,0,29,05,62630
"Sardis CDP, Arkansas",245,234,11,566,05,62660
"Scott CDP, Arkansas",23,23,0,23,05,62900
"Scranton city, Arkansas",144,143,1,245,05,62960
"Searcy city, Arkansas",9253,8641,612,22961,05,63020
"Sedgwick town, Arkansas",49,45,4,141,05,63110
"Shannon Hills city, Arkansas",2209,2060,149,4472,05,63470
"Sheridan city, Arkansas",1686,1620,66,5002,05,63710
"Sherrill town, Arkansas",45,45,0,194,05,63740
"Sherwood city, Arkansas",15933,15333,600,32715,05,63800
"Shirley town, Arkansas",121,118,3,281,05,63980
"Sidney town, Arkansas",54,52,2,140,05,64280
"Siloam Springs city, Arkansas",8270,8053,217,17632,05,64370
"Smackover city, Arkansas",954,912,42,1975,05,64730
"Smithville town, Arkansas",41,39,2,92,05,64910
"South Lead Hill town, Arkansas",20,19,1,59,05,65480
"Southside city, Arkansas",1930,1803,127,4247,05,65630
"Sparkman city, Arkansas",197,188,9,523,05,65900
"Springdale city, Arkansas",43762,41834,1928,86705,05,66080
"Springfield CDP, Arkansas",179,162,17,349,05,66110
"Springtown town, Arkansas",50,50,0,101,05,66200
"Stamps city, Arkansas",553,444,109,1481,05,66320
"Star City city, Arkansas",1068,1043,25,2299,05,66440
"Staves CDP, Arkansas",64,64,0,145,05,66800
"Stephens city, Arkansas",334,327,7,957,05,66860
"Strawberry town, Arkansas",93,86,7,314,05,67250
"Strong city, Arkansas",110,110,0,374,05,67370
"Stuttgart city, Arkansas",3684,3365,319,8189,05,67490
"Subiaco town, Arkansas",215,182,33,506,05,67520
"Success town, Arkansas",68,58,10,126,05,67550
"Sulphur Rock town, Arkansas",271,262,9,634,05,67730
"Sulphur Springs city, Arkansas",205,205,0,479,05,67760
"Sulphur Springs CDP, Arkansas",400,400,0,1119,05,67790
"Summers CDP, Arkansas",219,219,0,342,05,67880
"Summit city, Arkansas",277,244,33,555,05,67940
"Sunset town, Arkansas",58,46,12,133,05,68060
"Sweet Home CDP, Arkansas",440,389,51,973,05,68330
"Swifton city, Arkansas",473,415,58,1198,05,68360
"Taylor city, Arkansas",249,249,0,679,05,68660
"Texarkana city, Arkansas",12533,11489,1044,29404,05,68810
"Thornton city, Arkansas",164,90,74,402,05,69050
"Tillar city, Arkansas",99,99,0,195,05,69230
"Tinsman town, Arkansas",7,7,0,36,05,69350
"Tollette town, Arkansas",67,53,14,164,05,69500
"Tontitown city, Arkansas",3049,2974,75,5114,05,69740
"Traskwood city, Arkansas",170,169,1,351,05,69830
"Trumann city, Arkansas",3237,3154,83,7383,05,70010
"Tucker CDP, Arkansas",29,29,0,99,05,70070
"Tuckerman city, Arkansas",644,620,24,1654,05,70100
"Tull town, Arkansas",173,165,8,433,05,70220
"Tumbling Shoals CDP, Arkansas",333,327,6,864,05,70310
"Tupelo town, Arkansas",43,38,5,60,05,70340
"Turrell city, Arkansas",185,131,54,484,05,70430
"Twin Groves town, Arkansas",96,92,4,286,05,70540
"Tyronza city, Arkansas",240,227,13,620,05,70700
"Ulm town, Arkansas",129,129,0,196,05,70760
"Uniontown CDP, Arkansas",47,47,0,81,05,71060
"Urbana CDP, Arkansas",46,46,0,119,05,71180
"Valley Springs town, Arkansas",136,134,2,247,05,71390
"Van Buren city, Arkansas",10773,9926,847,23398,05,71480
"Vandervoort town, Arkansas",115,115,0,198,05,71510
"Vanndale CDP, Arkansas",217,166,51,535,05,71570
"Victoria town, Arkansas",0,0,0,0,05,71900
"Vilonia city, Arkansas",1850,1775,75,4348,05,71960
"Viola town, Arkansas",95,94,1,359,05,72140
"Violet Hill CDP, Arkansas",53,53,0,53,05,72170
"Wabbaseka town, Arkansas",81,81,0,361,05,72230
"Walcott CDP, Arkansas",0,0,0,11,05,72290
"Waldenburg town, Arkansas",29,29,0,57,05,72320
"Waldo city, Arkansas",569,569,0,1375,05,72350
"Waldron city, Arkansas",1541,1374,167,3375,05,72380
"Walnut Ridge city, Arkansas",2457,2317,140,5411,05,72890
"Ward city, Arkansas",2741,2598,143,6149,05,73130
"Warm Springs CDP, Arkansas",0,0,0,46,05,73250
"Warren city, Arkansas",2087,1995,92,5409,05,73310
"Washington city, Arkansas",57,38,19,100,05,73370
"Watson city, Arkansas",58,57,1,163,05,73550
"Wayton CDP, Arkansas",96,96,0,182,05,73730
"Weiner city, Arkansas",287,276,11,675,05,73940
"Weldon town, Arkansas",76,76,0,132,05,74000
"Wesley CDP, Arkansas",177,177,0,440,05,74090
"West Crossett CDP, Arkansas",443,430,13,1196,05,74270
"Western Grove town, Arkansas",166,159,7,461,05,74330
"West Fork city, Arkansas",1598,1552,46,3054,05,74360
"West Memphis city, Arkansas",11060,9587,1473,24351,05,74540
"West Point town, Arkansas",44,41,3,145,05,74660
"Wheatley city, Arkansas",259,259,0,534,05,74840
"Whelen Springs town, Arkansas",22,22,0,46,05,74930
"White Hall city, Arkansas",2431,2332,99,5559,05,75170
"Wickes town, Arkansas",308,287,21,869,05,75500
"Widener town, Arkansas",104,79,25,246,05,75560
"Wiederkehr Village city, Arkansas",10,10,0,13,05,75570
"Wilburn CDP, Arkansas",117,76,41,234,05,75590
"Williford town, Arkansas",26,24,2,76,05,75740
"Willisville town, Arkansas",130,129,1,270,05,75770
"Wilmar city, Arkansas",136,135,1,384,05,75860
"Wilmot city, Arkansas",145,128,17,455,05,75890
"Wilson city, Arkansas",551,531,20,1027,05,75920
"Wilton city, Arkansas",131,122,9,297,05,75980
"Winchester town, Arkansas",46,44,2,91,05,76010
"Winslow city, Arkansas",113,108,5,344,05,76190
"Winthrop city, Arkansas",18,18,0,101,05,76250
"Witts Springs CDP, Arkansas",0,0,0,0,05,76460
"Woodlawn CDP, Arkansas",58,58,0,166,05,76690
"Woodson CDP, Arkansas",252,252,0,661,05,76730
"Wooster town, Arkansas",512,486,26,1155,05,76820
"Wrightsville city, Arkansas",189,186,3,1382,05,76970
"Wynne city, Arkansas",3919,3590,329,8284,05,77090
"Yarborough Landing CDP, Arkansas",187,187,0,402,05,77203
"Yellville city, Arkansas",479,419,60,1159,05,77330
"Zinc town, Arkansas",21,19,2,68,05,77600
"Acalanes Ridge CDP, California",535,510,25,961,06,00135
"Acampo CDP, California",122,122,0,255,06,00156
"Acton CDP, California",3469,3416,53,7286,06,00212
"Adelanto city, California",14491,12839,1652,37960,06,00296
"Adin CDP, California",50,50,0,97,06,00310
"Agoura Hills city, California",10352,9790,562,20088,06,00394
"Agua Dulce CDP, California",1604,1542,62,3161,06,00450
"Aguanga CDP, California",178,178,0,603,06,00464
"Ahwahnee CDP, California",850,791,59,1896,06,00478
"Airport CDP, California",535,429,106,1387,06,00535
"Alameda city, California",42248,40109,2139,77565,06,00562
"Alamo CDP, California",6391,6221,170,14355,06,00618
"Albany city, California",10688,10339,349,20027,06,00674
"Albion CDP, California",55,48,7,222,06,00716
"Alderpoint CDP, California",13,13,0,91,06,00786
"Alhambra city, California",43718,41313,2405,82295,06,00884
"Alhambra Valley CDP, California",429,377,52,917,06,00898
"Aliso Viejo city, California",30523,29374,1149,51896,06,00947
"Alleghany CDP, California",16,16,0,63,06,00982
"Allendale CDP, California",829,784,45,1752,06,00996
"Allensworth CDP, California",199,149,50,459,06,01010
"Almanor CDP, California",0,0,0,0,06,01094
"Alondra Park CDP, California",4320,4149,171,8314,06,01150
"Alpaugh CDP, California",334,267,67,880,06,01164
"Alpine CDP, California",7670,7220,450,15911,06,01192
"Alpine Village CDP, California",113,108,5,220,06,01228
"Alta CDP, California",406,381,25,652,06,01276
"Altadena CDP, California",22510,21007,1503,42719,06,01290
"Alta Sierra CDP (Kern County), California",0,0,0,26,06,01358
"Alta Sierra CDP (Nevada County), California",3683,3532,151,7425,06,01360
"Alto CDP, California",370,341,29,659,06,01416
"Alturas city, California",1106,990,116,2683,06,01444
"Alum Rock CDP, California",6088,5767,321,11831,06,01458
"Amador City city, California",141,130,11,215,06,01514
"Amador Pines CDP, California",278,229,49,1058,06,01518
"American Canyon city, California",11393,10822,571,21669,06,01640
"Amesti CDP, California",1510,1408,102,3048,06,01651
"Anaheim city, California",186752,176716,10036,347111,06,02000
"Anchor Bay CDP, California",158,158,0,369,06,02028
"Anderson city, California",4860,4649,211,11267,06,02042
"Angels city, California",1475,1373,102,3714,06,02112
"Angwin CDP, California",1503,1416,87,2731,06,02168
"Antelope CDP, California",23482,21874,1608,47629,06,02210
"Antioch city, California",59553,54878,4675,115016,06,02252
"Anza CDP, California",989,887,102,1959,06,02294
"Apple Valley town, California",29922,27181,2741,75603,06,02364
"Aptos CDP, California",3407,3220,187,6614,06,02378
"Aptos Hills-Larkin Valley CDP, California",895,876,19,1746,06,02382
"Arbuckle CDP, California",1548,1525,23,3072,06,02420
"Arcadia city, California",26991,25539,1452,56181,06,02462
"Arcata city, California",11080,9544,1536,18536,06,02476
"Arden-Arcade CDP, California",47621,43770,3851,96076,06,02553
"Armona CDP, California",1804,1643,161,4367,06,02700
"Arnold CDP, California",794,755,39,1866,06,02770
"Aromas CDP, California",1437,1387,50,2744,06,02812
"Arroyo Grande city, California",8928,8730,198,18435,06,02868
"Artesia city, California",8199,7456,743,16237,06,02896
"Artois CDP, California",99,84,15,248,06,02910
"Arvin city, California",8161,7257,904,19613,06,02924
"Ashland CDP, California",12192,11357,835,23164,06,02980
"Aspen Springs CDP, California",145,145,0,202,06,03026
"Atascadero city, California",16085,15431,654,29758,06,03064
"Atherton town, California",3041,2974,67,7124,06,03092
"Atwater city, California",15027,13369,1658,31841,06,03162
"Auberry CDP, California",1352,1261,91,3032,06,03190
"Auburn city, California",6451,6265,186,13773,06,03204
"Auburn Lake Trails CDP, California",1828,1754,74,3846,06,03205
"August CDP, California",3650,3338,312,9089,06,03209
"Avalon city, California",2037,2037,0,3441,06,03274
"Avenal city, California",4108,3614,494,13423,06,03302
"Avery CDP, California",230,182,48,422,06,03316
"Avila Beach CDP, California",612,612,0,1599,06,03330
"Avocado Heights CDP, California",7193,6654,539,13470,06,03344
"Azusa city, California",26600,24987,1613,49704,06,03386
"Baker CDP, California",328,315,13,553,06,03512
"Bakersfield city, California",187100,173907,13193,404321,06,03526
"Bakersfield Country Club CDP, California",665,608,57,1638,06,03546
"Baldwin Park city, California",36436,33842,2594,71692,06,03666
"Ballard CDP, California",265,262,3,721,06,03694
"Ballico CDP, California",285,234,51,535,06,03708
"Bangor CDP, California",95,95,0,399,06,03792
"Banning city, California",11444,10480,964,29929,06,03820
"Barstow city, California",9889,8985,904,25235,06,04030
"Bass Lake CDP, California",111,111,0,318,06,04198
"Bay Point CDP, California",12810,11537,1273,24407,06,04415
"Bayview CDP (Contra Costa County), California",1544,1394,150,2529,06,04470
"Bayview CDP (Humboldt County), California",1247,1126,121,2719,06,04478
"Baywood Park CDP, California",717,682,35,1687,06,04549
"Beale AFB CDP, California",258,228,30,1107,06,04576
"Bear Creek CDP, California",72,72,0,251,06,04632
"Bear Valley CDP (Alpine County), California",59,46,13,72,06,04716
"Bear Valley CDP (Mariposa County), California",61,61,0,71,06,04730
"Bear Valley Springs CDP, California",2141,2073,68,5598,06,04734
"Beaumont city, California",24585,23220,1365,53544,06,04758
"Beckwourth CDP, California",217,217,0,457,06,04772
"Belden CDP, California",0,0,0,0,06,04856
"Bell city, California",15569,14552,1017,33377,06,04870
"Bella Vista CDP, California",1838,1684,154,3955,06,04926
"Bell Canyon CDP, California",823,810,13,1768,06,04938
"Bellflower city, California",41136,37670,3466,78352,06,04982
"Bell Gardens city, California",18031,16995,1036,39263,06,04996
"Belmont city, California",15656,14634,1022,27820,06,05108
"Belvedere city, California",933,920,13,2327,06,05164
"Benbow CDP, California",78,67,11,153,06,05262
"Bend CDP, California",172,172,0,414,06,05276
"Benicia city, California",14170,13583,587,27040,06,05290
"Ben Lomond CDP, California",3927,3598,329,7247,06,05332
"Benton CDP, California",158,156,2,393,06,05346
"Benton Park CDP, California",2771,2491,280,5836,06,05356
"Berkeley city, California",65788,62190,3598,121385,06,06000
"Bermuda Dunes CDP, California",3797,3525,272,7306,06,06028
"Berry Creek CDP, California",275,222,53,1006,06,06070
"Bertsch-Oceanview CDP, California",1092,1037,55,2222,06,06150
"Bethel Island CDP, California",931,773,158,1993,06,06210
"Beverly Hills city, California",16433,15025,1408,32406,06,06308
"Bieber CDP, California",33,33,0,151,06,06336
"Big Bear City CDP, California",5577,5115,462,12753,06,06406
"Big Bear Lake city, California",2305,2166,139,5059,06,06434
"Big Bend CDP, California",47,22,25,176,06,06475
"Big Creek CDP, California",27,23,4,97,06,06518
"Biggs city, California",1175,1058,117,2665,06,06560
"Big Lagoon CDP, California",33,33,0,104,06,06567
"Big Pine CDP, California",750,724,26,1563,06,06616
"Big River CDP, California",388,344,44,1028,06,06635
"Biola CDP, California",613,476,137,1335,06,06728
"Bishop city, California",2282,2220,62,3802,06,06798
"Blackhawk CDP, California",5260,5055,205,10622,06,06928
"Blacklake CDP, California",282,282,0,824,06,06935
"Black Point-Green Point CDP, California",822,787,35,1684,06,06982
"Blairsden CDP, California",0,0,0,0,06,06994
"Bloomfield CDP, California",120,120,0,197,06,07036
"Bloomington CDP, California",10593,9914,679,23051,06,07064
"Blue Lake city, California",414,382,32,841,06,07162
"Bluewater CDP, California",49,42,7,167,06,07172
"Blythe city, California",4924,4537,387,17949,06,07218
"Bodega CDP, California",244,170,74,547,06,07246
"Bodega Bay CDP, California",670,543,127,1186,06,07260
"Bodfish CDP, California",595,469,126,2320,06,07274
"Bolinas CDP, California",658,643,15,1280,06,07316
"Bombay Beach CDP, California",70,60,10,242,06,07372
"Bonadelle Ranchos CDP, California",2733,2614,119,5635,06,07378
"Bonita CDP, California",6960,6430,530,13473,06,07414
"Bonny Doon CDP, California",1365,1314,51,2858,06,07470
"Bonsall CDP, California",1939,1771,168,4131,06,07498
"Boonville CDP, California",390,352,38,995,06,07512
"Bootjack CDP, California",186,181,5,337,06,07525
"Boron CDP, California",1028,916,112,2469,06,07568
"Boronda CDP, California",1017,843,174,1885,06,07578
"Borrego Springs CDP, California",1258,1191,67,2946,06,07596
"Bostonia CDP, California",8579,7840,739,16850,06,07624
"Boulder Creek CDP, California",3098,2788,310,5492,06,07652
"Boulevard CDP, California",213,213,0,359,06,07694
"Bowles CDP, California",59,59,0,226,06,07750
"Boyes Hot Springs CDP, California",3642,3534,108,7374,06,07848
"Bradbury city, California",409,379,30,767,06,07946
"Bradley CDP, California",28,28,0,85,06,07974
"Brawley city, California",10913,8929,1984,26509,06,08058
"Brea city, California",25368,24087,1281,47099,06,08100
"Brentwood city, California",31735,29834,1901,64443,06,08142
"Bret Harte CDP, California",1722,1505,217,4926,06,08172
"Bridgeport CDP, California",218,218,0,408,06,08240
"Brisbane city, California",2663,2400,263,4756,06,08310
"Broadmoor CDP, California",2549,2424,125,4419,06,08338
"Brookdale CDP, California",700,676,24,1128,06,08478
"Brooks CDP, California",0,0,0,0,06,08506
"Brooktrails CDP, California",2240,2156,84,4440,06,08530
"Buckhorn CDP, California",1614,1518,96,3196,06,08680
"Buck Meadows CDP, California",0,0,0,0,06,08716
"Bucks Lake CDP, California",19,19,0,19,06,08744
"Buellton city, California",3113,3024,89,5151,06,08758
"Buena Park city, California",45935,43440,2495,83542,06,08786
"Buena Vista CDP, California",375,347,28,713,06,08828
"Burbank city, California",59118,55188,3930,106389,06,08954
"Burbank CDP, California",3315,3250,65,5234,06,08968
"Burlingame city, California",17546,16732,814,30995,06,09066
"Burney CDP, California",1065,915,150,3186,06,09122
"Burnt Ranch CDP, California",77,77,0,228,06,09150
"Butte Creek Canyon CDP, California",275,275,0,690,06,09310
"Butte Meadows CDP, California",0,0,0,0,06,09318
"Butte Valley CDP, California",259,259,0,811,06,09324
"Buttonwillow CDP, California",385,351,34,1148,06,09332
"Byron CDP, California",796,728,68,1918,06,09346
"Bystrom CDP, California",1334,1059,275,3941,06,09353
"Cabazon CDP, California",1040,1040,0,1946,06,09360
"Calabasas city, California",12032,10895,1137,23106,06,09598
"Calexico city, California",15551,12735,2816,38599,06,09710
"California City city, California",5531,4600,931,15002,06,09780
"California Hot Springs CDP, California",14,14,0,20,06,09822
"California Pines CDP, California",131,122,9,272,06,09834
"California Polytechnic State University CDP, California",2262,1932,330,6983,06,09835
"Calimesa city, California",4585,4481,104,10366,06,09864
"Calipatria city, California",1285,1099,186,6579,06,09878
"Calistoga city, California",2731,2715,16,5191,06,09892
"Callender CDP, California",1402,1402,0,2444,06,09948
"Calpella CDP, California",380,380,0,674,06,09990
"Calpine CDP, California",32,32,0,95,06,10004
"Calwa CDP, California",930,714,216,2486,06,10032
"Camanche North Shore CDP, California",351,325,26,1106,06,10042
"Camanche Village CDP, California",1040,1019,21,1945,06,10044
"Camarillo city, California",34706,33033,1673,70622,06,10046
"Cambria CDP, California",2425,2270,155,5825,06,10074
"Cambrian Park CDP, California",1884,1867,17,3551,06,10088
"Cameron Park CDP, California",8932,8385,547,17995,06,10256
"Camino CDP, California",921,830,91,2002,06,10270
"Camino Tassajara CDP, California",2548,2448,100,6238,06,10301
"Campbell city, California",24563,23613,950,43464,06,10345
"Camp Nelson CDP, California",73,73,0,73,06,10494
"Campo CDP, California",1356,1314,42,3468,06,10508
"Camp Pendleton Mainside CDP, California",704,602,102,9599,06,10554
"Camp Pendleton South CDP, California",2644,2127,517,13936,06,10561
"Camptonville CDP, California",69,60,9,224,06,10676
"Canby CDP, California",61,61,0,326,06,10732
"Cantua Creek CDP, California",154,154,0,522,06,10816
"Canyondam CDP, California",1,1,0,4,06,10914
"Canyon Lake city, California",5282,5087,195,11108,06,10928
"Capitola city, California",5354,5245,109,9921,06,11040
"Caribou CDP, California",0,0,0,0,06,11166
"Carlsbad city, California",58822,55297,3525,114745,06,11194
"Carmel-by-the-Sea city, California",1578,1563,15,3239,06,11250
"Carmel Valley Village CDP, California",2191,2095,96,4642,06,11324
"Carmet CDP, California",0,0,0,60,06,11376
"Carmichael CDP, California",39086,36933,2153,78144,06,11390
"Carnelian Bay CDP, California",336,336,0,534,06,11418
"Carpinteria city, California",7104,6780,324,13187,06,11446
"Carrick CDP, California",0,0,0,61,06,11481
"Carson city, California",48702,45363,3339,94475,06,11530
"Cartago CDP, California",35,35,0,68,06,11600
"Caruthers CDP, California",808,707,101,1950,06,11614
"Casa Conejo CDP, California",1497,1431,66,2711,06,11656
"Casa de Oro-Mount Helix CDP, California",9502,8842,660,20055,06,11691
"Casa Loma CDP, California",591,574,17,1431,06,11696
"Casmalia CDP, California",25,25,0,64,06,11754
"Caspar CDP, California",162,162,0,360,06,11768
"Cassel CDP, California",43,43,0,228,06,11782
"Castaic CDP, California",9655,9138,517,18643,06,11796
"Castella CDP, California",94,88,6,255,06,11824
"Castle Hill CDP, California",443,443,0,1010,06,11915
"Castro Valley CDP, California",34485,33144,1341,65444,06,11964
"Castroville CDP, California",2773,2700,73,6620,06,11978
"Cathedral City city, California",25424,23857,1567,51964,06,12048
"Catheys Valley CDP, California",232,222,10,723,06,12062
"Cayucos CDP, California",1266,1241,25,2361,06,12132
"Cazadero CDP, California",221,216,5,419,06,12146
"Cedar Flat CDP, California",545,506,39,948,06,12216
"Cedar Ridge CDP, California",738,691,47,1650,06,12300
"Cedar Slope CDP, California",0,0,0,0,06,12314
"Cedarville CDP, California",330,295,35,783,06,12328
"Centerville CDP (Fresno County), California",61,61,0,155,06,12412
"Centerville CDP (Shasta County), California",872,846,26,2204,06,12415
"Ceres city, California",21767,19477,2290,49183,06,12524
"Cerritos city, California",23658,22369,1289,49016,06,12552
"Chalfant CDP, California",259,233,26,605,06,12594
"Challenge-Brownsville CDP, California",212,205,7,866,06,12612
"Channel Islands Beach CDP, California",1561,1518,43,2708,06,12669
"Charleston View CDP, California",0,0,0,0,06,12730
"Charter Oak CDP, California",5245,4876,369,9335,06,12734
"Cherokee CDP, California",59,59,0,205,06,12818
"Cherokee Strip CDP, California",40,33,7,173,06,12860
"Cherryland CDP, California",7747,7337,410,15499,06,12902
"Cherry Valley CDP, California",3463,3074,389,7652,06,12916
"Chester CDP, California",1131,1108,23,2271,06,12930
"Chico city, California",56531,52638,3893,102790,06,13014
"Chilcoot-Vinton CDP, California",152,152,0,374,06,13077
"China Lake Acres CDP, California",1078,1005,73,2385,06,13157
"Chinese Camp CDP, California",40,16,24,54,06,13182
"Chino city, California",45408,42924,2484,91008,06,13210
"Chino Hills city, California",41083,38543,2540,78223,06,13214
"Choctaw Valley CDP, California",29,29,0,56,06,13278
"Chowchilla city, California",5675,5100,575,18772,06,13294
"Chualar CDP, California",419,412,7,959,06,13364
"Chula Vista city, California",139769,127435,12334,276103,06,13392
"Citrus CDP, California",5944,5602,342,10979,06,13560
"Citrus Heights city, California",45965,43056,2909,87127,06,13588
"Claremont city, California",18358,17324,1034,36891,06,13756
"Clarksburg CDP, California",258,207,51,302,06,13784
"Clay CDP, California",506,467,39,1121,06,13854
"Clayton city, California",5415,5120,295,11070,06,13882
"Clear Creek CDP, California",130,130,0,307,06,13910
"Clearlake city, California",6143,5120,1023,16612,06,13945
"Clearlake Oaks CDP, California",737,613,124,2074,06,13966
"Clearlake Riviera CDP, California",2293,2030,263,4461,06,13985
"Cleone CDP, California",449,348,101,774,06,14008
"Clio CDP, California",59,36,23,145,06,14106
"Clipper Mills CDP, California",110,110,0,314,06,14148
"Cloverdale city, California",4530,4357,173,8964,06,14190
"Clovis city, California",59475,55752,3723,120607,06,14218
"Clyde CDP, California",393,371,22,721,06,14232
"Coachella city, California",23601,20795,2806,42279,06,14260
"Coalinga city, California",6407,5653,754,17488,06,14274
"Coarsegold CDP, California",1996,1862,134,4578,06,14288
"Cobb CDP, California",309,309,0,685,06,14302
"Coffee Creek CDP, California",100,95,5,278,06,14406
"Cohasset CDP, California",245,222,23,392,06,14442
"Cold Springs CDP (El Dorado County), California",359,359,0,612,06,14450
"Cold Springs CDP (Tuolumne County), California",0,0,0,16,06,14454
"Coleville CDP, California",64,42,22,388,06,14484
"Colfax city, California",1147,1059,88,2230,06,14498
"College City CDP, California",126,126,0,343,06,14554
"Collierville CDP, California",1133,1075,58,2104,06,14708
"Colma town, California",763,710,53,1376,06,14736
"Coloma CDP, California",246,176,70,279,06,14764
"Colton city, California",26672,24701,1971,53959,06,14890
"Columbia CDP, California",1094,1003,91,2439,06,14904
"Colusa city, California",2886,2708,178,6380,06,14946
"Commerce city, California",5734,5453,281,12253,06,14974
"Comptche CDP, California",80,80,0,128,06,15030
"Compton city, California",44094,40591,3503,94822,06,15044
"Concord city, California",68335,64990,3345,125007,06,16000
"Concow CDP, California",116,108,8,244,06,16035
"Contra Costa Centre CDP, California",5146,4888,258,6884,06,16090
"Copperopolis CDP, California",1679,1519,160,3819,06,16210
"Corcoran city, California",5974,5303,671,22808,06,16224
"Corning city, California",3743,3609,134,8196,06,16322
"Corona city, California",81968,78212,3756,158346,06,16350
"Coronado city, California",6581,6253,328,18871,06,16378
"Coronita CDP, California",1651,1624,27,3235,06,16420
"Corralitos CDP, California",1199,1069,130,2154,06,16434
"Corte Madera town, California",5180,4909,271,10155,06,16462
"Costa Mesa city, California",67778,64362,3416,111490,06,16532
"Cotati city, California",4424,4191,233,7545,06,16560
"Coto de Caza CDP, California",8577,8219,358,15632,06,16580
"Cottonwood CDP (Kern County), California",855,654,201,2802,06,16623
"Cottonwood CDP (Shasta County), California",2972,2861,111,5893,06,16630
"Coulterville CDP, California",16,16,0,25,06,16644
"Country Club CDP, California",4603,4230,373,9686,06,16651
"Courtland CDP, California",296,296,0,654,06,16714
"Covelo CDP, California",497,366,131,1359,06,16728
"Covina city, California",28515,26893,1622,50717,06,16742
"Cowan CDP, California",124,73,51,263,06,16762
"Crescent City city, California",1840,1694,146,6379,06,17022
"Crescent Mills CDP, California",0,0,0,33,06,17050
"Cressey CDP, California",131,124,7,360,06,17078
"Crest CDP, California",1315,1244,71,3179,06,17106
"Crestline CDP, California",4565,4313,252,9335,06,17162
"Creston CDP, California",0,0,0,0,06,17232
"C-Road CDP, California",25,25,0,93,06,17267
"Crockett CDP, California",2062,1903,159,3574,06,17274
"Cromberg CDP, California",129,112,17,401,06,17288
"Crowley Lake CDP, California",649,649,0,1066,06,17372
"Crows Landing CDP, California",99,99,0,212,06,17428
"Cudahy city, California",10733,9743,990,22657,06,17498
"Culver City city, California",23040,21848,1192,40357,06,17568
"Cupertino city, California",29011,28140,871,59763,06,17610
"Cutler CDP, California",1849,1547,302,4429,06,17708
"Cutten CDP, California",1343,1290,53,3309,06,17722
"Cuyama CDP, California",6,6,0,9,06,17727
"Cypress city, California",25246,23968,1278,49955,06,17750
"Dales CDP, California",0,0,0,79,06,17876
"Daly City city, California",60955,57686,3269,103648,06,17918
"Dana Point city, California",17322,16546,776,33025,06,17946
"Danville town, California",21584,20634,950,43449,06,17988
"Daphnedale Park CDP, California",69,69,0,185,06,17995
"Darwin CDP, California",0,0,0,86,06,18030
"Davenport CDP, California",274,246,28,650,06,18086
"Davis city, California",34197,32230,1967,67203,06,18100
"Day Valley CDP, California",1363,1301,62,3252,06,18153
"Deer Park CDP, California",484,480,4,835,06,18324
"Del Aire CDP, California",5593,5434,159,10756,06,18352
"Delano city, California",20513,18493,2020,50498,06,18394
"Del Dios CDP, California",154,133,21,252,06,18422
"Delft Colony CDP, California",380,189,191,1038,06,18450
"Delhi CDP, California",5332,4838,494,10896,06,18464
"Delleker CDP, California",103,69,34,383,06,18485
"Del Mar city, California",2126,2084,42,3956,06,18506
"Del Monte Forest CDP, California",1138,1080,58,3416,06,18590
"Del Rey CDP, California",694,610,84,1491,06,18674
"Del Rey Oaks city, California",943,836,107,1611,06,18688
"Del Rio CDP, California",368,360,8,1146,06,18695
"Denair CDP, California",2222,2034,188,4289,06,18856
"Derby Acres CDP, California",152,127,25,416,06,18926
"Descanso CDP, California",849,849,0,1425,06,18940
"Desert Center CDP, California",79,70,9,191,06,18982
"Desert Edge CDP, California",1069,967,102,3715,06,18986
"Desert Hot Springs city, California",15408,14268,1140,32386,06,18996
"Desert Palms CDP, California",1151,1078,73,6414,06,19022
"Desert Shores CDP, California",152,135,17,360,06,19024
"Desert View Highlands CDP, California",1502,1404,98,3275,06,19052
"Diablo CDP, California",288,245,43,772,06,19150
"Diablo Grande CDP, California",504,476,28,1257,06,19155
"Diamond Bar city, California",28099,26650,1449,54534,06,19192
"Diamond Springs CDP, California",5472,5176,296,12197,06,19220
"Di Giorgio CDP, California",112,96,16,315,06,19248
"Dillon Beach CDP, California",224,198,26,442,06,19262
"Dinuba city, California",10964,9760,1204,24713,06,19318
"Discovery Bay CDP, California",7868,7443,425,15362,06,19339
"Dixon city, California",10426,10095,331,19071,06,19402
"Dixon Lane-MeadowCreek CDP, California",1264,1151,113,3043,06,19406
"Dobbins CDP, California",200,194,6,420,06,19416
"Dogtown CDP, California",1494,1434,60,2912,06,19440
"Dollar Point CDP, California",715,697,18,1233,06,19455
"Dorrington CDP, California",170,163,7,498,06,19570
"Dorris city, California",319,289,30,832,06,19584
"Dos Palos city, California",2484,2165,319,5755,06,19612
"Dos Palos Y CDP, California",93,63,30,185,06,19654
"Douglas City CDP, California",451,436,15,1103,06,19724
"Downey city, California",60052,56688,3364,113052,06,19766
"Downieville CDP, California",0,0,0,105,06,19794
"Doyle CDP, California",445,366,79,998,06,19878
"Drytown CDP, California",50,50,0,60,06,19976
"Duarte city, California",11248,10594,654,21686,06,19990
"Dublin city, California",37766,36473,1293,71068,06,20018
"Ducor CDP, California",256,235,21,701,06,20032
"Dunnigan CDP, California",376,376,0,1045,06,20228
"Dunsmuir city, California",793,724,69,1756,06,20242
"Durham CDP, California",3036,2859,177,6337,06,20270
"Dustin Acres CDP, California",186,186,0,529,06,20284
"Dutch Flat CDP, California",61,52,9,104,06,20298
"Eagleville CDP, California",4,4,0,13,06,20424
"Earlimart CDP, California",3432,2786,646,7674,06,20438
"East Bakersfield CDP, California",3936,3391,545,10754,06,20515
"Eastern Goleta Valley CDP, California",14020,13430,590,29563,06,20574
"East Foothills CDP, California",4591,4442,149,8270,06,20598
"East Hemet CDP, California",9123,8464,659,20261,06,20697
"East Los Angeles CDP, California",58134,54482,3652,117222,06,20802
"East Nicolaus CDP, California",70,67,3,163,06,20900
"East Niles CDP, California",11858,10837,1021,29981,06,20903
"East Oakdale CDP, California",939,889,50,2381,06,20907
"Easton CDP, California",1292,1187,105,2454,06,20928
"East Orosi CDP, California",169,169,0,422,06,20942
"East Palo Alto city, California",16426,15600,826,29520,06,20956
"East Pasadena CDP, California",2719,2659,60,5474,06,20984
"East Porterville CDP, California",2128,1588,540,5424,06,21012
"East Quincy CDP, California",1219,1204,15,2399,06,21026
"East Rancho Dominguez CDP, California",7145,6680,465,14924,06,21034
"East Richmond Heights CDP, California",1978,1851,127,3285,06,21061
"East San Gabriel CDP, California",11803,10929,874,22654,06,21096
"East Shore CDP, California",46,34,12,209,06,21138
"East Sonora CDP, California",888,888,0,2664,06,21188
"East Tulare Villa CDP, California",383,355,28,862,06,21210
"Eastvale city, California",36756,35112,1644,69594,06,21230
"East Whittier CDP, California",5171,4994,177,10248,06,21292
"Edgewood CDP, California",18,18,0,46,06,21530
"Edison CDP, California",217,217,0,490,06,21544
"Edmundson Acres CDP, California",145,143,2,335,06,21558
"Edna CDP, California",89,89,0,355,06,21565
"Edwards AFB CDP, California",342,304,38,2694,06,21600
"El Adobe CDP, California",61,52,9,240,06,21691
"El Cajon city, California",50803,46671,4132,105721,06,21712
"El Centro city, California",18630,16730,1900,44184,06,21782
"El Centro Naval Air Facility CDP, California",71,57,14,539,06,21788
"El Cerrito city, California",14665,13855,810,25869,06,21796
"El Cerrito CDP, California",2701,2616,85,5328,06,21810
"El Dorado Hills CDP, California",23151,22339,812,49082,06,21880
"Eldridge CDP, California",476,414,62,730,06,21894
"Elfin Forest CDP, California",260,260,0,595,06,21916
"El Granada CDP, California",3150,2889,261,5651,06,21936
"Elizabeth Lake CDP, California",972,887,85,1764,06,21964
"Elk Creek CDP, California",24,24,0,45,06,22006
"Elk Grove city, California",88594,82911,5683,176105,06,22020
"Elkhorn CDP, California",582,490,92,1285,06,22034
"El Macero CDP, California",404,404,0,1013,06,22104
"Elmira CDP, California",141,141,0,141,06,22146
"El Monte city, California",53624,49868,3756,108682,06,22230
"El Monte Mobile Village CDP, California",28,28,0,118,06,22235
"El Nido CDP, California",148,142,6,459,06,22286
"El Paso de Robles (Paso Robles) city, California",15463,14723,740,31595,06,22300
"El Portal CDP, California",299,299,0,479,06,22328
"El Rancho CDP, California",0,0,0,62,06,22360
"El Rio CDP, California",3233,2823,410,6418,06,22370
"El Segundo city, California",10523,9955,568,17081,06,22412
"El Sobrante CDP (Contra Costa County), California",8266,7802,464,15497,06,22454
"El Sobrante CDP (Riverside County), California",6936,6658,278,12127,06,22457
"El Verano CDP, California",1592,1411,181,3034,06,22510
"Elverta CDP, California",2603,2493,110,5102,06,22524
"Emerald Lake Hills CDP, California",2422,2361,61,4425,06,22587
"Emeryville city, California",9187,8737,450,12840,06,22594
"Empire CDP, California",1608,1385,223,3726,06,22622
"Encinitas city, California",32466,30984,1482,61942,06,22678
"Escalon city, California",3513,3232,281,7456,06,22790
"Escondido city, California",76223,72943,3280,151114,06,22804
"Esparto CDP, California",1823,1780,43,3600,06,22846
"Etna city, California",316,259,57,717,06,22972
"Eucalyptus Hills CDP, California",2999,2987,12,6491,06,23000
"Eureka city, California",13653,12276,1377,26519,06,23042
"Exeter city, California",4446,3841,605,10327,06,23126
"Fairbanks Ranch CDP, California",815,815,0,3014,06,23150
"Fairfax CDP, California",718,687,31,1776,06,23158
"Fairfax town, California",4575,4081,494,7567,06,23168
"Fairfield city, California",58759,55508,3251,119420,06,23182
"Fairhaven CDP, California",225,210,15,341,06,23196
"Fairmead CDP, California",479,429,50,1263,06,23210
"Fair Oaks CDP, California",17407,16606,801,32754,06,23294
"Fairview CDP, California",5791,5510,281,10583,06,23350
"Fallbrook CDP, California",14749,13664,1085,33710,06,23462
"Fall River Mills CDP, California",207,155,52,678,06,23532
"Farmersville city, California",4747,4283,464,10393,06,23616
"Farmington CDP, California",76,76,0,111,06,23630
"Fellows CDP, California",31,25,6,62,06,23812
"Felton CDP, California",2136,2073,63,3701,06,23826
"Ferndale city, California",653,596,57,1569,06,23910
"Fetters Hot Springs-Agua Caliente CDP, California",2358,2294,64,4224,06,23973
"Fiddletown CDP, California",10,10,0,56,06,23980
"Fieldbrook CDP, California",385,365,20,777,06,24008
"Fields Landing CDP, California",411,326,85,629,06,24022
"Fillmore city, California",8341,8026,315,16455,06,24092
"Firebaugh city, California",2896,2365,531,8139,06,24134
"Fish Camp CDP, California",0,0,0,0,06,24218
"Florence-Graham CDP, California",29282,26286,2996,63132,06,24477
"Florin CDP, California",23479,21342,2137,49992,06,24498
"Floriston CDP, California",0,0,0,23,06,24526
"Flournoy CDP, California",28,28,0,95,06,24568
"Folsom city, California",40170,38168,2002,81077,06,24638
"Fontana city, California",105847,99246,6601,209279,06,24680
"Foothill Farms CDP, California",17471,16119,1352,37635,06,24722
"Forbestown CDP, California",21,12,9,372,06,24750
"Ford City CDP, California",1911,1513,398,4357,06,24764
"Foresta CDP, California",43,19,24,75,06,24792
"Foresthill CDP, California",203,203,0,1178,06,24834
"Forest Meadows CDP, California",631,596,35,1485,06,24897
"Forest Ranch CDP, California",1178,1117,61,1686,06,24918
"Forestville CDP, California",2067,1986,81,3632,06,24960
"Fort Bidwell CDP, California",81,72,9,169,06,25030
"Fort Bragg city, California",2539,2368,171,7007,06,25058
"Fort Dick CDP, California",458,429,29,1295,06,25086
"Fort Hunter Liggett CDP, California",74,65,9,874,06,25093
"Fort Irwin CDP, California",1517,1284,233,8967,06,25114
"Fort Jones city, California",217,184,33,618,06,25128
"Fortuna city, California",5926,5614,312,12527,06,25296
"Fort Washington CDP, California",80,80,0,158,06,25300
"Foster City city, California",17671,16912,759,33215,06,25338
"Fountain Valley city, California",29314,27543,1771,56754,06,25380
"Fowler city, California",2793,2556,237,6819,06,25436
"Franklin CDP (Merced County), California",3068,2865,203,7581,06,25488
"Franklin CDP (Sacramento County), California",6,6,0,25,06,25506
"Frazier Park CDP, California",1439,1296,143,2719,06,25534
"Freedom CDP, California",1759,1587,172,3360,06,25576
"Freeport CDP, California",0,0,0,0,06,25590
"Fremont city, California",122752,117785,4967,228795,06,26000
"French Camp CDP, California",1389,1364,25,3860,06,26028
"French Gulch CDP, California",105,103,2,283,06,26056
"French Valley CDP, California",17909,16534,1375,41239,06,26067
"Fresno city, California",252276,229470,22806,541528,06,27000
"Friant CDP, California",182,182,0,317,06,27014
"Fruitdale CDP, California",818,780,38,1219,06,27080
"Fruitridge Pocket CDP, California",2118,1983,135,5596,06,27130
"Fuller Acres CDP, California",256,228,28,717,06,27190
"Fullerton city, California",74235,69141,5094,142280,06,28000
"Fulton CDP, California",339,339,0,749,06,28014
"Furnace Creek CDP, California",118,116,2,130,06,28021
"Galt city, California",12871,12102,769,25350,06,28112
"Garberville CDP, California",828,813,15,1815,06,28154
"Gardena city, California",32082,30698,1384,60377,06,28168
"Garden Acres CDP, California",4606,4030,576,10124,06,28182
"Garden Farms CDP, California",139,139,0,370,06,28210
"Garden Grove city, California",89924,84716,5208,171637,06,29000
"Garey CDP, California",30,23,7,52,06,29070
"Garnet CDP, California",3248,3138,110,7328,06,29112
"Gasquet CDP, California",159,152,7,366,06,29154
"Gazelle CDP, California",37,35,2,123,06,29252
"Georgetown CDP, California",841,689,152,2546,06,29350
"Gerber CDP, California",420,404,16,1084,06,29392
"Geyserville CDP, California",484,452,32,837,06,29420
"Gilroy city, California",29278,27541,1737,58696,06,29504
"Glendale city, California",101811,93528,8283,194512,06,30000
"Glendora city, California",25955,24366,1589,52095,06,30014
"Glen Ellen CDP, California",527,503,24,998,06,30028
"Glennville CDP, California",0,0,0,33,06,30126
"Golden Hills CDP, California",4866,4557,309,9892,06,30282
"Gold Mountain CDP, California",27,27,0,97,06,30339
"Gold River CDP, California",3865,3729,136,7910,06,30345
"Goleta city, California",18450,17704,746,32640,06,30378
"Gonzales city, California",3955,3764,191,8581,06,30392
"Good Hope CDP, California",3714,3255,459,8291,06,30410
"Goodmanville CDP, California",5,5,0,43,06,30412
"Goodyears Bar CDP, California",65,65,0,65,06,30420
"Goshen CDP, California",2352,2248,104,4974,06,30476
"Graeagle CDP, California",90,90,0,401,06,30560
"Grand Terrace city, California",7140,6479,661,13104,06,30658
"Grangeville CDP, California",85,85,0,244,06,30686
"Granite Bay CDP, California",10404,10003,401,22180,06,30693
"Granite Hills CDP, California",2113,1809,304,4525,06,30703
"Graniteville CDP, California",0,0,0,12,06,30714
"Grass Valley city, California",6028,5887,141,13964,06,30798
"Graton CDP, California",874,822,52,1671,06,30812
"Grayson CDP, California",881,863,18,1593,06,30882
"Greeley Hill CDP, California",387,368,19,960,06,30900
"Greenacres CDP, California",2140,1923,217,4562,06,30938
"Green Acres CDP, California",1436,1219,217,3023,06,30944
"Greenfield CDP, California",1681,1425,256,4417,06,30987
"Greenfield city, California",7565,7467,98,18998,06,30994
"Greenhorn CDP, California",53,53,0,174,06,31029
"Green Valley CDP (Los Angeles County), California",400,343,57,832,06,31092
"Green Valley CDP (Solano County), California",758,758,0,1586,06,31099
"Greenview CDP, California",45,45,0,94,06,31134
"Greenville CDP, California",532,452,80,705,06,31162
"Grenada CDP, California",119,92,27,230,06,31246
"Gridley city, California",3333,2974,359,7444,06,31260
"Grimes CDP, California",183,157,26,355,06,31288
"Grizzly Flats CDP, California",599,599,0,1374,06,31302
"Groveland CDP, California",165,165,0,591,06,31372
"Grover Beach city, California",6708,6500,208,12757,06,31393
"Guadalupe city, California",3749,3393,356,8272,06,31414
"Guerneville CDP, California",2510,2284,226,4764,06,31470
"Guinda CDP, California",100,100,0,194,06,31540
"Gustine city, California",2513,2154,359,6122,06,31568
"Hacienda Heights CDP, California",27467,25979,1488,55461,06,31596
"Half Moon Bay city, California",6279,6161,118,11633,06,31708
"Hamilton Branch CDP, California",164,164,0,454,06,31883
"Hamilton City CDP, California",1192,1073,119,2191,06,31890
"Hanford city, California",25030,22983,2047,57920,06,31960
"Happy Camp CDP, California",252,185,67,679,06,32030
"Happy Valley CDP, California",2694,2325,369,5532,06,32036
"Harbison Canyon CDP, California",2224,2018,206,4137,06,32044
"Hardwick CDP, California",86,78,8,160,06,32156
"Harmony Grove CDP, California",1127,1127,0,2039,06,32212
"Hartland CDP, California",0,0,0,0,06,32324
"Hartley CDP, California",1265,1243,22,2807,06,32340
"Hasley Canyon CDP, California",579,477,102,1236,06,32385
"Hat Creek CDP, California",7,6,1,71,06,32408
"Hawaiian Gardens city, California",7098,6750,348,14011,06,32506
"Hawthorne city, California",46900,43387,3513,86978,06,32548
"Hayfork CDP, California",513,513,0,3227,06,32562
"Hayward city, California",88189,83166,5023,160602,06,33000
"Healdsburg city, California",5874,5517,357,11481,06,33056
"Heber CDP, California",3061,2923,138,7910,06,33084
"Hemet city, California",34748,31430,3318,89651,06,33182
"Herald CDP, California",455,432,23,1050,06,33294
"Hercules city, California",14352,13727,625,26041,06,33308
"Herlong CDP, California",112,103,9,1280,06,33336
"Hermosa Beach city, California",11479,10912,567,19551,06,33364
"Hesperia city, California",42838,38658,4180,99878,06,33434
"Hickman CDP, California",469,386,83,810,06,33504
"Hidden Hills city, California",930,886,44,2107,06,33518
"Hidden Meadows CDP, California",1760,1457,303,3698,06,33532
"Hidden Valley Lake CDP, California",2315,2053,262,5852,06,33549
"Highgrove CDP, California",3768,3603,165,7069,06,33574
"Highland city, California",26946,25328,1618,56789,06,33588
"Highlands CDP, California",1409,1336,73,2730,06,33632
"Hillcrest CDP, California",4164,3841,323,10495,06,33689
"Hillsborough town, California",5236,4955,281,11258,06,33798
"Hilmar-Irwin CDP, California",2688,2459,229,6484,06,33861
"Hiouchi CDP, California",49,49,0,141,06,33935
"Hollister city, California",21880,20478,1402,42093,06,34120
"Holtville city, California",2203,1956,247,5620,06,34246
"Home Garden CDP, California",580,517,63,1511,06,34281
"Home Gardens CDP, California",5789,5551,238,12278,06,34302
"Homeland CDP, California",2556,2279,277,6221,06,34316
"Homestead Valley CDP, California",917,770,147,2546,06,34392
"Homewood Canyon CDP, California",155,155,0,224,06,34405
"Honcut CDP, California",81,48,33,313,06,34428
"Hood CDP, California",148,131,17,314,06,34484
"Hoopa CDP, California",883,725,158,2489,06,34540
"Hopland CDP, California",493,404,89,1025,06,34652
"Hornbrook CDP, California",150,121,29,381,06,34694
"Hornitos CDP, California",15,15,0,54,06,34708
"Hughson city, California",3772,3519,253,7523,06,34904
"Humboldt Hill CDP, California",1573,1489,84,3273,06,34928
"Huntington Beach city, California",110472,104470,6002,197481,06,36000
"Huntington Park city, California",28066,25236,2830,54547,06,36056
"Huron city, California",2780,2434,346,6260,06,36084
"Hyampom CDP, California",176,66,110,328,06,36098
"Hydesville CDP, California",394,394,0,1060,06,36126
"Hypericum CDP, California",99,99,0,207,06,36135
"Idlewild CDP, California",10,10,0,48,06,36168
"Idyllwild-Pine Cove CDP, California",1906,1737,169,3491,06,36203
"Igo CDP, California",42,42,0,95,06,36252
"Imperial city, California",8244,7364,880,20430,06,36280
"Imperial Beach city, California",13564,12588,976,26157,06,36294
"Independence CDP, California",274,252,22,850,06,36350
"Indian Falls CDP, California",0,0,0,0,06,36364
"Indianola CDP, California",338,275,63,717,06,36420
"Indian Wells city, California",1748,1637,111,4832,06,36434
"Indio city, California",43069,39916,3153,89616,06,36448
"Indio Hills CDP, California",280,194,86,605,06,36452
"Industry city, California",92,85,7,234,06,36490
"Inglewood city, California",58241,53440,4801,106806,06,36546
"Interlaken CDP, California",3718,3517,201,8039,06,36613
"Inverness CDP, California",743,649,94,1469,06,36616
"Inyokern CDP, California",467,363,104,922,06,36658
"Ione city, California",2494,2467,27,5364,06,36672
"Iron Horse CDP, California",49,49,0,418,06,36735
"Irvine city, California",160415,151513,8902,304527,06,36770
"Irwindale city, California",727,694,33,1343,06,36826
"Isla Vista CDP, California",8396,6920,1476,14722,06,36868
"Isleton city, California",275,227,48,538,06,36882
"Ivanhoe CDP, California",1901,1812,89,4329,06,36910
"Jackson city, California",2101,1996,105,5004,06,36980
"Jacumba CDP, California",421,333,88,857,06,37022
"Jamestown CDP, California",1473,1380,93,3742,06,37106
"Jamul CDP, California",2783,2684,99,6018,06,37120
"Janesville CDP, California",1061,998,63,2641,06,37134
"Jenner CDP, California",16,16,0,16,06,37274
"Johannesburg CDP, California",44,34,10,94,06,37400
"Johnson Park CDP, California",259,251,8,761,06,37442
"Johnstonville CDP, California",436,382,54,1090,06,37484
"Johnsville CDP, California",0,0,0,0,06,37512
"Jones Valley CDP, California",540,510,30,969,06,37533
"Joshua Tree CDP, California",2855,2545,310,6751,06,37554
"Jovista CDP, California",34,24,10,43,06,37568
"Julian CDP, California",647,647,0,1377,06,37582
"Junction City CDP, California",562,523,39,1195,06,37596
"June Lake CDP, California",199,199,0,302,06,37624
"Jurupa Valley city, California",51892,48366,3526,105672,06,37692
"Keddie CDP, California",19,19,0,67,06,37904
"Keeler CDP, California",5,0,5,28,06,37918
"Keene CDP, California",199,199,0,404,06,37946
"Kelly Ridge CDP, California",1174,1107,67,3168,06,38024
"Kelseyville CDP, California",1660,1426,234,3828,06,38044
"Kennedy CDP, California",1038,948,90,2516,06,38065
"Kennedy Meadows CDP, California",0,0,0,93,06,38076
"Kensington CDP, California",2805,2629,176,5309,06,38086
"Kentfield CDP, California",3495,3316,179,7410,06,38114
"Kenwood CDP, California",361,361,0,609,06,38156
"Kep'el CDP, California",6,6,0,19,06,38177
"Kerman city, California",6913,6030,883,15980,06,38226
"Kernville CDP, California",312,254,58,836,06,38310
"Keswick CDP, California",30,24,6,138,06,38352
"Kettleman City CDP, California",590,544,46,956,06,38394
"Keyes CDP, California",2293,2089,204,5827,06,38422
"King City city, California",5054,4800,254,13471,06,38520
"Kings Beach CDP, California",1594,1594,0,2589,06,38548
"Kingsburg city, California",5426,5128,298,12490,06,38562
"Kingvale CDP, California",57,57,0,85,06,38604
"Kirkwood CDP, California",102,102,0,249,06,38646
"Klamath CDP, California",295,242,53,924,06,38702
"Knightsen CDP, California",811,758,53,1646,06,38772
"Knights Ferry CDP, California",55,55,0,72,06,38786
"Knights Landing CDP, California",384,320,64,987,06,38800
"La Cañada Flintridge city, California",9014,8609,405,20378,06,39003
"La Crescenta-Montrose CDP, California",10240,9468,772,20092,06,39045
"La Cresta CDP, California",3619,3308,311,8468,06,39052
"Ladera CDP, California",706,615,91,1427,06,39094
"Ladera Heights CDP, California",3600,3477,123,6710,06,39108
"Ladera Ranch CDP, California",12201,11867,334,24323,06,39114
"Lafayette city, California",12785,11976,809,25310,06,39122
"La Grange CDP, California",31,23,8,143,06,39164
"Laguna Beach city, California",12143,11322,821,22943,06,39178
"Laguna Hills city, California",17018,16163,855,31170,06,39220
"Laguna Niguel city, California",36217,34218,1999,64259,06,39248
"Laguna Woods city, California",4001,3667,334,17452,06,39259
"Lagunitas-Forest Knolls CDP, California",999,976,23,1747,06,39283
"La Habra city, California",34694,32203,2491,62904,06,39290
"La Habra Heights city, California",2958,2904,54,5599,06,39304
"La Honda CDP, California",1005,997,8,1422,06,39318
"Lake Almanor Country Club CDP, California",159,117,42,529,06,39411
"Lake Almanor Peninsula CDP, California",112,104,8,319,06,39420
"Lake Almanor West CDP, California",76,76,0,322,06,39425
"Lake Arrowhead CDP, California",4557,4296,261,10189,06,39444
"Lake California CDP, California",1635,1527,108,3639,06,39460
"Lake City CDP, California",20,20,0,32,06,39472
"Lake Davis CDP, California",81,81,0,105,06,39483
"Lake Don Pedro CDP, California",541,522,19,1215,06,39484
"Lake Elsinore city, California",34385,31997,2388,69993,06,39486
"Lake Forest city, California",48506,46072,2434,85583,06,39496
"Lakehead CDP, California",236,218,18,569,06,39514
"Lake Hughes CDP, California",434,355,79,867,06,39556
"Lake Isabella CDP, California",929,836,93,3514,06,39570
"Lakeland Village CDP, California",4873,4648,225,10565,06,39598
"Lake Los Angeles CDP, California",4265,3925,340,13097,06,39612
"Lake Mathews CDP, California",2481,2191,290,6494,06,39645
"Lake Nacimiento CDP, California",1474,1399,75,3205,06,39670
"Lake of the Pines CDP, California",2017,1948,69,4703,06,39690
"Lake of the Woods CDP, California",231,152,79,729,06,39696
"Lakeport city, California",1738,1660,78,5014,06,39710
"Lake Riverside CDP, California",567,501,66,1417,06,39715
"Lake San Marcos CDP, California",1800,1719,81,4080,06,39724
"Lake Shastina CDP, California",1238,1140,98,3008,06,39728
"Lake Sherwood CDP, California",732,680,52,1617,06,39735
"Lakeside CDP (Kern County), California",491,331,160,1405,06,39759
"Lakeside CDP (San Diego County), California",10208,9422,786,21759,06,39766
"Lakeview CDP, California",1045,993,52,2327,06,39836
"Lake Wildwood CDP, California",1735,1660,75,4974,06,39885
"Lakewood city, California",45208,42640,2568,81499,06,39892
"La Mesa city, California",33091,30940,2151,60888,06,40004
"La Mirada city, California",24583,23355,1228,47644,06,40032
"Lamont CDP, California",5493,4972,521,13715,06,40088
"Lanare CDP, California",294,250,44,528,06,40116
"Lancaster city, California",70198,64930,5268,171465,06,40130
"La Palma city, California",8150,7769,381,15522,06,40256
"La Porte CDP, California",35,35,0,52,06,40312
"La Presa CDP, California",18477,16872,1605,38618,06,40326
"La Puente city, California",19141,17987,1154,37835,06,40340
"La Quinta city, California",16632,15286,1346,37933,06,40354
"La Riviera CDP, California",6638,6417,221,11652,06,40410
"Larkfield-Wikiup CDP, California",3694,3584,110,7688,06,40426
"Larkspur city, California",7188,6856,332,12969,06,40438
"La Selva Beach CDP, California",1239,1194,45,2320,06,40508
"Las Flores CDP (Orange County), California",3372,3256,116,5757,06,40526
"Las Flores CDP (Tehama County), California",54,54,0,128,06,40536
"Las Lomas CDP, California",1453,1408,45,3059,06,40592
"Lathrop city, California",14063,12805,1258,29633,06,40704
"Laton CDP, California",595,547,48,1301,06,40746
"La Verne city, California",15650,14646,1004,31239,06,40830
"La Vina CDP, California",278,199,79,912,06,40872
"Lawndale city, California",18269,16756,1513,31553,06,40886
"Laytonville CDP, California",253,235,18,552,06,40928
"Lebec CDP, California",420,363,57,913,06,40956
"Lee Vining CDP, California",261,228,33,594,06,40998
"Leggett CDP, California",22,22,0,46,06,41026
"Le Grand CDP, California",742,664,78,1679,06,41040
"Lemon Cove CDP, California",151,143,8,498,06,41110
"Lemon Grove city, California",13801,12672,1129,27482,06,41124
"Lemon Hill CDP, California",6244,5684,560,14824,06,41142
"Lemoore city, California",11675,10389,1286,26955,06,41152
"Lemoore Station CDP, California",925,843,82,6403,06,41166
"Lennox CDP, California",11491,10733,758,20687,06,41180
"Lenwood CDP, California",1522,1420,102,4016,06,41194
"Leona Valley CDP, California",654,615,39,1569,06,41208
"Lewiston CDP, California",862,828,34,2218,06,41278
"Lexington Hills CDP, California",1529,1514,15,2587,06,41282
"Likely CDP, California",0,0,0,0,06,41390
"Lincoln city, California",20609,19741,868,50131,06,41474
"Lincoln Village CDP, California",2017,1823,194,4508,06,41558
"Linda CDP, California",9021,8095,926,23262,06,41572
"Lindcove CDP, California",107,99,8,236,06,41656
"Linden CDP, California",866,757,109,1845,06,41670
"Lindsay city, California",5135,4258,877,12581,06,41712
"Linnell Camp CDP, California",272,272,0,737,06,41740
"Litchfield CDP, California",67,67,0,134,06,41782
"Little Grass Valley CDP, California",0,0,0,0,06,41789
"Little River CDP, California",98,98,0,223,06,41866
"Littlerock CDP, California",679,628,51,1509,06,41880
"Little Valley CDP, California",0,0,0,10,06,41908
"Live Oak CDP, California",9675,9226,449,17707,06,41922
"Live Oak city, California",4177,3842,335,9222,06,41936
"Livermore city, California",48485,46862,1623,87154,06,41992
"Livingston city, California",6925,6227,698,14344,06,42006
"Lockeford CDP, California",1911,1791,120,4126,06,42104
"Lockwood CDP (Amador County), California",242,242,0,495,06,42142
"Lockwood CDP (Monterey County), California",170,154,16,235,06,42146
"Lodi city, California",33375,30203,3172,66509,06,42202
"Lodoga CDP, California",83,83,0,201,06,42230
"Loleta CDP, California",269,235,34,532,06,42328
"Loma Linda city, California",12166,11293,873,24883,06,42370
"Loma Mar CDP, California",78,78,0,112,06,42384
"Loma Rica CDP, California",1021,972,49,2605,06,42412
"Lomita city, California",11482,11092,390,20662,06,42468
"Lompico CDP, California",516,499,17,911,06,42510
"Lompoc city, California",19924,18330,1594,44086,06,42524
"London CDP, California",692,618,74,1785,06,42566
"Lone Pine CDP, California",370,351,19,1323,06,42580
"Long Barn CDP, California",0,0,0,42,06,42622
"Long Beach city, California",251134,234567,16567,462293,06,43000
"Lookout CDP, California",9,9,0,37,06,43126
"Loomis town, California",3086,2962,124,6831,06,43140
"Los Alamitos city, California",6306,5840,466,11728,06,43224
"Los Alamos CDP, California",431,402,29,834,06,43252
"Los Altos city, California",14342,13789,553,31133,06,43280
"Los Altos Hills town, California",3845,3738,107,8441,06,43294
"Los Angeles city, California",2128400,1963533,164867,3881041,06,44000
"Los Banos city, California",18353,16910,1443,45560,06,44028
"Los Berros CDP, California",42,42,0,182,06,44042
"Los Gatos town, California",16305,15535,770,33093,06,44112
"Los Molinos CDP, California",572,510,62,1649,06,44140
"Los Olivos CDP, California",468,426,42,1020,06,44168
"Los Osos CDP, California",7744,7314,430,15523,06,44182
"Los Ranchos CDP, California",614,598,16,1571,06,44242
"Lost Hills CDP, California",738,705,33,1754,06,44280
"Lower Lake CDP, California",499,487,12,1326,06,44350
"Loyalton city, California",373,366,7,997,06,44364
"Loyola CDP, California",1606,1562,44,3818,06,44378
"Lucas Valley-Marinwood CDP, California",3319,3238,81,6334,06,44399
"Lucerne CDP, California",1424,1295,129,3085,06,44406
"Lucerne Valley CDP, California",2154,1687,467,6212,06,44420
"Lynwood city, California",31034,28043,2991,66346,06,44574
"Lytle Creek CDP, California",252,221,31,528,06,44644
"Mabie CDP, California",133,66,67,212,06,44672
"McArthur CDP, California",169,150,19,425,06,44700
"McClellan Park CDP, California",454,441,13,1193,06,44760
"McClenney Tract CDP, California",0,0,0,20,06,44770
"McCloud CDP, California",367,329,38,959,06,44784
"Macdoel CDP, California",77,77,0,143,06,44812
"McFarland city, California",5498,5148,350,13971,06,44826
"McGee Creek CDP, California",0,0,0,0,06,44830
"McKinleyville CDP, California",8009,7304,705,16913,06,44910
"McKittrick CDP, California",46,40,6,93,06,44924
"McSwain CDP, California",2285,2191,94,5042,06,45006
"Madeline CDP, California",0,0,0,31,06,45008
"Madera city, California",30158,26304,3854,66784,06,45022
"Madera Acres CDP, California",4217,3884,333,9794,06,45050
"Madera Ranchos CDP, California",1385,1325,60,3357,06,45054
"Madison CDP, California",208,208,0,455,06,45064
"Mad River CDP, California",72,67,5,322,06,45092
"Magalia CDP, California",3651,3358,293,9245,06,45120
"Malaga CDP, California",421,389,32,753,06,45232
"Malibu city, California",5039,4763,276,10698,06,45246
"Mammoth Lakes town, California",4482,4430,52,7253,06,45358
"Manchester CDP, California",250,236,14,298,06,45386
"Manhattan Beach city, California",16614,15976,638,35123,06,45400
"Manila CDP, California",367,347,20,663,06,45414
"Manteca city, California",38916,36411,2505,83897,06,45484
"Manton CDP, California",33,33,0,305,06,45512
"March ARB CDP, California",209,209,0,1175,06,45680
"Maricopa city, California",500,426,74,1217,06,45736
"Marina city, California",11932,11229,703,22253,06,45778
"Marina del Rey CDP, California",7868,7459,409,10274,06,45806
"Marin City CDP, California",1794,1682,112,3419,06,45820
"Mariposa CDP, California",306,281,25,1060,06,45932
"Markleeville CDP, California",48,48,0,163,06,45988
"Martell CDP, California",141,141,0,219,06,46100
"Martinez city, California",20487,19492,995,37093,06,46114
"Marysville city, California",5370,4959,411,12681,06,46170
"Matheny CDP, California",395,379,16,766,06,46223
"Mather CDP, California",2421,2390,31,4712,06,46226
"Maxwell CDP, California",499,451,48,1181,06,46338
"Mayfair CDP, California",2223,2030,193,4937,06,46400
"Mayflower Village CDP, California",2661,2575,86,5209,06,46436
"Maywood city, California",12209,11523,686,25009,06,46492
"Meadowbrook CDP, California",1365,1244,121,3409,06,46520
"Meadow Valley CDP, California",138,138,0,434,06,46618
"Meadow Vista CDP, California",1602,1555,47,3589,06,46632
"Mead Valley CDP, California",9788,9168,620,20581,06,46646
"Mecca CDP, California",3691,3305,386,6313,06,46660
"Meiners Oaks CDP, California",1771,1725,46,3914,06,46702
"Mendocino CDP, California",443,429,14,731,06,46814
"Mendota city, California",5077,4500,577,12603,06,46828
"Menifee city, California",45512,42272,3240,103680,06,46842
"Menlo Park city, California",17312,16570,742,33324,06,46870
"Mentone CDP, California",4817,4644,173,9707,06,46884
"Merced city, California",39494,34529,4965,87686,06,46898
"Meridian CDP, California",141,130,11,376,06,46926
"Mesa CDP, California",174,174,0,374,06,47013
"Mesa Verde CDP, California",401,369,32,926,06,47066
"Mesa Vista CDP, California",140,135,5,246,06,47086
"Mettler CDP, California",48,45,3,122,06,47164
"Mexican Colony CDP, California",180,173,7,302,06,47192
"Meyers CDP, California",1267,1232,35,2140,06,47206
"Middletown CDP, California",876,782,94,1748,06,47332
"Midpines CDP, California",122,122,0,183,06,47374
"Midway City CDP, California",3715,3385,330,8032,06,47430
"Milford CDP, California",0,0,0,0,06,47472
"Millbrae city, California",12398,11740,658,22825,06,47486
"Millerton CDP, California",356,356,0,726,06,47592
"Mill Valley city, California",7186,6656,530,14199,06,47710
"Millville CDP, California",446,422,24,794,06,47724
"Milpitas city, California",43836,41858,1978,79092,06,47766
"Mineral CDP, California",48,48,0,77,06,47794
"Minkler CDP, California",274,274,0,683,06,47822
"Mira Monte CDP, California",3095,2818,277,6837,06,48046
"Miranda CDP, California",208,208,0,656,06,48060
"Mission Canyon CDP, California",1365,1344,21,2500,06,48147
"Mission Hills CDP, California",1817,1727,90,3458,06,48186
"Mission Viejo city, California",48917,46761,2156,93233,06,48256
"Mi-Wuk Village CDP, California",515,445,70,1010,06,48298
"Modesto city, California",102579,94533,8046,218308,06,48354
"Modjeska CDP, California",370,361,9,756,06,48410
"Mohawk Vista CDP, California",20,20,0,28,06,48448
"Mojave CDP, California",1559,1437,122,3865,06,48452
"Mokelumne Hill CDP, California",354,354,0,808,06,48480
"Monmouth CDP, California",66,62,4,202,06,48592
"Mono City CDP, California",111,111,0,223,06,48602
"Mono Vista CDP, California",1933,1787,146,3620,06,48641
"Monrovia city, California",20676,19475,1201,37656,06,48648
"Monson CDP, California",63,63,0,143,06,48676
"Montague city, California",604,545,59,1484,06,48690
"Montalvin Manor CDP, California",1124,1085,39,2195,06,48718
"Montara CDP, California",1650,1478,172,2649,06,48760
"Montclair city, California",18270,17108,1162,37842,06,48788
"Montebello city, California",32167,29987,2180,62056,06,48816
"Montecito CDP, California",3213,3052,161,8529,06,48844
"Monterey city, California",15001,14262,739,30007,06,48872
"Monterey Park city, California",29924,28190,1734,60386,06,48914
"Monterey Park Tract CDP, California",82,63,19,138,06,48916
"Monte Rio CDP, California",413,383,30,771,06,48928
"Monte Sereno city, California",1541,1527,14,3444,06,48956
"Montgomery Creek CDP, California",121,88,33,214,06,48998
"Monument Hills CDP, California",627,613,14,1281,06,49045
"Moorpark city, California",19199,18221,978,36073,06,49138
"Morada CDP, California",1573,1546,27,3335,06,49180
"Moraga town, California",7875,7460,415,16859,06,49187
"Moreno Valley city, California",102460,94746,7714,209578,06,49270
"Morgan Hill city, California",23026,21906,1120,45291,06,49278
"Morongo Valley CDP, California",1481,1350,131,3387,06,49348
"Morro Bay city, California",5436,4938,498,10766,06,49362
"Moskowite Corner CDP, California",77,77,0,146,06,49432
"Moss Beach CDP, California",1494,1491,3,3165,06,49446
"Moss Landing CDP, California",5,5,0,9,06,49488
"Mountain Center CDP, California",20,20,0,44,06,49544
"Mountain Gate CDP, California",246,246,0,819,06,49558
"Mountain House CDP, California",11203,10798,405,23590,06,49582
"Mountain Meadows CDP, California",125,125,0,254,06,49592
"Mountain Mesa CDP, California",60,60,0,572,06,49600
"Mountain Ranch CDP, California",36,36,0,293,06,49628
"Mountain View CDP, California",1317,1289,28,2166,06,49651
"Mountain View city, California",48782,47113,1669,82132,06,49670
"Mountain View Acres CDP, California",1233,1144,89,3457,06,49684
"Mt. Bullion CDP, California",12,12,0,80,06,49726
"Mount Hebron CDP, California",59,46,13,113,06,49768
"Mount Hermon CDP, California",641,641,0,1174,06,49796
"Mount Laguna CDP, California",43,28,15,104,06,49810
"Mount Shasta city, California",1378,1356,22,3235,06,49852
"Muir Beach CDP, California",212,196,16,407,06,49950
"Murphys CDP, California",757,739,18,2022,06,50034
"Murrieta city, California",53194,49610,3584,111899,06,50076
"Muscoy CDP, California",4987,4566,421,11802,06,50132
"Myers Flat CDP, California",84,84,0,208,06,50146
"Myrtletown CDP, California",2059,1905,154,4946,06,50188
"Napa city, California",42718,40226,2492,79233,06,50258
"National City city, California",27525,25203,2322,56345,06,50398
"Needles city, California",1747,1501,246,4895,06,50734
"Nevada City city, California",1424,1398,26,3142,06,50874
"Newark city, California",28053,26789,1264,47470,06,50916
"Newcastle CDP, California",496,475,21,1501,06,51000
"New Cuyama CDP, California",255,232,23,669,06,51028
"Newell CDP, California",193,193,0,431,06,51042
"Newman city, California",6586,5835,751,12275,06,51140
"New Pine Creek CDP, California",17,17,0,79,06,51168
"Newport Beach city, California",45199,43340,1859,85159,06,51182
"Nicasio CDP, California",54,50,4,83,06,51280
"Nice CDP, California",990,940,50,2389,06,51294
"Nicolaus CDP, California",49,49,0,125,06,51336
"Niland CDP, California",247,247,0,602,06,51392
"Nipinnawasee CDP, California",145,145,0,341,06,51470
"Nipomo CDP, California",8475,8133,342,18009,06,51476
"Norco city, California",12007,11551,456,25328,06,51560
"Nord CDP, California",40,40,0,147,06,51574
"Norris Canyon CDP, California",485,454,31,954,06,51622
"North Auburn CDP, California",6316,6157,159,14403,06,51637
"North Edwards CDP, California",487,428,59,1086,06,51812
"North El Monte CDP, California",2183,2118,65,3983,06,51820
"North Fair Oaks CDP, California",7335,6791,544,13718,06,51840
"North Fork CDP, California",1204,980,224,3279,06,51868
"North Gate CDP, California",376,376,0,900,06,51890
"North Highlands CDP, California",23054,21723,1331,48083,06,51924
"North Lakeport CDP, California",1058,1011,47,2666,06,51990
"North Richmond CDP, California",1964,1904,60,3734,06,52162
"North San Juan CDP, California",2,2,0,109,06,52246
"North Shore CDP, California",1644,1465,179,2610,06,52302
"North Tustin CDP, California",12353,11972,381,25131,06,52379
"Norwalk city, California",50612,47787,2825,101893,06,52526
"Novato city, California",27000,25247,1753,53055,06,52582
"Nubieber CDP, California",13,6,7,42,06,52610
"Nuevo CDP, California",3409,3173,236,7305,06,52624
"Oakdale city, California",11245,10283,962,23120,06,52694
"Oak Glen CDP, California",110,110,0,369,06,52715
"Oak Hills CDP, California",4053,3907,146,7838,06,52760
"Oakhurst CDP, California",2449,2254,195,5003,06,52764
"Oakland city, California",247759,233396,14363,437825,06,53000
"Oakley city, California",22923,21573,1350,43525,06,53070
"Oak Park CDP, California",6607,6258,349,13627,06,53116
"Oak Run CDP, California",204,142,62,561,06,53140
"Oak Shores CDP, California",90,90,0,159,06,53160
"Oak View CDP, California",3131,3038,93,6468,06,53182
"Oakville CDP, California",0,0,0,0,06,53196
"Oasis CDP, California",2189,1774,415,3775,06,53224
"Occidental CDP, California",592,570,22,1061,06,53266
"Oceano CDP, California",3289,3160,129,7287,06,53294
"Oceanside city, California",90702,85385,5317,173722,06,53322
"Ocotillo CDP, California",22,0,22,146,06,53378
"Oildale CDP, California",14680,13006,1674,34796,06,53448
"Ojai city, California",3380,3161,219,7610,06,53476
"Olancha CDP, California",86,86,0,171,06,53490
"Olde Stockdale CDP, California",240,240,0,543,06,53503
"Old Fig Garden CDP, California",2622,2417,205,5156,06,53505
"Old River CDP, California",68,68,0,106,06,53574
"Old Station CDP, California",0,0,0,0,06,53602
"Old Stine CDP, California",1658,1411,247,3612,06,53603
"Olivehurst CDP, California",7983,7397,586,17416,06,53714
"Ono CDP, California",4,4,0,27,06,53882
"Ontario city, California",91757,86406,5351,176326,06,53896
"Onyx CDP, California",173,108,65,645,06,53910
"Orange city, California",75272,71741,3531,138728,06,53980
"Orange Blossom CDP, California",546,539,7,1520,06,53987
"Orange Cove city, California",3804,3284,520,9635,06,54008
"Orangevale CDP, California",18097,17157,940,35852,06,54092
"Orcutt CDP, California",15050,14423,627,31137,06,54120
"Orick CDP, California",178,167,11,308,06,54218
"Orinda city, California",9294,8985,309,19477,06,54232
"Orland city, California",3636,3373,263,8221,06,54274
"Orosi CDP, California",3688,3298,390,9100,06,54372
"Oroville city, California",7854,7262,592,20283,06,54386
"Oroville East CDP, California",3370,3107,263,7640,06,54388
"Oxnard city, California",104335,98135,6200,202279,06,54652
"Pacheco CDP, California",2897,2718,179,5041,06,54764
"Pacifica city, California",21453,20636,817,38048,06,54806
"Pacific Grove city, California",7389,6977,412,15098,06,54848
"Pajaro CDP, California",1205,906,299,2723,06,55044
"Pajaro Dunes CDP, California",15,15,0,93,06,55048
"Pala CDP, California",332,307,25,988,06,55058
"Palermo CDP, California",2459,2172,287,5516,06,55086
"Palmdale city, California",75675,70069,5606,166895,06,55156
"Palm Desert city, California",21984,20564,1420,51290,06,55184
"Palm Springs city, California",20880,19081,1799,44935,06,55254
"Palo Alto city, California",34793,33660,1133,67901,06,55282
"Palo Cedro CDP, California",1479,1394,85,3396,06,55296
"Palos Verdes Estates city, California",5403,5280,123,13219,06,55380
"Palo Verde CDP, California",28,28,0,81,06,55422
"Panorama Heights CDP, California",5,5,0,44,06,55506
"Paradise town, California",2049,1932,117,6666,06,55520
"Paradise CDP, California",114,114,0,183,06,55528
"Paradise Park CDP, California",200,182,18,538,06,55604
"Paramount city, California",26684,25282,1402,53255,06,55618
"Parklawn CDP, California",652,628,24,1543,06,55728
"Parksdale CDP, California",929,743,186,2500,06,55751
"Parkway CDP, California",7160,6337,823,16242,06,55800
"Parkwood CDP, California",875,664,211,2073,06,55842
"Parlier city, California",6827,6354,473,14625,06,55856
"Pasadena city, California",77951,73930,4021,137554,06,56000
"Pasatiempo CDP, California",478,478,0,1264,06,56028
"Paskenta CDP, California",28,28,0,63,06,56042
"Patterson city, California",10983,10165,818,23678,06,56112
"Patterson Tract CDP, California",722,693,29,1645,06,56120
"Patton Village CDP, California",241,183,58,792,06,56140
"Paxton CDP, California",0,0,0,0,06,56182
"Paynes Creek CDP, California",0,0,0,37,06,56196
"Pearsonville CDP, California",0,0,0,0,06,56294
"Penngrove CDP, California",1031,966,65,2184,06,56476
"Penn Valley CDP, California",502,502,0,1188,06,56518
"Penryn CDP, California",525,494,31,1112,06,56546
"Pepperdine University CDP, California",1130,1024,106,2741,06,56598
"Perris city, California",36711,34101,2610,78881,06,56700
"Pescadero CDP, California",234,234,0,349,06,56756
"Petaluma city, California",32384,30870,1514,59682,06,56784
"Petaluma Center CDP, California",107,104,3,849,06,56786
"Peters CDP, California",122,122,0,309,06,56798
"Phelan CDP, California",7672,6741,931,18272,06,56826
"Phillipsville CDP, California",0,0,0,0,06,56854
"Philo CDP, California",29,29,0,53,06,56868
"Phoenix Lake CDP, California",1754,1653,101,4377,06,56870
"Pico Rivera city, California",31078,29629,1449,61561,06,56924
"Piedmont city, California",5444,5174,270,11161,06,56938
"Pierpoint CDP, California",22,0,22,79,06,57011
"Pike CDP, California",56,56,0,97,06,57036
"Pine Canyon CDP, California",985,959,26,2092,06,57070
"Pine Flat CDP, California",63,40,23,181,06,57134
"Pine Grove CDP, California",1554,1336,218,3386,06,57148
"Pine Hills CDP, California",1368,1319,49,3508,06,57204
"Pine Mountain Club CDP, California",854,771,83,2195,06,57240
"Pine Mountain Lake CDP, California",1028,955,73,3038,06,57244
"Pine Valley CDP, California",861,560,301,1778,06,57260
"Pinole city, California",10175,9776,399,18946,06,57288
"Piñon Hills CDP, California",2602,2231,371,7157,06,57302
"Pioneer CDP, California",589,552,37,1322,06,57330
"Piru CDP, California",1122,1035,87,2182,06,57372
"Pismo Beach city, California",4049,3939,110,8050,06,57414
"Pittsburg city, California",40033,37171,2862,76419,06,57456
"Pixley CDP, California",1523,1313,210,3811,06,57512
"Placentia city, California",27051,25697,1354,51797,06,57526
"Placerville city, California",5146,4886,260,10744,06,57540
"Plainview CDP, California",193,115,78,378,06,57568
"Planada CDP, California",1454,1264,190,3494,06,57582
"Platina CDP, California",0,0,0,25,06,57666
"Pleasant Hill city, California",19296,18580,716,34504,06,57764
"Pleasanton city, California",41246,39517,1729,78691,06,57792
"Pleasure Point CDP, California",3581,3473,108,5909,06,57825
"Plumas Eureka CDP, California",152,143,9,444,06,57828
"Plumas Lake CDP, California",3928,3715,213,8301,06,57829
"Plymouth city, California",707,678,29,1297,06,57834
"Point Arena city, California",342,312,30,661,06,57876
"Point Reyes Station CDP, California",232,232,0,383,06,57960
"Pollock Pines CDP, California",2687,2548,139,5917,06,58030
"Pomona city, California",73980,69155,4825,149831,06,58072
"Ponderosa CDP, California",8,8,0,58,06,58134
"Poplar-Cotton Center CDP, California",1052,851,201,1918,06,58191
"Port Costa CDP, California",149,138,11,251,06,58226
"Porterville city, California",28551,25672,2879,62491,06,58240
"Port Hueneme city, California",10706,9756,950,21847,06,58296
"Portola city, California",1096,1019,77,2427,06,58352
"Portola Valley town, California",1536,1494,42,4397,06,58380
"Posey CDP, California",0,0,0,0,06,58422
"Poso Park CDP, California",0,0,0,0,06,58436
"Post Mountain CDP, California",79,79,0,101,06,58456
"Potomac Park CDP, California",4800,4143,657,10697,06,58471
"Potrero CDP, California",231,210,21,509,06,58478
"Potter Valley CDP, California",254,234,20,537,06,58506
"Poway city, California",24468,23023,1445,48737,06,58520
"Prattville CDP, California",12,6,6,39,06,58618
"Princeton CDP, California",145,145,0,357,06,58758
"Proberta CDP, California",99,79,20,195,06,58814
"Prunedale CDP, California",8320,7775,545,19372,06,58870
"Pumpkin Center CDP, California",130,88,42,258,06,58940
"Quartz Hill CDP, California",4675,4448,227,10089,06,59052
"Quincy CDP, California",724,638,86,1368,06,59080
"Rackerby CDP, California",37,29,8,222,06,59115
"Rail Road Flat CDP, California",41,24,17,78,06,59220
"Rainbow CDP, California",816,760,56,1830,06,59248
"Raisin City CDP, California",133,89,44,267,06,59290
"Ramona CDP, California",11707,11262,445,22118,06,59346
"Rancho Calaveras CDP, California",2719,2543,176,6089,06,59426
"Rancho Cordova city, California",39871,37426,2445,79128,06,59444
"Rancho Cucamonga city, California",91686,86714,4972,174696,06,59451
"Rancho Mirage city, California",6523,5835,688,17257,06,59500
"Rancho Mission Viejo CDP, California",5050,4891,159,10697,06,59503
"Rancho Murieta CDP, California",2491,2439,52,5728,06,59506
"Rancho Palos Verdes city, California",19200,18228,972,41805,06,59514
"Rancho San Diego CDP, California",11477,10707,770,22430,06,59550
"Rancho Santa Fe CDP, California",1106,1036,70,3033,06,59584
"Rancho Santa Margarita city, California",28366,27433,933,47702,06,59587
"Rancho Tehama Reserve CDP, California",121,112,9,793,06,59604
"Randsburg CDP, California",7,7,0,65,06,59668
"Red Bluff city, California",5777,5275,502,14576,06,59892
"Red Corral CDP, California",268,268,0,1271,06,59896
"Redcrest CDP, California",0,0,0,0,06,59906
"Redding city, California",43508,40948,2560,93327,06,59920
"Redlands city, California",36942,34557,2385,73234,06,59962
"Redondo Beach city, California",40203,38207,1996,70620,06,60018
"Redway CDP, California",606,606,0,1257,06,60088
"Redwood City city, California",46943,45120,1823,83077,06,60102
"Redwood Valley CDP, California",854,835,19,1623,06,60214
"Reedley city, California",11477,10173,1304,25248,06,60242
"Reliez Valley CDP, California",1511,1410,101,3190,06,60279
"Rexland Acres CDP, California",1678,1501,177,3788,06,60370
"Rialto city, California",51650,46864,4786,103873,06,60466
"Richfield CDP, California",61,52,9,142,06,60592
"Richgrove CDP, California",816,642,174,1837,06,60606
"Richmond city, California",62562,58229,4333,115619,06,60620
"Richvale CDP, California",27,11,16,248,06,60662
"Ridgecrest city, California",13036,11840,1196,28118,06,60704
"Ridgecrest Heights CDP, California",146,126,20,352,06,60705
"Ridgemark CDP, California",1528,1412,116,3022,06,60706
"Rio Dell city, California",1702,1550,152,3386,06,60900
"Rio del Mar CDP, California",4871,4648,223,9007,06,60928
"Rio Linda CDP, California",7705,7329,376,16596,06,60942
"Rio Oso CDP, California",154,150,4,368,06,60970
"Rio Vista city, California",3899,3376,523,10074,06,60984
"Ripley CDP, California",135,118,17,614,06,61012
"Ripon city, California",8091,7880,211,16092,06,61026
"Riverbank city, California",11234,10576,658,24803,06,61068
"Riverdale CDP, California",1207,1143,64,2756,06,61096
"Riverdale Park CDP, California",205,205,0,795,06,61106
"Rivergrove CDP, California",27,27,0,74,06,61108
"River Pines CDP, California",146,146,0,487,06,61124
"Riverside city, California",159841,150122,9719,316076,06,62000
"Robbins CDP, California",146,146,0,341,06,62168
"Robinson Mill CDP, California",0,0,0,37,06,62200
"Rocklin city, California",35613,33878,1735,71676,06,62364
"Rodeo CDP, California",5015,4636,379,9334,06,62490
"Rodriguez Camp CDP, California",9,9,0,52,06,62496
"Rohnert Park city, California",25749,24510,1239,44461,06,62546
"Rolling Hills city, California",556,524,32,1451,06,62602
"Rolling Hills CDP, California",284,256,28,539,06,62625
"Rolling Hills Estates city, California",3599,3268,331,8214,06,62644
"Rollingwood CDP, California",1839,1608,231,3483,06,62700
"Romoland CDP, California",1075,1010,65,2738,06,62756
"Rosamond CDP, California",9075,8294,781,20654,06,62826
"Rosedale CDP, California",9421,9122,299,19174,06,62854
"Rose Hills CDP, California",1562,1525,37,2718,06,62860
"Rosemead city, California",24971,23745,1226,51043,06,62896
"Rosemont CDP, California",12426,11570,856,23845,06,62910
"Roseville city, California",77006,73503,3503,148879,06,62938
"Ross town, California",1137,1102,35,2537,06,62980
"Rossmoor CDP, California",5556,5298,258,11742,06,63050
"Rough and Ready CDP, California",183,175,8,623,06,63106
"Round Mountain CDP, California",21,15,6,100,06,63134
"Round Valley CDP, California",169,160,9,739,06,63148
"Rouse CDP, California",414,408,6,1003,06,63168
"Rowland Heights CDP, California",24680,23137,1543,47209,06,63218
"Rumsey CDP, California",52,52,0,131,06,63302
"Running Springs CDP, California",2257,2159,98,4589,06,63316
"Ruth CDP, California",28,28,0,151,06,63386
"Rutherford CDP, California",48,48,0,115,06,63400
"Sacramento city, California",271982,254892,17090,523600,06,64000
"Sage CDP, California",1275,1202,73,2818,06,64056
"St. Helena city, California",2653,2567,86,5426,06,64140
"Salida CDP, California",8304,7413,891,14849,06,64210
"Salinas city, California",74099,70389,3710,162783,06,64224
"Salmon Creek CDP, California",8,8,0,8,06,64252
"Salton City CDP, California",2370,2130,240,6202,06,64294
"Salton Sea Beach CDP, California",104,53,51,186,06,64308
"Salyer CDP, California",274,274,0,495,06,64378
"Samoa CDP, California",121,79,42,223,06,64392
"San Andreas CDP, California",860,843,17,2936,06,64420
"San Anselmo town, California",7201,6813,388,12761,06,64434
"San Antonio Heights CDP, California",1639,1605,34,3294,06,64462
"San Ardo CDP, California",326,270,56,624,06,64476
"San Bernardino city, California",101131,93480,7651,221041,06,65000
"San Bruno city, California",25070,23919,1151,43218,06,65028
"San Buenaventura (Ventura) city, California",57902,55057,2845,110358,06,65042
"San Carlos city, California",17252,16542,710,30490,06,65070
"San Clemente city, California",32666,30951,1715,64232,06,65084
"Sand City city, California",191,188,3,319,06,65112
"San Diego city, California",744033,698895,45138,1383987,06,66000
"San Diego Country Estates CDP, California",5195,5032,163,10241,06,66004
"San Dimas city, California",17829,16893,936,34466,06,66070
"San Fernando city, California",12541,11649,892,23958,06,66140
"San Francisco city, California",526058,497881,28177,851036,06,67000
"San Gabriel city, California",20712,19308,1404,39211,06,67042
"Sanger city, California",12376,11360,1016,26553,06,67056
"San Geronimo CDP, California",226,226,0,427,06,67070
"San Jacinto city, California",23307,21367,1940,54077,06,67112
"San Joaquin city, California",1264,1025,239,3725,06,67126
"San Jose city, California",552156,525944,26212,1001176,06,68000
"San Juan Bautista city, California",1028,1004,24,1976,06,68014
"San Juan Capistrano city, California",17916,17175,741,35099,06,68028
"San Leandro city, California",50396,47892,2504,89723,06,68084
"San Lorenzo CDP, California",16184,15291,893,29759,06,68112
"San Lucas CDP, California",126,126,0,377,06,68140
"San Luis Obispo city, California",26908,25061,1847,47529,06,68154
"San Marcos city, California",47207,45206,2001,94360,06,68196
"San Marino city, California",5739,5484,255,12442,06,68224
"San Martin CDP, California",3417,3215,202,6289,06,68238
"San Mateo city, California",60114,57259,2855,104165,06,68252
"San Miguel CDP (Contra Costa County), California",2068,2004,64,4004,06,68263
"San Miguel CDP (San Luis Obispo County), California",1378,1303,75,2756,06,68266
"San Pablo city, California",15791,14547,1244,31907,06,68294
"San Pasqual CDP, California",1202,1153,49,1934,06,68308
"San Rafael city, California",33169,31565,1604,60891,06,68364
"San Ramon city, California",45411,43135,2276,86119,06,68378
"San Simeon CDP, California",127,127,0,307,06,68434
"Santa Ana city, California",163929,154940,8989,311379,06,69000
"Santa Barbara city, California",48950,46800,2150,88640,06,69070
"Santa Clara city, California",76484,73274,3210,128058,06,69084
"Santa Clarita city, California",117677,111146,6531,225850,06,69088
"Santa Cruz city, California",33852,31762,2090,61367,06,69112
"Santa Fe Springs city, California",9083,8702,381,18840,06,69154
"Santa Margarita CDP, California",447,447,0,698,06,69182
"Santa Maria city, California",52187,48898,3289,109543,06,69196
"Santa Monica city, California",53579,50253,3326,92168,06,70000
"Santa Nella CDP, California",962,844,118,2055,06,70028
"Santa Paula city, California",14742,13788,954,30788,06,70042
"Santa Rosa city, California",96655,91204,5451,178221,06,70098
"Santa Rosa Valley CDP, California",1174,1119,55,2508,06,70130
"Santa Susana CDP, California",638,577,61,1132,06,70140
"Santa Venetia CDP, California",1852,1721,131,3785,06,70154
"Santa Ynez CDP, California",2276,2259,17,4716,06,70182
"Santee city, California",29399,27808,1591,59497,06,70224
"Saranap CDP, California",3438,3318,120,6136,06,70266
"Saratoga city, California",14353,13860,493,30771,06,70280
"Saticoy CDP, California",606,561,45,1628,06,70322
"Sattley CDP, California",0,0,0,27,06,70336
"Sausalito city, California",4393,4108,285,7233,06,70364
"Scotia CDP, California",226,196,30,510,06,70518
"Scotts Valley city, California",6630,6504,126,12239,06,70588
"Seacliff CDP, California",2208,2065,143,3550,06,70644
"Seal Beach city, California",9449,9048,401,25046,06,70686
"Sea Ranch CDP, California",380,366,14,1224,06,70712
"Searles Valley CDP, California",595,542,53,1716,06,70728
"Seaside city, California",15849,14719,1130,32291,06,70742
"Sebastopol city, California",4000,3781,219,7503,06,70770
"Seeley CDP, California",731,556,175,1756,06,70798
"Selma city, California",11541,10350,1191,24576,06,70882
"Sequoia Crest CDP, California",0,0,0,89,06,70966
"Sereno del Mar CDP, California",27,27,0,98,06,71000
"Seville CDP, California",144,124,20,411,06,71078
"Shafter city, California",8696,8076,620,20162,06,71106
"Shandon CDP, California",516,472,44,1031,06,71134
"Shasta CDP, California",645,580,65,1376,06,71218
"Shasta Lake city, California",4507,4139,368,10361,06,71225
"Shaver Lake CDP, California",94,88,6,306,06,71246
"Shell Ridge CDP, California",601,590,11,1041,06,71362
"Shelter Cove CDP, California",194,194,0,500,06,71372
"Sheridan CDP, California",717,671,46,1397,06,71414
"Shingle Springs CDP, California",1622,1526,96,3703,06,71554
"Shingletown CDP, California",918,851,67,2248,06,71568
"Shoshone CDP, California",7,7,0,23,06,71680
"Sierra Brooks CDP, California",259,259,0,503,06,71774
"Sierra City CDP, California",95,95,0,221,06,71778
"Sierra Madre city, California",6346,6143,203,11151,06,71806
"Sierra Village CDP, California",52,52,0,90,06,71834
"Sierraville CDP, California",111,111,0,227,06,71848
"Signal Hill city, California",6704,6397,307,11678,06,71876
"Silverado CDP, California",406,376,30,878,06,71918
"Silverado Resort CDP, California",349,331,18,1012,06,71927
"Silver City CDP, California",0,0,0,0,06,71932
"Silver Lakes CDP, California",2624,2551,73,5532,06,71964
"Simi Valley city, California",68847,65839,3008,126153,06,72016
"Sisquoc CDP, California",62,55,7,155,06,72086
"Sky Valley CDP, California",875,782,93,2307,06,72156
"Sleepy Hollow CDP, California",1347,1234,113,2778,06,72184
"Smartsville CDP, California",37,37,0,379,06,72282
"Smith Corner CDP, California",138,119,19,316,06,72338
"Smith River CDP, California",350,329,21,849,06,72380
"Snelling CDP, California",68,59,9,178,06,72408
"Soda Bay CDP, California",464,448,16,759,06,72478
"Soda Springs CDP, California",54,54,0,54,06,72492
"Solana Beach city, California",6245,6026,219,12946,06,72506
"Soledad city, California",7643,7424,219,24781,06,72520
"Solvang city, California",3139,3007,132,6035,06,72576
"Somis CDP, California",584,565,19,1083,06,72632
"Sonoma city, California",5311,4988,323,10702,06,72646
"Sonoma State University CDP, California",721,547,174,1707,06,72654
"Sonora city, California",2198,1992,206,4963,06,72674
"Soquel CDP, California",5512,5263,249,10505,06,72688
"Soulsbyville CDP, California",1028,916,112,1972,06,72772
"South Dos Palos CDP, California",625,514,111,1476,06,72954
"South El Monte city, California",9381,8749,632,19694,06,72996
"South Gate city, California",47053,43342,3711,92381,06,73080
"South Lake Tahoe city, California",12637,12053,584,21346,06,73108
"South Monrovia Island CDP, California",3378,3182,196,6833,06,73167
"South Oroville CDP, California",1241,1181,60,2291,06,73178
"South Pasadena city, California",14708,13944,764,26583,06,73220
"South San Francisco city, California",37485,36584,901,65596,06,73262
"South San Gabriel CDP, California",3848,3642,206,7786,06,73276
"South San Jose Hills CDP, California",9720,8875,845,18717,06,73290
"South Taft CDP, California",967,801,166,2370,06,73388
"South Whittier CDP, California",30085,28526,1559,57383,06,73430
"Spaulding CDP, California",98,55,43,233,06,73554
"Spreckels CDP, California",63,63,0,198,06,73612
"Spring Garden CDP, California",0,0,0,0,06,73654
"Spring Valley CDP (Lake County), California",251,251,0,889,06,73690
"Spring Valley CDP (San Diego County), California",16718,15537,1181,32496,06,73696
"Spring Valley Lake CDP, California",3760,3527,233,8764,06,73700
"Springville CDP, California",262,244,18,508,06,73710
"Squaw Valley CDP, California",1345,1307,38,4568,06,73794
"Squirrel Mountain Valley CDP, California",290,257,33,1071,06,73815
"Stallion Springs CDP, California",757,729,28,2396,06,73868
"Stanford CDP, California",8018,7527,491,17255,06,73906
"Stanton city, California",19679,18227,1452,38271,06,73962
"Stebbins CDP, California",494,452,42,923,06,74021
"Stevenson Ranch CDP, California",10126,9182,944,20484,06,74130
"Stevinson CDP, California",54,52,2,132,06,74144
"Stinson Beach CDP, California",208,208,0,371,06,74172
"Stirling City CDP, California",224,206,18,501,06,74186
"Stockton city, California",146231,134931,11300,320030,06,75000
"Stones Landing CDP, California",59,59,0,144,06,75122
"Stonyford CDP, California",16,12,4,82,06,75154
"Stratford CDP, California",398,384,14,1034,06,75252
"Strathmore CDP, California",632,536,96,2993,06,75280
"Strawberry CDP (Marin County), California",2946,2814,132,5632,06,75315
"Strawberry CDP (Tuolumne County), California",15,15,0,64,06,75322
"Sugarloaf Saw Mill CDP, California",0,0,0,0,06,75592
"Sugarloaf Village CDP, California",0,0,0,7,06,75596
"Suisun City city, California",15222,14176,1046,29350,06,75630
"Sultana CDP, California",396,344,52,1005,06,75672
"Summerland CDP, California",560,491,69,1274,06,75714
"Sunnyside CDP, California",2268,2139,129,4565,06,75994
"Sunnyside-Tahoe City CDP, California",833,833,0,1536,06,76015
"Sunny Slopes CDP, California",45,45,0,66,06,76040
"Sunnyvale city, California",90848,87140,3708,154573,06,77000
"Sunol CDP, California",491,459,32,920,06,77042
"Sun Village CDP, California",4532,4178,354,11472,06,77308
"Susanville city, California",4238,3927,311,15737,06,77364
"Sutter CDP, California",1307,1194,113,2848,06,77378
"Sutter Creek city, California",1243,1149,94,2659,06,77392
"Swall Meadows CDP, California",241,236,5,365,06,77430
"Taft city, California",2787,2652,135,7414,06,77574
"Taft Heights CDP, California",848,774,74,1638,06,77588
"Taft Mosswood CDP, California",444,409,35,987,06,77595
"Tahoe Vista CDP, California",674,674,0,1171,06,77700
"Tahoma CDP, California",713,685,28,1071,06,77728
"Talmage CDP, California",246,226,20,1031,06,77784
"Tamalpais-Homestead Valley CDP, California",6204,5910,294,12196,06,77805
"Tancred CDP, California",3,3,0,41,06,77860
"Tara Hills CDP, California",3002,2868,134,5202,06,77924
"Tarina CDP, California",0,0,0,0,06,77934
"Tarpey Village CDP, California",1761,1594,167,3746,06,77960
"Taylorsville CDP, California",0,0,0,27,06,78008
"Tecopa CDP, California",22,22,0,187,06,78050
"Tehachapi city, California",3567,3262,305,12855,06,78092
"Tehama city, California",181,179,2,421,06,78106
"Temecula city, California",52710,49667,3043,110114,06,78120
"Temelec CDP, California",522,416,106,1693,06,78126
"Temescal Valley CDP, California",13596,12902,694,28227,06,78138
"Temple City city, California",17866,16753,1113,36165,06,78148
"Templeton CDP, California",4557,4300,257,8614,06,78162
"Tennant CDP, California",13,3,10,80,06,78176
"Terminous CDP, California",211,169,42,392,06,78232
"Terra Bella CDP, California",576,352,224,1806,06,78288
"Teviston CDP, California",319,214,105,1038,06,78336
"Thermal CDP, California",583,543,40,1352,06,78456
"Thermalito CDP, California",2745,2526,219,6790,06,78470
"Thornton CDP, California",381,351,30,873,06,78568
"Thousand Oaks city, California",64967,61852,3115,126532,06,78582
"Thousand Palms CDP, California",3577,3451,126,8242,06,78596
"Three Rivers CDP, California",1287,1233,54,2496,06,78638
"Three Rocks CDP, California",76,70,6,181,06,78652
"Tiburon town, California",4578,4143,435,9115,06,78666
"Timber Cove CDP, California",122,116,6,235,06,78715
"Tipton CDP, California",1473,1318,155,3170,06,78750
"Tobin CDP, California",0,0,0,0,06,78792
"Tomales CDP, California",84,84,0,178,06,78890
"Tonyville CDP, California",78,67,11,314,06,78932
"Tooleville CDP, California",38,25,13,51,06,78949
"Topanga CDP, California",4373,4058,315,8202,06,78960
"Topaz CDP, California",70,70,0,162,06,79030
"Toro Canyon CDP, California",753,695,58,1692,06,79529
"Torrance city, California",76094,72049,4045,145454,06,80000
"Trabuco Canyon CDP, California",637,611,26,1275,06,80210
"Tracy city, California",48721,46087,2634,94027,06,80238
"Tranquillity CDP, California",321,260,61,786,06,80266
"Traver CDP, California",194,167,27,427,06,80280
"Tres Pinos CDP, California",664,626,38,1006,06,80364
"Trinidad city, California",195,175,20,449,06,80448
"Trinity Center CDP, California",55,41,14,250,06,80476
"Trinity Village CDP, California",334,334,0,580,06,80483
"Trona CDP, California",0,0,0,0,06,80515
"Trowbridge CDP, California",103,88,15,192,06,80560
"Truckee town, California",9027,8513,514,16784,06,80588
"Tulare city, California",29816,27249,2567,69261,06,80644
"Tulelake city, California",226,199,27,811,06,80686
"Tuolumne City CDP, California",492,492,0,1297,06,80763
"Tupman CDP, California",56,56,0,150,06,80784
"Turlock city, California",34348,31746,2602,72504,06,80812
"Tustin city, California",43285,40715,2570,79514,06,80854
"Tuttle CDP, California",0,0,0,65,06,80882
"Tuttletown CDP, California",386,350,36,946,06,80896
"Twain CDP, California",100,81,19,319,06,80952
"Twain Harte CDP, California",972,891,81,2154,06,80966
"Twentynine Palms city, California",7752,7261,491,28006,06,80994
"Twin Lakes CDP (Mono County), California",30,30,0,87,06,81048
"Twin Lakes CDP (Santa Cruz County), California",2835,2733,102,5090,06,81050
"Ukiah city, California",7930,7264,666,16496,06,81134
"Union City city, California",38035,36303,1732,69502,06,81204
"University of California-Davis CDP, California",2136,1894,242,8229,06,81302
"University of California-Merced CDP, California",430,137,293,1079,06,81312
"University of California-Santa Barbara CDP, California",5054,4294,760,11441,06,81316
"Upland city, California",42329,40240,2089,78847,06,81344
"Upper Lake CDP, California",609,571,38,954,06,81358
"Vacaville city, California",48465,45842,2623,101631,06,81554
"Valinda CDP, California",11877,11169,708,21952,06,81638
"Vallecito CDP, California",96,96,0,213,06,81652
"Vallejo city, California",64938,60421,4517,125132,06,81666
"Valle Vista CDP, California",8025,7280,745,19252,06,81708
"Valley Acres CDP, California",275,197,78,610,06,81722
"Valley Center CDP, California",4842,4692,150,10929,06,81736
"Valley Ford CDP, California",0,0,0,0,06,81778
"Valley Home CDP, California",112,102,10,246,06,81792
"Valley Ranch CDP, California",0,0,0,41,06,81869
"Valley Springs CDP, California",1797,1663,134,3630,06,81890
"Valley Wells CDP, California",0,0,0,0,06,81925
"Val Verde CDP, California",1669,1579,90,3292,06,81967
"Vandenberg AFB CDP, California",748,663,85,3681,06,82072
"Vandenberg Village CDP, California",3272,3039,233,6702,06,82086
"Verdi CDP, California",54,54,0,98,06,82334
"Vernon city, California",128,117,11,329,06,82422
"Victor CDP, California",309,309,0,608,06,82562
"Victorville city, California",54630,49019,5611,134417,06,82590
"View Park-Windsor Hills CDP, California",6139,5443,696,11999,06,82667
"Villa Park city, California",2433,2402,31,5814,06,82744
"Vina CDP, California",137,137,0,270,06,82786
"Vincent CDP, California",8413,7964,449,15266,06,82815
"Vine Hill CDP, California",1727,1597,130,3217,06,82842
"Vineyard CDP, California",20515,19525,990,42657,06,82852
"Virginia Lakes CDP, California",0,0,0,0,06,82929
"Visalia city, California",66464,62742,3722,141466,06,82954
"Vista city, California",52428,49119,3309,98392,06,82996
"Vista Santa Rosa CDP, California",1121,1054,67,2269,06,83085
"Volcano CDP, California",0,0,0,59,06,83094
"Volta CDP, California",199,148,51,292,06,83108
"Walker CDP, California",117,117,0,499,06,83262
"Wallace CDP, California",217,189,28,350,06,83304
"Walnut city, California",14005,13412,593,28212,06,83332
"Walnut Creek city, California",34753,33061,1692,69809,06,83346
"Walnut Grove CDP, California",445,434,11,814,06,83374
"Walnut Park CDP, California",8028,7282,746,16209,06,83402
"Warm Springs CDP, California",778,682,96,1876,06,83460
"Warner Valley CDP, California",0,0,0,0,06,83494
"Wasco city, California",9511,8691,820,26317,06,83542
"Washington CDP, California",82,76,6,117,06,83570
"Waterford city, California",4037,3822,215,9165,06,83612
"Waterloo CDP, California",566,566,0,840,06,83626
"Watsonville city, California",25214,22840,2374,52457,06,83668
"Waukena CDP, California",36,27,9,63,06,83724
"Wautec CDP, California",7,4,3,17,06,83730
"Wawona CDP, California",89,83,6,122,06,83766
"Weaverville CDP, California",1491,1335,156,3582,06,83794
"Weed city, California",1163,1081,82,2845,06,83850
"Weedpatch CDP, California",920,703,217,2788,06,83863
"Weitchpec CDP, California",34,24,10,79,06,83906
"Weldon CDP, California",837,786,51,2602,06,83948
"Weott CDP, California",0,0,0,0,06,84004
"West Athens CDP, California",4572,4041,531,9131,06,84116
"West Bishop CDP, California",1092,1034,58,2430,06,84120
"West Carson CDP, California",11811,11190,621,22240,06,84144
"West Covina city, California",56692,52900,3792,108173,06,84200
"West Goshen CDP, California",388,340,48,562,06,84345
"Westhaven-Moonstone CDP, California",756,644,112,1298,06,84385
"West Hollywood city, California",26533,24408,2125,35358,06,84410
"Westlake Village city, California",3865,3754,111,7948,06,84438
"Westley CDP, California",201,81,120,602,06,84480
"West Menlo Park CDP, California",1692,1622,70,3401,06,84536
"Westminster city, California",44335,40988,3347,90638,06,84550
"West Modesto CDP, California",2502,2260,242,5438,06,84578
"Westmont CDP, California",15856,14117,1739,35345,06,84592
"Westmorland city, California",595,476,119,2010,06,84606
"West Park CDP, California",487,419,68,1148,06,84680
"West Point CDP, California",285,285,0,777,06,84732
"West Puente Valley CDP, California",10772,9991,781,22074,06,84774
"West Rancho Dominguez CDP, California",10729,9886,843,22141,06,84780
"West Sacramento city, California",27451,25955,1496,54163,06,84816
"Westside CDP, California",78,78,0,191,06,84863
"West Whittier-Los Nietos CDP, California",11955,11483,472,25442,06,84921
"Westwood CDP, California",337,274,63,1116,06,84928
"Wheatland city, California",1710,1654,56,3702,06,85012
"Whitehawk CDP, California",10,10,0,61,06,85086
"Whitewater CDP, California",597,538,59,1194,06,85208
"Whitley Gardens CDP, California",6,6,0,6,06,85222
"Whitmore CDP, California",112,107,5,272,06,85250
"Whittier city, California",43024,40760,2264,86459,06,85292
"Wildomar city, California",17998,16832,1166,36822,06,85446
"Wilkerson CDP, California",255,244,11,590,06,85551
"Williams city, California",2900,2464,436,5539,06,85586
"Williams Canyon CDP, California",18,18,0,36,06,85587
"Willits city, California",1925,1660,265,4968,06,85600
"Willowbrook CDP, California",10297,8935,1362,22491,06,85614
"Willow Creek CDP, California",564,533,31,1371,06,85642
"Willows city, California",2828,2569,259,6201,06,85684
"Wilsonia CDP, California",26,26,0,26,06,85866
"Wilton CDP, California",3107,3055,52,6663,06,85880
"Winchester CDP, California",1196,1147,49,2917,06,85894
"Windsor town, California",14625,14116,509,26320,06,85922
"Winter Gardens CDP, California",10756,9959,797,21320,06,85992
"Winterhaven CDP, California",0,0,0,53,06,86020
"Winters city, California",4290,4207,83,7270,06,86034
"Winton CDP, California",4985,4421,564,11986,06,86076
"Wofford Heights CDP, California",519,488,31,2267,06,86174
"Woodacre CDP, California",1029,965,64,1389,06,86216
"Woodbridge CDP, California",1967,1888,79,3870,06,86230
"Woodcrest CDP, California",8521,8169,352,17378,06,86244
"Woodlake city, California",3006,2731,275,7495,06,86300
"Woodland city, California",31681,30110,1571,61227,06,86328
"Woodlands CDP, California",551,551,0,1924,06,86380
"Woodside town, California",2518,2405,113,5256,06,86440
"Woodville CDP, California",788,699,89,1830,06,86482
"Woodville Farm Labor Camp CDP, California",185,157,28,425,06,86489
"Woody CDP, California",57,57,0,96,06,86496
"Wrightwood CDP, California",1985,1937,48,4461,06,86594
"Yankee Hill CDP, California",123,116,7,318,06,86678
"Yermo CDP, California",618,364,254,981,06,86720
"Yettem CDP, California",108,108,0,108,06,86734
"Yolo CDP, California",99,99,0,281,06,86804
"Yorba Linda city, California",34213,32626,1587,68035,06,86832
"Yosemite Lakes CDP, California",2311,2171,140,5232,06,86878
"Yosemite Valley CDP, California",1532,1463,69,1737,06,86912
"Yosemite West CDP, California",14,14,0,29,06,86916
"Yountville city, California",1435,1332,103,3397,06,86930
"Yreka city, California",3226,3096,130,7833,06,86944
"Yuba City city, California",31919,29461,2458,69535,06,86972
"Yucaipa city, California",25899,24141,1758,54428,06,87042
"Yucca Valley town, California",9608,8876,732,21700,06,87056
"Zayante CDP, California",267,261,6,451,06,87090
"Acres Green CDP, Colorado",1713,1695,18,2627,08,00320
"Aetna Estates CDP, Colorado",730,658,72,1194,08,00620
"Aguilar town, Colorado",260,250,10,456,08,00760
"Air Force Academy CDP, Colorado",531,488,43,6665,08,00870
"Akron town, Colorado",811,794,17,1675,08,00925
"Alamosa city, Colorado",4647,4464,183,9792,08,01090
"Alamosa East CDP, Colorado",782,782,0,1319,08,01145
"Allenspark CDP, Colorado",385,371,14,622,08,01420
"Alma town, Colorado",250,236,14,396,08,01530
"Alpine CDP, Colorado",59,59,0,219,08,01640
"Altona CDP, Colorado",322,322,0,531,08,01740
"Amherst CDP, Colorado",77,77,0,77,08,01915
"Antonito town, Colorado",277,221,56,634,08,02355
"Applewood CDP, Colorado",4698,4411,287,7985,08,02575
"Arapahoe CDP, Colorado",12,12,0,21,08,02850
"Arboles CDP, Colorado",124,120,4,383,08,02905
"Aristocrat Ranchettes CDP, Colorado",905,853,52,1987,08,03015
"Arriba town, Colorado",100,100,0,235,08,03235
"Arvada city, Colorado",71802,69071,2731,123066,08,03455
"Aspen city, Colorado",4693,4582,111,6952,08,03620
"Aspen Park CDP, Colorado",509,509,0,1006,08,03730
"Atwood CDP, Colorado",109,88,21,144,08,03840
"Ault town, Colorado",854,840,14,1601,08,03950
"Aurora city, Colorado",216205,204387,11818,387349,08,04000
"Avon town, Colorado",4053,3767,286,6115,08,04110
"Avondale CDP, Colorado",160,151,9,379,08,04165
"Bark Ranch CDP, Colorado",28,28,0,129,08,04620
"Basalt town, Colorado",2439,2361,78,3815,08,04935
"Battlement Mesa CDP, Colorado",2313,2277,36,5148,08,05120
"Bayfield town, Colorado",1591,1497,94,2853,08,05265
"Bennett town, Colorado",1705,1666,39,3299,08,06090
"Berkley CDP, Colorado",6513,6119,394,11185,08,06172
"Berthoud town, Colorado",6274,6101,173,10892,08,06255
"Bethune town, Colorado",82,82,0,217,08,06530
"Beulah Valley CDP, Colorado",195,171,24,643,08,06602
"Black Forest CDP, Colorado",7102,6662,440,14437,08,06970
"Black Hawk city, Colorado",90,90,0,129,08,07025
"Blanca town, Colorado",123,104,19,321,08,07190
"Blende CDP, Colorado",339,314,25,663,08,07245
"Blue River town, Colorado",744,738,6,1238,08,07410
"Blue Sky CDP, Colorado",49,49,0,98,08,07420
"Blue Valley CDP, Colorado",55,55,0,171,08,07455
"Bonanza town, Colorado",11,0,11,11,08,07571
"Bonanza Mountain Estates CDP, Colorado",133,133,0,133,08,07580
"Boone town, Colorado",83,81,2,289,08,07795
"Boulder city, Colorado",61397,58063,3334,106598,08,07850
"Bow Mar town, Colorado",407,395,12,996,08,08070
"Brandon CDP, Colorado",0,0,0,27,08,08290
"Branson town, Colorado",17,17,0,60,08,08345
"Breckenridge town, Colorado",3131,3111,20,5017,08,08400
"Brick Center CDP, Colorado",88,88,0,88,08,08530
"Briggsdale CDP, Colorado",64,64,0,124,08,08620
"Brighton city, Colorado",21640,20537,1103,40569,08,08675
"Brook Forest CDP, Colorado",352,327,25,535,08,08950
"Brookside town, Colorado",137,109,28,290,08,09115
"Broomfield city, Colorado",43262,41879,1383,73946,08,09280
"Brush city, Colorado",2424,2330,94,5304,08,09555
"Buena Vista town, Colorado",1930,1605,325,2887,08,10105
"Burlington city, Colorado",1784,1738,46,3184,08,10600
"Byers CDP, Colorado",821,677,144,1635,08,10985
"Calhan town, Colorado",171,164,7,386,08,11260
"Campo town, Colorado",36,36,0,103,08,11645
"Cañon City city, Colorado",6849,6521,328,17059,08,11810
"Capulin CDP, Colorado",90,41,49,301,08,11975
"Carbonate town, Colorado",0,0,0,0,08,12030
"Carbondale town, Colorado",4412,4362,50,6497,08,12045
"Cascade-Chipita Park CDP, Colorado",647,529,118,1302,08,12325
"Castle Pines city, Colorado",6640,6401,239,11811,08,12387
"Castle Pines Village CDP, Colorado",2190,2065,125,4462,08,12393
"Castle Rock town, Colorado",41248,39502,1746,74065,08,12415
"Cathedral CDP, Colorado",2,2,0,16,08,12450
"Catherine CDP, Colorado",218,218,0,268,08,12460
"Cattle Creek CDP, Colorado",302,292,10,538,08,12470
"Cedaredge town, Colorado",1082,943,139,2572,08,12635
"Centennial city, Colorado",59878,57835,2043,107702,08,12815
"Center town, Colorado",1160,1036,124,2349,08,12855
"Central City city, Colorado",453,435,18,655,08,12910
"Chacra CDP, Colorado",231,231,0,428,08,12945
"Cheraw town, Colorado",96,90,6,197,08,13460
"Cherry Creek CDP, Colorado",6081,5816,265,11157,08,13590
"Cherry Hills Village city, Colorado",2639,2565,74,6405,08,13845
"Cheyenne Wells town, Colorado",483,479,4,932,08,14175
"Cimarron Hills CDP, Colorado",9998,9458,540,19039,08,14587
"City of Creede town, Colorado",181,173,8,280,08,14765
"Clifton CDP, Colorado",9503,8635,868,19443,08,15165
"Coal Creek CDP, Colorado",1401,1372,29,2431,08,15302
"Coal Creek town, Colorado",203,185,18,494,08,15330
"Coaldale CDP, Colorado",142,142,0,379,08,15440
"Cokedale town, Colorado",72,62,10,148,08,15550
"Collbran town, Colorado",239,152,87,647,08,15605
"Colona CDP, Colorado",33,33,0,89,08,15825
"Colorado City CDP, Colorado",784,784,0,1932,08,15935
"Colorado Springs city, Colorado",250388,236437,13951,479612,08,16000
"Columbine CDP, Colorado",13682,13184,498,25940,08,16110
"Columbine Valley town, Colorado",816,812,4,1928,08,16385
"Comanche Creek CDP, Colorado",328,328,0,530,08,16465
"Commerce City city, Colorado",33720,32175,1545,63050,08,16495
"Conejos CDP, Colorado",0,0,0,0,08,16715
"Cope CDP, Colorado",22,21,1,46,08,17100
"Copper Mountain CDP, Colorado",205,205,0,285,08,17150
"Cortez city, Colorado",3817,3550,267,8832,08,17375
"Cotopaxi CDP, Colorado",0,0,0,18,08,17485
"Craig city, Colorado",4573,4433,140,9013,08,17760
"Crawford town, Colorado",252,230,22,459,08,17925
"Crested Butte town, Colorado",948,890,58,1434,08,18310
"Crestone town, Colorado",19,7,12,33,08,18420
"Cripple Creek city, Colorado",379,347,32,1093,08,18530
"Crisman CDP, Colorado",164,149,15,264,08,18585
"Crook town, Colorado",29,26,3,80,08,18640
"Crowley town, Colorado",87,84,3,195,08,18750
"Dacono city, Colorado",3351,3277,74,6260,08,19080
"Dakota Ridge CDP, Colorado",20076,19400,676,34234,08,19150
"De Beque town, Colorado",253,227,26,470,08,19355
"Deer Trail town, Colorado",432,428,4,904,08,19630
"Del Norte town, Colorado",858,792,66,1808,08,19795
"Delta city, Colorado",3414,3243,171,9137,08,19850
"Denver city, Colorado",436576,416271,20305,710800,08,20000
"Derby CDP, Colorado",4456,4244,212,9009,08,20275
"Dillon town, Colorado",500,477,23,831,08,20440
"Dinosaur town, Colorado",177,101,76,495,08,20495
"Divide CDP, Colorado",113,113,0,140,08,20605
"Dolores town, Colorado",527,527,0,852,08,20770
"Dotsero CDP, Colorado",779,727,52,1189,08,21155
"Dove Creek town, Colorado",319,301,18,775,08,21265
"Dove Valley CDP, Colorado",3370,3232,138,5569,08,21330
"Downieville-Lawson-Dumont CDP, Colorado",364,364,0,558,08,21390
"Durango city, Colorado",11271,11007,264,19148,08,22035
"Eads town, Colorado",344,344,0,646,08,22145
"Eagle town, Colorado",4276,4189,87,7481,08,22200
"East Pleasant View CDP, Colorado",98,98,0,134,08,22575
"Eaton town, Colorado",3225,3108,117,5763,08,22860
"Echo Hills CDP, Colorado",286,286,0,362,08,22882
"Eckley town, Colorado",180,176,4,338,08,23025
"Edgewater city, Colorado",3713,3558,155,5002,08,23135
"Edwards CDP, Colorado",6189,5704,485,10721,08,23300
"Elbert CDP, Colorado",112,108,4,203,08,23520
"Eldora CDP, Colorado",357,357,0,381,08,23575
"Eldorado Springs CDP, Colorado",131,123,8,284,08,23630
"Elizabeth town, Colorado",1045,1014,31,1830,08,23740
"El Jebel CDP, Colorado",2735,2735,0,4328,08,23795
"Ellicott CDP, Colorado",554,547,7,1247,08,24235
"El Moro CDP, Colorado",173,163,10,220,08,24290
"Empire town, Colorado",290,283,7,447,08,24620
"Englewood city, Colorado",21319,20429,890,33634,08,24785
"Erie town, Colorado",16853,16180,673,30447,08,24950
"Estes Park town, Colorado",2772,2621,151,5906,08,25115
"Evans city, Colorado",11699,10772,927,22092,08,25280
"Evergreen CDP, Colorado",4861,4797,64,8972,08,25390
"Fairmount CDP, Colorado",5667,5533,134,10398,08,25550
"Fairplay town, Colorado",555,549,6,782,08,25610
"Federal Heights city, Colorado",7247,6969,278,14173,08,26270
"Firestone town, Colorado",9699,9329,370,16704,08,26600
"Flagler town, Colorado",206,176,30,581,08,26765
"Fleming town, Colorado",302,294,8,707,08,26875
"Florence city, Colorado",1952,1921,31,3874,08,27040
"Florissant CDP, Colorado",63,63,0,173,08,27095
"Floyd Hill CDP, Colorado",610,578,32,856,08,27175
"Fort Carson CDP, Colorado",2216,2174,42,18105,08,27370
"Fort Collins city, Colorado",101206,95831,5375,168758,08,27425
"Fort Garland CDP, Colorado",224,194,30,582,08,27535
"Fort Lupton city, Colorado",4238,3938,300,8164,08,27700
"Fort Morgan city, Colorado",5567,5296,271,11501,08,27810
"Fountain city, Colorado",13705,12743,962,29498,08,27865
"Four Square Mile CDP, Colorado",13691,13252,439,21420,08,27950
"Fowler town, Colorado",443,420,23,1115,08,27975
"Foxfield town, Colorado",343,332,11,673,08,28105
"Franktown CDP, Colorado",156,156,0,351,08,28250
"Fraser town, Colorado",883,794,89,1220,08,28305
"Frederick town, Colorado",9015,8748,267,15037,08,28360
"Frisco town, Colorado",1928,1900,28,2900,08,28690
"Fruita city, Colorado",6549,6321,228,13462,08,28745
"Fruitvale CDP, Colorado",4039,3859,180,8022,08,28800
"Fulford CDP, Colorado",0,0,0,0,08,28830
"Garden City town, Colorado",88,73,15,165,08,29185
"Gardner CDP, Colorado",0,0,0,57,08,29240
"Garfield CDP, Colorado",0,0,0,0,08,29295
"Genesee CDP, Colorado",1923,1878,45,4046,08,29625
"Genoa town, Colorado",62,62,0,126,08,29680
"Georgetown town, Colorado",661,603,58,1104,08,29735
"Gerrard CDP, Colorado",145,145,0,325,08,29845
"Gilcrest town, Colorado",575,575,0,1082,08,29955
"Glendale city, Colorado",3713,3616,97,4580,08,30340
"Glendale CDP, Colorado",14,14,0,68,08,30350
"Gleneagle CDP, Colorado",3238,3166,72,6421,08,30420
"Glenwood Springs city, Colorado",6249,6053,196,10100,08,30780
"Golden city, Colorado",11142,10630,512,20461,08,30835
"Goldfield CDP, Colorado",149,149,0,166,08,30890
"Gold Hill CDP, Colorado",208,208,0,249,08,30945
"Granada town, Colorado",246,246,0,482,08,31550
"Granby town, Colorado",1223,1221,2,2074,08,31605
"Grand Junction city, Colorado",33584,32021,1563,65918,08,31660
"Grand Lake town, Colorado",154,150,4,281,08,31715
"Grand View Estates CDP, Colorado",473,452,21,788,08,31935
"Greeley city, Colorado",55098,52028,3070,107949,08,32155
"Green Mountain Falls town, Colorado",336,336,0,518,08,32650
"Greenwood Village city, Colorado",8239,7981,258,15537,08,33035
"Grover town, Colorado",70,69,1,165,08,33310
"Guffey CDP, Colorado",0,0,0,29,08,33420
"Gunbarrel CDP, Colorado",6144,5797,347,10108,08,33502
"Gunnison city, Colorado",4553,4336,217,6629,08,33640
"Gypsum town, Colorado",4316,4284,32,8291,08,33695
"Hartman town, Colorado",24,24,0,51,08,34520
"Hartsel CDP, Colorado",0,0,0,0,08,34630
"Hasty CDP, Colorado",16,16,0,92,08,34685
"Haswell town, Colorado",30,30,0,61,08,34740
"Haxtun town, Colorado",447,425,22,917,08,34960
"Hayden town, Colorado",1091,1076,15,2057,08,35070
"Heeney CDP, Colorado",45,45,0,66,08,35400
"Hidden Lake CDP, Colorado",17,17,0,29,08,35860
"Highlands Ranch CDP, Colorado",57029,55104,1925,101514,08,36410
"Hillrose town, Colorado",114,104,10,229,08,36610
"Hoehne CDP, Colorado",18,12,6,114,08,36940
"Holly town, Colorado",329,324,5,771,08,37215
"Holly Hills CDP, Colorado",1538,1518,20,2801,08,37220
"Holyoke city, Colorado",1055,1055,0,2430,08,37270
"Hooper town, Colorado",43,43,0,178,08,37380
"Hotchkiss town, Colorado",448,435,13,1083,08,37545
"Hot Sulphur Springs town, Colorado",462,456,6,906,08,37600
"Howard CDP, Colorado",424,424,0,976,08,37655
"Hudson town, Colorado",1110,1078,32,2167,08,37820
"Hugo town, Colorado",388,371,17,929,08,37875
"Idaho Springs city, Colorado",1374,1280,94,2113,08,38370
"Idalia CDP, Colorado",56,56,0,77,08,38425
"Idledale CDP, Colorado",298,241,57,329,08,38480
"Ignacio town, Colorado",666,615,51,1257,08,38535
"Iliff town, Colorado",196,168,28,333,08,38590
"Indian Hills CDP, Colorado",800,800,0,1445,08,38810
"Inverness CDP, Colorado",2223,2150,73,2772,08,38910
"Jackson Lake CDP, Colorado",66,61,5,165,08,39160
"Jamestown town, Colorado",222,217,5,287,08,39195
"Jansen CDP, Colorado",45,28,17,235,08,39250
"Joes CDP, Colorado",44,42,2,121,08,39745
"Johnson Village CDP, Colorado",192,179,13,314,08,39800
"Johnstown town, Colorado",9886,9350,536,17327,08,39855
"Julesburg town, Colorado",521,499,22,1187,08,39965
"Keenesburg town, Colorado",865,810,55,1669,08,40185
"Ken Caryl CDP, Colorado",19843,19158,685,33505,08,40377
"Kersey town, Colorado",752,697,55,1453,08,40515
"Keystone CDP, Colorado",838,826,12,995,08,40550
"Kim town, Colorado",20,20,0,51,08,40570
"Kiowa town, Colorado",306,301,5,609,08,40790
"Kirk CDP, Colorado",43,43,0,75,08,40900
"Kit Carson town, Colorado",142,138,4,228,08,41010
"Kittredge CDP, Colorado",705,671,34,1021,08,41065
"Kremmling town, Colorado",788,769,19,1779,08,41560
"Lafayette city, Colorado",18052,17389,663,30295,08,41835
"Laird CDP, Colorado",0,0,0,5,08,42000
"La Jara town, Colorado",284,241,43,669,08,42055
"La Junta city, Colorado",3194,3002,192,7244,08,42110
"La Junta Gardens CDP, Colorado",42,42,0,132,08,42165
"Lake City town, Colorado",216,213,3,465,08,42330
"Lakeside town, Colorado",5,5,0,7,08,42495
"Lakewood city, Colorado",91038,87073,3965,156149,08,43000
"Lamar city, Colorado",3580,3367,213,7667,08,43110
"Laporte CDP, Colorado",1297,1253,44,2233,08,43220
"Larkspur town, Colorado",97,97,0,182,08,43550
"La Salle town, Colorado",1548,1524,24,2874,08,43605
"Las Animas city, Colorado",928,832,96,2421,08,43660
"La Veta town, Colorado",347,340,7,830,08,44100
"Lazear CDP, Colorado",46,46,0,142,08,44265
"Lazy Acres CDP, Colorado",494,475,19,1014,08,44270
"Leadville city, Colorado",1946,1902,44,2622,08,44320
"Leadville North CDP, Colorado",1141,1105,36,2003,08,44375
"Lewis CDP, Colorado",61,61,0,149,08,44595
"Leyner CDP, Colorado",0,0,0,0,08,44695
"Limon town, Colorado",835,819,16,1479,08,44980
"Lincoln Park CDP, Colorado",1555,1464,91,4413,08,45145
"Littleton city, Colorado",26925,25877,1048,45531,08,45255
"Lochbuie town, Colorado",4434,4332,102,7963,08,45530
"Loghill Village CDP, Colorado",206,200,6,673,08,45680
"Log Lane Village town, Colorado",423,403,20,808,08,45695
"Loma CDP, Colorado",864,851,13,1481,08,45750
"Lone Tree city, Colorado",8581,8228,353,13993,08,45955
"Longmont city, Colorado",55269,53010,2259,98282,08,45970
"Louisville city, Colorado",11510,11139,371,20920,08,46355
"Louviers CDP, Colorado",144,144,0,266,08,46410
"Loveland city, Colorado",40705,38920,1785,76500,08,46465
"Lynn CDP, Colorado",10,3,7,10,08,47015
"Lyons town, Colorado",947,915,32,1936,08,47070
"McClave CDP, Colorado",71,71,0,93,08,47235
"McCoy CDP, Colorado",0,0,0,0,08,47345
"Manassa town, Colorado",472,459,13,936,08,48060
"Mancos town, Colorado",589,580,9,1121,08,48115
"Manitou Springs city, Colorado",3126,2757,369,4848,08,48445
"Manzanola town, Colorado",159,152,7,491,08,48500
"Marble town, Colorado",105,104,1,191,08,48555
"Marvel CDP, Colorado",27,24,3,92,08,48940
"Matheson CDP, Colorado",8,5,3,28,08,49215
"Maybell CDP, Colorado",5,5,0,21,08,49325
"Maysville CDP, Colorado",101,101,0,168,08,49490
"Mead town, Colorado",2903,2827,76,5110,08,49600
"Meeker town, Colorado",1083,1075,8,2500,08,49875
"Meridian CDP, Colorado",3479,3265,214,5029,08,50012
"Meridian Village CDP, Colorado",1525,1499,26,2499,08,50026
"Merino town, Colorado",171,167,4,269,08,50040
"Midland CDP, Colorado",67,67,0,255,08,50380
"Milliken town, Colorado",5063,4915,148,8438,08,50480
"Minturn town, Colorado",645,607,38,978,08,50920
"Moffat town, Colorado",37,33,4,54,08,51250
"Monte Vista city, Colorado",2046,1876,170,4201,08,51635
"Montezuma town, Colorado",75,59,16,118,08,51690
"Montrose city, Colorado",8778,8330,448,20394,08,51745
"Monument town, Colorado",5436,5168,268,10548,08,51800
"Morgan Heights CDP, Colorado",90,90,0,289,08,51975
"Morrison town, Colorado",163,144,19,393,08,52075
"Mountain Meadows CDP, Colorado",98,98,0,179,08,52210
"Mountain View town, Colorado",393,388,5,682,08,52350
"Mountain Village town, Colorado",1131,1069,62,1582,08,52550
"Mount Crested Butte town, Colorado",649,649,0,869,08,52570
"Mulford CDP, Colorado",370,370,0,539,08,52820
"Nathrop CDP, Colorado",69,54,15,148,08,53010
"Naturita town, Colorado",192,192,0,479,08,53120
"Nederland town, Colorado",904,881,23,1413,08,53175
"New Castle town, Colorado",2405,2340,65,4874,08,53395
"Niwot CDP, Colorado",1905,1764,141,4091,08,53780
"No Name CDP, Colorado",72,72,0,269,08,53875
"Norrie CDP, Colorado",0,0,0,0,08,53945
"Northglenn city, Colorado",21448,20559,889,37948,08,54330
"North La Junta CDP, Colorado",261,254,7,461,08,54495
"North Washington CDP, Colorado",145,135,10,232,08,54750
"Norwood town, Colorado",313,280,33,558,08,54880
"Nucla town, Colorado",219,197,22,634,08,54935
"Nunn town, Colorado",229,219,10,425,08,55045
"Oak Creek town, Colorado",405,392,13,681,08,55155
"Olathe town, Colorado",804,767,37,1901,08,55540
"Olney Springs town, Colorado",152,144,8,477,08,55705
"Ophir town, Colorado",134,126,8,180,08,55870
"Orchard CDP, Colorado",37,36,1,86,08,55925
"Orchard City town, Colorado",1571,1496,75,3150,08,55980
"Orchard Mesa CDP, Colorado",3267,3010,257,7173,08,56035
"Ordway town, Colorado",541,453,88,1874,08,56145
"Otis town, Colorado",221,202,19,556,08,56365
"Ouray city, Colorado",550,525,25,1007,08,56420
"Ovid town, Colorado",140,132,8,297,08,56475
"Padroni CDP, Colorado",23,14,9,33,08,56695
"Pagosa Springs town, Colorado",803,773,30,1643,08,56860
"Palisade town, Colorado",1326,1265,61,2571,08,56970
"Palmer Lake town, Colorado",1624,1510,114,2642,08,57025
"Paoli town, Colorado",28,27,1,63,08,57245
"Paonia town, Colorado",764,717,47,1571,08,57300
"Parachute town, Colorado",843,680,163,1555,08,57400
"Paragon Estates CDP, Colorado",396,396,0,857,08,57445
"Park Center CDP, Colorado",1299,1263,36,2387,08,57465
"Parker town, Colorado",34263,33156,1107,58733,08,57630
"Parshall CDP, Colorado",53,53,0,53,08,57850
"Peetz town, Colorado",155,128,27,231,08,58235
"Penrose CDP, Colorado",1596,1460,136,3900,08,58400
"Peoria CDP, Colorado",38,32,6,74,08,58510
"Perry Park CDP, Colorado",901,901,0,1712,08,58592
"Peyton CDP, Colorado",0,0,0,0,08,58675
"Phippsburg CDP, Colorado",210,182,28,345,08,58785
"Piedra CDP, Colorado",8,8,0,40,08,58960
"Pierce town, Colorado",548,488,60,1018,08,59005
"Pine Brook Hill CDP, Colorado",277,277,0,521,08,59240
"Pine Valley CDP, Colorado",174,162,12,526,08,59520
"Pitkin town, Colorado",53,53,0,122,08,59830
"Placerville CDP, Colorado",225,225,0,347,08,59885
"Platteville town, Colorado",1669,1523,146,2917,08,60160
"Poncha Springs town, Colorado",574,574,0,867,08,60600
"Ponderosa Park CDP, Colorado",1948,1934,14,3577,08,60655
"Portland CDP, Colorado",51,51,0,118,08,60765
"Pritchett town, Colorado",67,67,0,136,08,61315
"Pueblo city, Colorado",48280,45087,3193,111430,08,62000
"Pueblo West CDP, Colorado",16592,15870,722,34337,08,62220
"Ramah town, Colorado",34,34,0,87,08,62660
"Rangely town, Colorado",1229,1149,80,2382,08,62880
"Raymer (New Raymer) town, Colorado",66,54,12,94,08,63045
"Red Cliff town, Colorado",182,182,0,292,08,63265
"Red Feather Lakes CDP, Colorado",276,276,0,428,08,63320
"Redlands CDP, Colorado",3921,3780,141,8914,08,63375
"Redstone CDP, Colorado",187,187,0,202,08,63650
"Redvale CDP, Colorado",180,171,9,349,08,63705
"Rico town, Colorado",271,271,0,382,08,64090
"Ridgway town, Colorado",631,567,64,1093,08,64200
"Rifle city, Colorado",6003,5763,240,10420,08,64255
"Rock Creek Park CDP, Colorado",24,24,0,141,08,64870
"Rockvale town, Colorado",276,255,21,683,08,64970
"Rocky Ford city, Colorado",1179,1051,128,3850,08,65190
"Rollinsville CDP, Colorado",160,160,0,189,08,65685
"Romeo town, Colorado",166,166,0,365,08,65740
"Roxborough Park CDP, Colorado",4772,4719,53,9057,08,66197
"Rye town, Colorado",82,82,0,202,08,66895
"Saddle Ridge CDP, Colorado",30,30,0,53,08,66995
"Saguache town, Colorado",232,199,33,535,08,67005
"St. Ann Highlands CDP, Colorado",134,101,33,452,08,67040
"St. Mary's CDP, Colorado",162,113,49,228,08,67142
"Salida city, Colorado",2930,2826,104,5697,08,67280
"Salt Creek CDP, Colorado",481,422,59,790,08,67445
"San Acacio CDP, Colorado",25,25,0,57,08,67500
"Sanford town, Colorado",582,542,40,1306,08,67830
"San Luis town, Colorado",267,258,9,603,08,68105
"Sawpit town, Colorado",8,8,0,11,08,68655
"Security-Widefield CDP, Colorado",18476,17072,1404,39150,08,68847
"Sedalia CDP, Colorado",38,38,0,38,08,68875
"Sedgwick town, Colorado",86,83,3,160,08,68930
"Segundo CDP, Colorado",65,65,0,172,08,68985
"Seibert town, Colorado",48,48,0,140,08,69040
"Seven Hills CDP, Colorado",43,43,0,133,08,69110
"Severance town, Colorado",4809,4708,101,8526,08,69150
"Shaw Heights CDP, Colorado",2945,2862,83,5458,08,69480
"Sheridan city, Colorado",3034,2729,305,6062,08,69645
"Sheridan Lake town, Colorado",21,21,0,56,08,69700
"Sherrelwood CDP, Colorado",10117,9568,549,19254,08,69810
"Sierra Ridge CDP, Colorado",1831,1806,25,2933,08,70112
"Silt town, Colorado",1972,1939,33,3529,08,70195
"Silver Cliff town, Colorado",231,223,8,735,08,70250
"Silver Plume town, Colorado",91,91,0,203,08,70360
"Silverthorne town, Colorado",3080,2886,194,4550,08,70525
"Silverton town, Colorado",382,352,30,613,08,70580
"Simla town, Colorado",288,288,0,588,08,70635
"Smeltertown CDP, Colorado",57,57,0,104,08,71625
"Snowmass Village town, Colorado",1726,1726,0,3076,08,71755
"Snyder CDP, Colorado",40,40,0,106,08,71790
"Somerset CDP, Colorado",13,13,0,61,08,71845
"Southern Ute CDP, Colorado",46,46,0,136,08,72320
"South Fork town, Colorado",180,165,15,458,08,72395
"Springfield town, Colorado",568,555,13,1357,08,73330
"Starkville town, Colorado",36,36,0,182,08,73715
"Steamboat Springs city, Colorado",7682,7407,275,13251,08,73825
"Stepping Stone CDP, Colorado",1523,1477,46,2766,08,73925
"Sterling city, Colorado",6511,6296,215,13466,08,73935
"Sterling Ranch CDP, Colorado",1080,1064,16,1900,08,73943
"Stonegate CDP, Colorado",5451,5258,193,9770,08,74080
"Stonewall Gap CDP, Colorado",12,11,1,95,08,74275
"Strasburg CDP, Colorado",1528,1435,93,3149,08,74375
"Stratmoor CDP, Colorado",3464,3321,143,7154,08,74430
"Stratton town, Colorado",314,310,4,722,08,74485
"Sugar City town, Colorado",365,340,25,705,08,74815
"Sugarloaf CDP, Colorado",280,280,0,501,08,74980
"Sunshine CDP, Colorado",175,175,0,212,08,75585
"Superior town, Colorado",7408,7161,247,13146,08,75640
"Swink town, Colorado",320,320,0,689,08,75970
"Tabernash CDP, Colorado",493,470,23,791,08,76190
"Tall Timber CDP, Colorado",104,104,0,410,08,76325
"Telluride town, Colorado",1772,1722,50,2622,08,76795
"The Pinery CDP, Colorado",5643,5473,170,10534,08,77235
"Thornton city, Colorado",80360,76700,3660,141799,08,77290
"Timnath town, Colorado",3419,3389,30,7122,08,77510
"Todd Creek CDP, Colorado",2892,2829,63,5057,08,77757
"Towaoc CDP, Colorado",326,326,0,1186,08,78280
"Towner CDP, Colorado",5,5,0,10,08,78335
"Trail Side CDP, Colorado",48,48,0,83,08,78345
"Trinidad city, Colorado",4072,3737,335,8334,08,78610
"Twin Lakes CDP (Adams County), Colorado",4772,4488,284,7686,08,79100
"Twin Lakes CDP (Lake County), Colorado",182,182,0,348,08,79105
"Two Buttes town, Colorado",11,11,0,19,08,79270
"Upper Bear Creek CDP, Colorado",463,463,0,921,08,79785
"Upper Witter Gulch CDP, Colorado",407,407,0,611,08,79800
"Vail town, Colorado",3349,3093,256,4833,08,80040
"Valdez CDP, Colorado",0,0,0,12,08,80095
"Valmont CDP, Colorado",65,65,0,81,08,80370
"Vernon CDP, Colorado",0,0,0,0,08,80755
"Victor city, Colorado",174,164,10,310,08,80865
"Vilas town, Colorado",48,48,0,111,08,81030
"Vineland CDP, Colorado",193,193,0,404,08,81305
"Vona town, Colorado",92,92,0,148,08,81690
"Walden town, Colorado",338,338,0,704,08,82130
"Walsenburg city, Colorado",1203,1096,107,3072,08,82350
"Walsh town, Colorado",163,161,2,552,08,82460
"Ward town, Colorado",31,26,5,47,08,82735
"Watkins CDP, Colorado",497,497,0,991,08,82900
"Welby CDP, Colorado",9553,9087,466,16287,08,83120
"Weldona CDP, Colorado",88,88,0,122,08,83175
"Wellington town, Colorado",5722,5281,441,11163,08,83230
"Westcliffe town, Colorado",237,221,16,443,08,83450
"Westcreek CDP, Colorado",233,233,0,281,08,83500
"Westminster city, Colorado",69800,66926,2874,115502,08,83835
"Weston CDP, Colorado",10,10,0,31,08,84000
"West Pleasant View CDP, Colorado",2798,2647,151,5197,08,84042
"Wheat Ridge city, Colorado",18830,17830,1000,32263,08,84440
"Wiggins town, Colorado",562,521,41,1138,08,84770
"Wiley town, Colorado",220,215,5,412,08,85045
"Williamsburg town, Colorado",369,353,16,810,08,85155
"Windsor town, Colorado",18201,17311,890,33905,08,85485
"Winter Park town, Colorado",490,458,32,762,08,85705
"Wolcott CDP, Colorado",0,0,0,0,08,85760
"Woodland Park city, Colorado",3921,3772,149,7911,08,86090
"Woodmoor CDP, Colorado",4570,4360,210,8859,08,86117
"Woody Creek CDP, Colorado",124,124,0,237,08,86200
"Wray city, Colorado",1230,1160,70,2461,08,86310
"Yampa town, Colorado",192,189,3,424,08,86475
"Yuma city, Colorado",1789,1623,166,3443,08,86750
"Ansonia city, Connecticut",10557,9507,1050,18954,09,01150
"Ball Pond CDP, Connecticut",1206,1156,50,2531,09,02480
"Baltic CDP, Connecticut",638,608,30,1150,09,02550
"Bantam borough, Connecticut",359,346,13,697,09,02690
"Bethel CDP, Connecticut",6298,6041,257,11551,09,04790
"Bethlehem Village CDP, Connecticut",1194,1184,10,2103,09,04945
"Bigelow Corners CDP, Connecticut",319,309,10,936,09,04965
"Blue Hills CDP, Connecticut",1355,1308,47,2224,09,06050
"Bogus Hill CDP, Connecticut",110,95,15,199,09,06155
"Botsford CDP, Connecticut",347,347,0,571,09,06680
"Branchville CDP, Connecticut",46,46,0,79,09,07100
"Branford Center CDP, Connecticut",3598,3441,157,6201,09,07345
"Bridgeport city, Connecticut",79753,72144,7609,148470,09,08000
"Bridgewater CDP, Connecticut",72,72,0,142,09,08140
"Bristol city, Connecticut",35189,32860,2329,61052,09,08420
"Broad Brook CDP, Connecticut",2176,2087,89,4006,09,08770
"Brookfield Center CDP, Connecticut",135,126,9,170,09,09050
"Brooklyn CDP, Connecticut",307,307,0,886,09,09120
"Byram CDP, Connecticut",3008,2613,395,5285,09,10660
"Canaan CDP, Connecticut",591,516,75,1353,09,10870
"Candlewood Isle CDP, Connecticut",283,283,0,467,09,11360
"Candlewood Knolls CDP, Connecticut",117,72,45,170,09,11430
"Candlewood Lake Club CDP, Connecticut",84,84,0,145,09,11500
"Candlewood Orchards CDP, Connecticut",318,301,17,655,09,11640
"Candlewood Shores CDP, Connecticut",508,477,31,792,09,11780
"Cannondale CDP, Connecticut",187,187,0,532,09,11990
"Canton Valley CDP, Connecticut",676,674,2,1484,09,12370
"Cheshire Village CDP, Connecticut",3076,2933,143,5879,09,14200
"Chester Center CDP, Connecticut",885,856,29,1729,09,14370
"Chimney Point CDP, Connecticut",88,88,0,106,09,14615
"Clinton CDP, Connecticut",1853,1785,68,3113,09,15420
"Colchester CDP, Connecticut",2268,2086,182,4868,09,15840
"Coleytown CDP, Connecticut",1636,1504,132,3390,09,16085
"Collinsville CDP, Connecticut",1967,1923,44,3750,09,16120
"Compo CDP, Connecticut",1571,1500,71,3638,09,16525
"Conning Towers-Nautilus Park CDP, Connecticut",2189,2025,164,8330,09,16960
"Cornwall CDP, Connecticut",70,70,0,83,09,17170
"Cornwall Bridge CDP, Connecticut",101,98,3,229,09,17310
"Cos Cob CDP, Connecticut",3963,3713,250,7243,09,17520
"Coventry Lake CDP, Connecticut",1207,1162,45,2230,09,17835
"Crystal Lake CDP, Connecticut",1158,1158,0,2080,09,18220
"Danbury city, Connecticut",49816,46806,3010,86456,09,18430
"Daniels Farm CDP, Connecticut",3131,2948,183,6067,09,18675
"Danielson borough, Connecticut",2522,2095,427,4162,09,18780
"Darien Downtown CDP, Connecticut",559,505,54,1177,09,18936
"Dayville CDP, Connecticut",158,158,0,290,09,18990
"Deep River Center CDP, Connecticut",1639,1589,50,2700,09,19200
"Derby city, Connecticut",6775,6365,410,12373,09,19480
"Dodgingtown CDP, Connecticut",14,14,0,89,09,20250
"Durham CDP, Connecticut",2210,2077,133,3469,09,20740
"East Brooklyn CDP, Connecticut",1052,948,104,2051,09,21160
"East Hampton CDP, Connecticut",1528,1460,68,2944,09,22420
"East Hartford CDP, Connecticut",27593,25750,1843,50942,09,22700
"East Haven CDP, Connecticut",15241,14480,761,27871,09,22980
"East Village CDP, Connecticut",2188,2132,56,4189,09,24520
"Essex Village CDP, Connecticut",1511,1511,0,2725,09,26370
"Fairfield University CDP, Connecticut",895,824,71,3169,09,26698
"Falls Village CDP, Connecticut",222,219,3,473,09,27390
"Fenwick borough, Connecticut",17,17,0,40,09,27810
"Gales Ferry CDP, Connecticut",492,487,5,1113,09,30190
"Gaylordsville CDP, Connecticut",335,335,0,538,09,30470
"Georgetown CDP, Connecticut",1132,1037,95,1656,09,30540
"Glastonbury Center CDP, Connecticut",4141,4029,112,7959,09,31270
"Glenville CDP, Connecticut",2028,1878,150,3112,09,31520
"Greens Farms CDP, Connecticut",1307,1288,19,3050,09,33480
"Greenwich CDP, Connecticut",6842,6288,554,14051,09,33690
"Groton city, Connecticut",5591,5250,341,9364,09,34180
"Groton Long Point borough, Connecticut",277,256,21,517,09,34460
"Guilford Center CDP, Connecticut",1409,1400,9,2541,09,35020
"Hartford city, Connecticut",59976,53598,6378,121057,09,37000
"Hawleyville CDP, Connecticut",76,76,0,150,09,37490
"Hazardville CDP, Connecticut",3367,3221,146,6123,09,37770
"Heritage Village CDP, Connecticut",1158,1119,39,4411,09,37930
"Higganum CDP, Connecticut",932,932,0,1693,09,38050
"Indian Field CDP, Connecticut",210,203,7,451,09,39695
"Inglenook CDP, Connecticut",523,516,7,1082,09,39747
"Jewett City borough, Connecticut",1760,1617,143,3415,09,39940
"Kellogg Point CDP, Connecticut",0,0,0,0,09,40077
"Kensington CDP, Connecticut",5652,5528,124,9580,09,40150
"Knollcrest CDP, Connecticut",199,190,9,302,09,40920
"Lake Bungee CDP, Connecticut",347,347,0,515,09,41226
"Lake Chaffee CDP, Connecticut",134,134,0,301,09,41238
"Lake Pocotopaug CDP, Connecticut",2459,2329,130,4761,09,41410
"Lakes East CDP, Connecticut",785,785,0,1457,09,41585
"Lakeside Woods CDP, Connecticut",256,256,0,402,09,41714
"Lakes West CDP, Connecticut",766,716,50,1358,09,41736
"Lakeville CDP, Connecticut",502,502,0,886,09,41830
"Litchfield borough, Connecticut",692,658,34,1355,09,43300
"Long Hill CDP (Greater Bridgeport County), Connecticut",4479,4125,354,8279,09,43580
"Long Hill CDP (Southeastern Connecticut County), Connecticut",2660,2515,145,4520,09,43790
"Lordship CDP, Connecticut",2319,2259,60,3850,09,44000
"Madison Center CDP, Connecticut",843,820,23,1536,09,44630
"Mamanasco Lake CDP, Connecticut",201,196,5,470,09,44660
"Manchester CDP, Connecticut",20663,19614,1049,37015,09,44690
"Mansfield Center CDP, Connecticut",552,533,19,1281,09,45120
"Mashantucket CDP, Connecticut",44,42,2,104,09,45995
"Mechanicsville CDP, Connecticut",405,405,0,542,09,46240
"Meriden city, Connecticut",30926,28315,2611,60556,09,46450
"Middletown city, Connecticut",27692,26383,1309,48152,09,47290
"Milford city (balance), Connecticut",29304,28042,1262,50664,09,47515
"Mill Plain CDP, Connecticut",1096,908,188,1841,09,47990
"Moodus CDP, Connecticut",1031,1000,31,1666,09,49110
"Moosup CDP, Connecticut",1832,1708,124,3175,09,49180
"Murray CDP, Connecticut",320,303,17,707,09,49720
"Mystic CDP, Connecticut",1982,1909,73,4417,09,49810
"Naugatuck borough, Connecticut",18866,17819,1047,31653,09,49880
"New Britain city, Connecticut",38736,35275,3461,74212,09,50370
"New Canaan CDP, Connecticut",3064,2725,339,6863,09,50576
"New Hartford Center CDP, Connecticut",613,582,31,1364,09,51420
"New Haven city, Connecticut",70583,65086,5497,135736,09,52000
"Newington CDP, Connecticut",17675,17128,547,30458,09,52210
"New London city, Connecticut",13908,12927,981,27596,09,52280
"New Milford CDP, Connecticut",3979,3814,165,7095,09,52560
"New Preston CDP, Connecticut",494,487,7,1026,09,52770
"Newtown borough, Connecticut",1102,1064,38,1959,09,52910
"Niantic CDP, Connecticut",1659,1615,44,3497,09,53120
"Noank CDP, Connecticut",976,967,9,1708,09,53260
"Norfolk CDP, Connecticut",359,351,8,652,09,53400
"Noroton CDP, Connecticut",2696,2525,171,5605,09,53540
"Noroton Heights CDP, Connecticut",1751,1685,66,3006,09,53610
"Northford CDP, Connecticut",3332,3219,113,6189,09,54450
"North Granby CDP, Connecticut",894,894,0,1556,09,54660
"North Grosvenor Dale CDP, Connecticut",647,574,73,1281,09,54730
"North Haven CDP, Connecticut",13262,12814,448,24179,09,54940
"Northwest Harwinton CDP, Connecticut",1706,1629,77,3202,09,55725
"Norwalk city, Connecticut",53288,50148,3140,91050,09,55990
"Norwich city, Connecticut",20584,19140,1444,40054,09,56200
"Oakville CDP, Connecticut",5380,5253,127,9387,09,56690
"Old Greenwich CDP, Connecticut",3080,2940,140,7060,09,56900
"Old Hill CDP, Connecticut",1508,1453,55,2856,09,56935
"Old Mystic CDP, Connecticut",1721,1625,96,3385,09,57180
"Old Saybrook Center CDP, Connecticut",1053,1053,0,2017,09,57390
"Orange CDP, Connecticut",7383,7101,282,14231,09,57670
"Oronoque CDP, Connecticut",1559,1385,174,4065,09,57880
"Oxoboxo River CDP, Connecticut",1181,1100,81,2429,09,58520
"Pawcatuck CDP, Connecticut",2941,2791,150,5570,09,59140
"Pemberwick CDP, Connecticut",1967,1860,107,3212,09,59210
"Plainfield Village CDP, Connecticut",1231,1106,125,2681,09,60090
"Plantsville CDP, Connecticut",1185,1157,28,2084,09,60260
"Plattsville CDP, Connecticut",385,379,6,876,09,60365
"Pleasant Valley CDP, Connecticut",199,125,74,307,09,60540
"Poplar Plains CDP, Connecticut",709,700,9,1431,09,61555
"Poquonock Bridge CDP, Connecticut",814,685,129,1390,09,61730
"Portland CDP, Connecticut",3768,3531,237,6417,09,61870
"Putnam CDP, Connecticut",3868,3658,210,7207,09,62640
"Quasset Lake CDP, Connecticut",153,145,8,244,09,63165
"Quinebaug CDP, Connecticut",532,478,54,946,09,63270
"Quinnipiac University CDP, Connecticut",2450,2380,70,4926,09,63313
"Redding Center CDP, Connecticut",111,105,6,258,09,63620
"Ridgebury CDP, Connecticut",969,969,0,2187,09,63830
"Ridgefield CDP, Connecticut",3867,3645,222,7655,09,63900
"Riverside CDP, Connecticut",4112,3880,232,9093,09,64530
"Riverton CDP, Connecticut",160,152,8,332,09,64880
"Rock Ridge CDP, Connecticut",217,217,0,418,09,65160
"Rockville CDP, Connecticut",3483,3090,393,6951,09,65230
"Route 7 Gateway CDP, Connecticut",255,255,0,1009,09,65685
"Sacred Heart University CDP, Connecticut",407,401,6,1269,09,66086
"Sail Harbor CDP, Connecticut",37,37,0,143,09,66113
"Salmon Brook CDP, Connecticut",1155,1127,28,2184,09,66455
"Sandy Hook CDP, Connecticut",5520,5221,299,9604,09,66700
"Saugatuck CDP, Connecticut",1606,1485,121,2999,09,66770
"Saybrook Manor CDP, Connecticut",781,748,33,1231,09,67050
"Sharon CDP, Connecticut",204,199,5,403,09,67890
"Shelton city, Connecticut",22848,21586,1262,41206,09,68100
"Sherman CDP, Connecticut",23,23,0,33,09,68240
"Sherwood Manor CDP, Connecticut",3317,3163,154,5731,09,68450
"Simsbury Center CDP, Connecticut",3374,3205,169,6110,09,69010
"Somers CDP, Connecticut",1035,1035,0,2231,09,69150
"South Coventry CDP, Connecticut",588,572,16,1468,09,69990
"Southport CDP, Connecticut",872,826,46,1515,09,71040
"South Wilton CDP, Connecticut",881,857,24,1428,09,71215
"South Windham CDP, Connecticut",655,647,8,1412,09,71250
"Southwood Acres CDP, Connecticut",4778,4630,148,7928,09,71460
"South Woodstock CDP, Connecticut",1055,979,76,1418,09,71530
"Stafford Springs CDP, Connecticut",2505,2339,166,4890,09,72300
"Stamford city, Connecticut",80239,75860,4379,135413,09,73000
"Staples CDP, Connecticut",3155,2993,162,7200,09,73175
"Stepney CDP, Connecticut",2168,2068,100,3674,09,73280
"Stonington borough, Connecticut",448,419,29,942,09,73700
"Storrs CDP, Connecticut",7562,6613,949,17606,09,73980
"Stratford Downtown CDP, Connecticut",944,828,116,1949,09,74303
"Suffield Depot CDP, Connecticut",1348,1149,199,1886,09,74655
"Taylor Corners CDP, Connecticut",279,232,47,566,09,75065
"Tariffville CDP, Connecticut",1271,1084,187,1803,09,75100
"Tashua CDP, Connecticut",1546,1476,70,3404,09,75116
"Terramuggus CDP, Connecticut",458,439,19,778,09,75200
"Terryville CDP, Connecticut",2934,2773,161,4998,09,75240
"Thomaston CDP, Connecticut",1021,971,50,2087,09,75660
"Thompsonville CDP, Connecticut",4099,3381,718,8097,09,75940
"Tokeneke CDP, Connecticut",1033,974,59,2575,09,76150
"Topstone CDP, Connecticut",65,65,0,178,09,76400
"Torrington city, Connecticut",19445,18310,1135,35510,09,76500
"Trumbull Center CDP, Connecticut",4922,4516,406,10335,09,77278
"Wallingford Center CDP, Connecticut",10377,9768,609,18738,09,78880
"Waterbury city, Connecticut",56206,50700,5506,114480,09,80000
"Waterford CDP, Connecticut",1709,1569,140,3276,09,80210
"Watertown CDP, Connecticut",1991,1910,81,3765,09,80420
"Wauregan CDP, Connecticut",776,759,17,1396,09,80630
"Weatogue CDP, Connecticut",1487,1476,11,2671,09,80770
"Westbrook Center CDP, Connecticut",1351,1302,49,2317,09,81750
"West Cornwall CDP, Connecticut",36,36,0,54,09,82030
"West Hartford CDP, Connecticut",35611,34227,1384,64088,09,82660
"West Haven city, Connecticut",29517,27195,2322,55336,09,82800
"West Mountain CDP, Connecticut",225,225,0,423,09,83045
"Weston CDP, Connecticut",446,446,0,797,09,83360
"Westport Village CDP, Connecticut",1350,1257,93,2668,09,83586
"West Simsbury CDP, Connecticut",1189,1135,54,2796,09,83990
"Wethersfield CDP, Connecticut",15273,14605,668,27192,09,84970
"Willimantic CDP, Connecticut",8904,8175,729,17762,09,85810
"Wilton Center CDP, Connecticut",875,854,21,1642,09,86380
"Windsor Locks CDP, Connecticut",7667,7106,561,12563,09,87140
"Winsted CDP, Connecticut",3735,3501,234,6880,09,87350
"Witches Woods CDP, Connecticut",71,60,11,397,09,87455
"Woodbury Center CDP, Connecticut",746,660,86,1445,09,87980
"Woodmont borough, Connecticut",986,958,28,1619,09,88050
"Arden village, Delaware",313,299,14,652,10,01400
"Ardencroft village, Delaware",114,114,0,190,10,01530
"Ardentown village, Delaware",105,100,5,223,10,01660
"Bear CDP, Delaware",13590,12539,1051,23070,10,04130
"Bellefonte town, Delaware",864,825,39,1526,10,04650
"Bethany Beach town, Delaware",400,391,9,1064,10,05690
"Bethel town, Delaware",123,119,4,376,10,05820
"Blades town, Delaware",480,456,24,960,10,06730
"Bowers town, Delaware",112,102,10,336,10,07250
"Bridgeville town, Delaware",872,806,66,2590,10,08680
"Brookside CDP, Delaware",7820,7467,353,14331,10,09850
"Camden town, Delaware",1737,1676,61,3914,10,10760
"Cheswold town, Delaware",757,723,34,1639,10,14660
"Claymont CDP, Delaware",5884,5652,232,10191,10,15310
"Clayton town, Delaware",1833,1790,43,3978,10,15440
"Dagsboro town, Delaware",663,630,33,1338,10,18950
"Delaware City city, Delaware",987,899,88,1932,10,19730
"Delmar town, Delaware",1044,990,54,2398,10,20380
"Dewey Beach town, Delaware",176,173,3,359,10,20900
"Dover city, Delaware",18638,17025,1613,38879,10,21200
"Dover Base Housing CDP, Delaware",696,667,29,3262,10,21387
"Edgemoor CDP, Delaware",3642,3438,204,6485,10,23240
"Ellendale town, Delaware",188,188,0,609,10,24020
"Elsmere town, Delaware",3244,3075,169,6194,10,24540
"Farmington town, Delaware",145,88,57,234,10,25840
"Felton town, Delaware",582,549,33,1136,10,26620
"Fenwick Island town, Delaware",107,107,0,350,10,26880
"Frankford town, Delaware",477,473,4,842,10,28310
"Frederica town, Delaware",510,484,26,1001,10,28440
"Georgetown town, Delaware",3168,3104,64,7247,10,29090
"Glasgow CDP, Delaware",9031,8452,579,15405,10,29350
"Greenville CDP, Delaware",1419,1370,49,2824,10,31430
"Greenwood town, Delaware",911,877,34,1556,10,31560
"Harrington city, Delaware",1930,1834,96,3770,10,33120
"Hartly town, Delaware",69,69,0,161,10,33250
"Henlopen Acres town, Delaware",66,64,2,193,10,33900
"Highland Acres CDP, Delaware",1762,1710,52,3892,10,34810
"Hockessin CDP, Delaware",6720,6411,309,13878,10,35850
"Houston town, Delaware",275,252,23,426,10,36760
"Kent Acres CDP, Delaware",961,896,65,2124,10,38710
"Kenton town, Delaware",119,83,36,400,10,39100
"Laurel town, Delaware",1458,1256,202,3954,10,41310
"Leipsic town, Delaware",96,89,7,171,10,41700
"Lewes city, Delaware",1199,1187,12,3339,10,41830
"Lincoln CDP, Delaware",542,542,0,1439,10,42480
"Little Creek town, Delaware",146,136,10,272,10,42870
"Long Neck CDP, Delaware",1432,1324,108,2983,10,43245
"Magnolia town, Delaware",96,87,9,263,10,44430
"Middletown town, Delaware",11909,11055,854,23573,10,47030
"Milford city, Delaware",5445,5111,334,11714,10,47420
"Millsboro town, Delaware",3279,3162,117,6876,10,47940
"Millville town, Delaware",681,665,16,2052,10,48200
"Milton town, Delaware",1184,1096,88,3349,10,48330
"Newark city, Delaware",14297,13292,1005,30655,10,50670
"New Castle city, Delaware",3261,3217,44,5523,10,50800
"Newport town, Delaware",571,541,30,1145,10,51190
"North Star CDP, Delaware",4426,4262,164,8370,10,52490
"Ocean View town, Delaware",923,909,14,2660,10,53920
"Odessa town, Delaware",167,166,1,389,10,54050
"Pike Creek CDP, Delaware",3951,3811,140,6975,10,56490
"Pike Creek Valley CDP, Delaware",6815,6535,280,11452,10,56500
"Port Penn CDP, Delaware",23,23,0,138,10,58600
"Rehoboth Beach city, Delaware",655,609,46,1357,10,60290
"Rising Sun-Lebanon CDP, Delaware",1642,1620,22,4060,10,61265
"Riverview CDP, Delaware",987,969,18,2270,10,61480
"Rodney Village CDP, Delaware",575,547,28,1304,10,61720
"St. Georges CDP, Delaware",932,904,28,1304,10,63800
"Seaford city, Delaware",3893,3444,449,8055,10,64320
"Selbyville town, Delaware",1538,1485,53,2907,10,64840
"Slaughter Beach town, Delaware",181,174,7,393,10,67050
"Smyrna town, Delaware",6853,6435,418,12870,10,67310
"South Bethany town, Delaware",150,144,6,490,10,67700
"Townsend town, Delaware",1574,1535,39,2728,10,72510
"Viola town, Delaware",45,41,4,81,10,74330
"Wilmington city, Delaware",37214,34003,3211,71034,10,77580
"Wilmington Manor CDP, Delaware",4778,4592,186,8260,10,77840
"Woodside town, Delaware",116,112,4,253,10,80830
"Woodside East CDP, Delaware",826,642,184,2002,10,80895
"Wyoming town, Delaware",854,701,153,1888,10,81350
"Washington city, District of Columbia",397662,369398,28264,670587,11,50000
"Acacia Villas CDP, Florida",215,215,0,363,12,00075
"Alachua city, Florida",5050,4853,197,10570,12,00375
"Alafaya CDP, Florida",52156,49879,2277,91531,12,00410
"Alford town, Florida",213,208,5,432,12,00625
"Allentown CDP, Florida",276,276,0,1030,12,00800
"Altamonte Springs city, Florida",27630,26136,1494,45772,12,00950
"Altha town, Florida",170,170,0,525,12,01000
"Altoona CDP, Florida",0,0,0,26,12,01050
"Alturas CDP, Florida",1692,1609,83,3460,12,01100
"Alva CDP, Florida",1236,1225,11,2986,12,01125
"Andrews CDP, Florida",518,518,0,944,12,01353
"Anna Maria city, Florida",196,196,0,825,12,01475
"Apalachicola city, Florida",1126,1035,91,2504,12,01625
"Apollo Beach CDP, Florida",13393,12849,544,26444,12,01675
"Apopka city, Florida",29704,28680,1024,55056,12,01700
"Arcadia city, Florida",3419,3136,283,7480,12,01750
"Archer city, Florida",364,340,24,908,12,01775
"Aripeka CDP, Florida",25,25,0,185,12,01875
"Asbury Lake CDP, Florida",6242,6160,82,12515,12,02187
"Astatula town, Florida",1180,1098,82,2573,12,02250
"Astor CDP, Florida",615,593,22,1469,12,02275
"Atlantic Beach city, Florida",6899,6751,148,13381,12,02400
"Atlantis city, Florida",828,805,23,1767,12,02500
"Auburndale city, Florida",7676,7417,259,16432,12,02550
"Aucilla CDP, Florida",90,70,20,179,12,02575
"Avalon CDP, Florida",461,461,0,777,12,02660
"Ave Maria CDP, Florida",2656,2529,127,5895,12,02677
"Aventura city, Florida",18321,17441,880,39621,12,02681
"Avon Park city, Florida",3601,3179,422,9789,12,02750
"Azalea Park CDP, Florida",8768,8182,586,16024,12,02850
"Babson Park CDP, Florida",410,410,0,1071,12,02900
"Bagdad CDP, Florida",2239,2215,24,4359,12,02925
"Baldwin town, Florida",853,766,87,1798,12,03250
"Bal Harbour village, Florida",1312,1209,103,3035,12,03275
"Balm CDP, Florida",3067,2986,81,5397,12,03375
"Bardmoor CDP, Florida",5236,5078,158,9834,12,03480
"Bartow city, Florida",10158,9752,406,19424,12,03675
"Bascom town, Florida",70,69,1,123,12,03725
"Bay Harbor Islands town, Florida",3010,2908,102,5843,12,03975
"Bay Hill CDP, Florida",2514,2464,50,4363,12,04070
"Bay Lake city, Florida",39,39,0,42,12,04150
"Bayonet Point CDP, Florida",9617,8894,723,24628,12,04162
"Bay Pines CDP, Florida",1192,1183,9,2717,12,04200
"Bayport CDP, Florida",0,0,0,106,12,04250
"Bayshore Gardens CDP, Florida",8582,7579,1003,18745,12,04350
"Beacon Square CDP, Florida",3411,3171,240,7327,12,04650
"Bear Creek CDP, Florida",951,915,36,2066,12,04735
"Bee Ridge CDP, Florida",4603,4477,126,10069,12,04925
"Bell town, Florida",234,234,0,469,12,04975
"Bellair-Meadowbrook Terrace CDP, Florida",7220,6967,253,13850,12,05025
"Belleair town, Florida",1984,1920,64,4295,12,05075
"Belleair Beach city, Florida",658,637,21,1512,12,05100
"Belleair Bluffs city, Florida",1241,1183,58,2476,12,05125
"Belleair Shore town, Florida",29,29,0,67,12,05150
"Belle Glade city, Florida",7753,6786,967,16896,12,05200
"Belle Isle city, Florida",3370,3328,42,7020,12,05300
"Belleview city, Florida",2455,2422,33,5438,12,05375
"Bellview CDP, Florida",11177,10567,610,24035,12,05462
"Berkshire Lakes CDP, Florida",1233,1180,53,2476,12,05806
"Berrydale CDP, Florida",93,93,0,180,12,05825
"Beverly Beach town, Florida",175,168,7,495,12,06100
"Beverly Hills CDP, Florida",4074,3727,347,9787,12,06125
"Big Coppitt Key CDP, Florida",1753,1702,51,3188,12,06350
"Big Pine Key CDP, Florida",2129,2090,39,4502,12,06425
"Biscayne Park village, Florida",1228,1199,29,3098,12,06600
"Bithlo CDP, Florida",6057,5826,231,11041,12,06625
"Black Diamond CDP, Florida",243,209,34,1195,12,06667
"Black Hammock CDP, Florida",739,699,40,1140,12,06670
"Bloomingdale CDP, Florida",12174,11615,559,24103,12,06875
"Blountstown city, Florida",1274,1242,32,3297,12,06925
"Boca Raton city, Florida",47890,45069,2821,97980,12,07300
"Bokeelia CDP, Florida",663,622,41,2230,12,07375
"Bonifay city, Florida",954,873,81,2760,12,07450
"Bonita Springs city, Florida",21544,20766,778,53945,12,07525
"Boulevard Gardens CDP, Florida",583,583,0,1714,12,07687
"Bowling Green city, Florida",1020,879,141,2484,12,07775
"Boynton Beach city, Florida",44424,41996,2428,80068,12,07875
"Bradenton city, Florida",24708,23054,1654,55795,12,07950
"Bradenton Beach city, Florida",275,268,7,737,12,07975
"Bradfordville CDP, Florida",9691,9449,242,18833,12,08075
"Bradley Junction CDP, Florida",335,320,15,743,12,08125
"Brandon CDP, Florida",61974,59115,2859,114923,12,08150
"Branford town, Florida",422,396,26,873,12,08175
"Brent CDP, Florida",11022,10293,729,22969,12,08300
"Briny Breezes town, Florida",125,119,6,570,12,08575
"Bristol city, Florida",494,462,32,1351,12,08600
"Broadview Park CDP, Florida",4329,4043,286,7385,12,08650
"Bronson town, Florida",688,677,11,1424,12,08700
"Brooker town, Florida",121,114,7,243,12,08725
"Brookridge CDP, Florida",1108,1092,16,4783,12,08762
"Brooksville city, Florida",3421,3271,150,8981,12,08800
"Brownsdale CDP, Florida",161,161,0,389,12,08925
"Brownsville CDP, Florida",8245,7625,620,17817,12,09000
"Buckhead Ridge CDP, Florida",252,220,32,1028,12,09315
"Buckingham CDP, Florida",2102,2018,84,4288,12,09350
"Buenaventura Lakes CDP, Florida",19271,18059,1212,33284,12,09415
"Bunnell city, Florida",1223,1177,46,3355,12,09550
"Burnt Store Marina CDP, Florida",377,355,22,2278,12,09612
"Bushnell city, Florida",917,917,0,3081,12,09625
"Butler Beach CDP, Florida",2290,2146,144,4831,12,09630
"Cabana Colony CDP, Florida",1547,1530,17,2334,12,09655
"Callahan town, Florida",707,686,21,1469,12,09700
"Callaway city, Florida",6785,6465,320,13455,12,09725
"Campbell CDP, Florida",845,747,98,2262,12,09875
"Campbellton town, Florida",76,76,0,240,12,09900
"Canal Point CDP, Florida",276,236,40,437,12,10100
"Cape Canaveral city, Florida",5341,5184,157,9980,12,10250
"Cape Coral city, Florida",97585,93332,4253,198912,12,10275
"Capitola CDP, Florida",140,140,0,310,12,10350
"Captiva CDP, Florida",56,56,0,151,12,10425
"Carrabelle city, Florida",641,579,62,3151,12,10725
"Carrollwood CDP, Florida",19223,18452,771,36148,12,10825
"Caryville town, Florida",120,114,6,269,12,10975
"Casselberry city, Florida",16023,15400,623,29092,12,11050
"Cedar Grove CDP, Florida",1334,1296,38,3019,12,11150
"Cedar Key city, Florida",298,277,21,940,12,11225
"Celebration CDP, Florida",5472,5243,229,12030,12,11285
"Center Hill city, Florida",492,456,36,1129,12,11325
"Century town, Florida",834,751,83,1952,12,11362
"Chaires CDP, Florida",241,238,3,687,12,11525
"Charleston Park CDP, Florida",29,29,0,33,12,11597
"Charlotte Harbor CDP, Florida",1171,1140,31,4516,12,11625
"Charlotte Park CDP, Florida",677,651,26,1795,12,11650
"Chattahoochee city, Florida",668,630,38,2975,12,11800
"Cheval CDP, Florida",6728,6407,321,13189,12,11912
"Chiefland city, Florida",748,722,26,2016,12,11925
"Chipley city, Florida",1538,1385,153,3644,12,11975
"Chokoloskee CDP, Florida",390,390,0,1061,12,12150
"Christmas CDP, Florida",940,924,16,1545,12,12250
"Chuluota CDP, Florida",1177,1108,69,2484,12,12275
"Chumuckla CDP, Florida",434,434,0,991,12,12300
"Cinco Bayou town, Florida",367,362,5,741,12,12325
"Citrus Hills CDP, Florida",2077,1780,297,8599,12,12412
"Citrus Park CDP, Florida",15021,14516,505,27260,12,12425
"Citrus Springs CDP, Florida",4176,3841,335,11074,12,12450
"Clarcona CDP, Florida",1500,1480,20,4128,12,12675
"Clearwater city, Florida",57565,54877,2688,116984,12,12875
"Clermont city, Florida",18432,17514,918,43266,12,12925
"Cleveland CDP, Florida",640,640,0,2466,12,12950
"Clewiston city, Florida",3771,3605,166,7252,12,13000
"Cloud Lake town, Florida",118,115,3,219,12,13050
"Cobbtown CDP, Florida",57,57,0,57,12,13125
"Cocoa city, Florida",9493,9076,417,19073,12,13150
"Cocoa Beach city, Florida",5206,4821,385,11334,12,13175
"Cocoa West CDP, Florida",3015,2957,58,5727,12,13225
"Coconut Creek city, Florida",31511,30012,1499,57574,12,13275
"Coleman city, Florida",447,384,63,918,12,13400
"Combee Settlement CDP, Florida",2088,1979,109,4880,12,13775
"Connerton CDP, Florida",2340,2237,103,6383,12,13965
"Conway CDP, Florida",7649,7451,198,13519,12,14050
"Cooper City city, Florida",18028,17324,704,34046,12,14125
"Coral Gables city, Florida",24330,23168,1162,49696,12,14250
"Coral Springs city, Florida",72969,68434,4535,133801,12,14400
"Coral Terrace CDP, Florida",12671,12328,343,24597,12,14412
"Cortez CDP, Florida",1844,1648,196,5033,12,14700
"Cottondale town, Florida",445,437,8,965,12,14850
"Country Club CDP, Florida",29498,28134,1364,50975,12,14895
"Country Walk CDP, Florida",9775,9442,333,18719,12,15055
"Crawfordville CDP, Florida",2896,2855,41,5268,12,15300
"Crescent Beach CDP, Florida",419,419,0,936,12,15325
"Crescent City city, Florida",677,564,113,2040,12,15375
"Crestview city, Florida",12832,12359,473,27427,12,15475
"Crooked Lake Park CDP, Florida",873,847,26,2071,12,15515
"Cross City town, Florida",1020,1002,18,2485,12,15575
"Crystal Lake CDP, Florida",2642,2446,196,6048,12,15725
"Crystal River city, Florida",990,881,109,3398,12,15775
"Crystal Springs CDP, Florida",398,343,55,973,12,15800
"Cudjoe Key CDP, Florida",1070,1038,32,2238,12,15862
"Cutler Bay town, Florida",24094,23032,1062,44738,12,15968
"Cypress Gardens CDP, Florida",5019,4891,128,9692,12,16050
"Cypress Lake CDP, Florida",5553,5385,168,12313,12,16062
"Cypress Quarters CDP, Florida",486,486,0,1460,12,16100
"Dade City city, Florida",2726,2579,147,7221,12,16125
"Dade City North CDP, Florida",1458,1243,215,2959,12,16175
"Dania Beach city, Florida",16823,15303,1520,31700,12,16335
"Davenport city, Florida",5398,5257,141,10246,12,16450
"Davie town, Florida",59163,56524,2639,105821,12,16475
"Day CDP, Florida",27,27,0,198,12,16500
"Daytona Beach city, Florida",33475,31806,1669,73329,12,16525
"Daytona Beach Shores city, Florida",1580,1503,77,5087,12,16550
"DeBary city, Florida",11235,10784,451,22310,12,16675
"Deerfield Beach city, Florida",44469,41677,2792,86455,12,16725
"DeFuniak Springs city, Florida",3058,2618,440,6072,12,16800
"DeLand city, Florida",16414,15748,666,38392,12,16875
"DeLand Southwest CDP, Florida",426,424,2,1233,12,16937
"De Leon Springs CDP, Florida",873,873,0,2745,12,16975
"Delray Beach city, Florida",35407,33369,2038,66646,12,17100
"Deltona city, Florida",45868,44026,1842,94373,12,17200
"Desoto Acres CDP, Florida",389,389,0,705,12,17273
"Desoto Lakes CDP, Florida",1050,1027,23,1738,12,17300
"Destin city, Florida",7624,7465,159,13923,12,17325
"Dickerson City CDP, Florida",28,28,0,145,12,17450
"Dixonville CDP, Florida",8,8,0,47,12,17710
"Doctor Phillips CDP, Florida",6351,5635,716,12278,12,17725
"Doral city, Florida",39912,38657,1255,74891,12,17935
"Dover CDP, Florida",1369,1346,23,3247,12,18075
"Duck Key CDP, Florida",298,288,10,731,12,18425
"Dundee town, Florida",2200,2195,5,5373,12,18550
"Dunedin city, Florida",16903,16111,792,36089,12,18575
"Dunnellon city, Florida",677,636,41,2337,12,18675
"Eagle Lake city, Florida",1412,1340,72,3111,12,18875
"East Bronson CDP, Florida",934,905,29,1924,12,19025
"East Lake CDP, Florida",15745,14864,881,33629,12,19206
"East Lake-Orient Park CDP, Florida",15555,14437,1118,29243,12,19212
"East Milton CDP, Florida",4368,4151,217,13974,12,19275
"East Palatka CDP, Florida",451,445,6,1465,12,19350
"Eastpoint CDP, Florida",1289,1111,178,2624,12,19400
"East Williston CDP, Florida",221,191,30,674,12,19575
"Eatonville town, Florida",1247,1051,196,2486,12,19650
"Ebro town, Florida",135,130,5,236,12,19725
"Edgewater city, Florida",10567,10287,280,23138,12,19825
"Edgewood city, Florida",1415,1395,20,2689,12,19900
"Eglin AFB CDP, Florida",628,609,19,2759,12,20050
"Egypt Lake-Leto CDP, Florida",21402,19774,1628,36000,12,20108
"Elfers CDP, Florida",6480,6210,270,13296,12,20275
"Ellenton CDP, Florida",2284,2126,158,5391,12,20375
"El Portal village, Florida",1176,1153,23,1904,12,20650
"Englewood CDP, Florida",5704,5442,262,19378,12,20825
"Ensley CDP, Florida",11627,10933,694,22148,12,20925
"Estero village, Florida",13687,13155,532,36685,12,21150
"Esto town, Florida",146,143,3,336,12,21250
"Eustis city, Florida",11575,11100,475,23101,12,21350
"Everglades city, Florida",76,76,0,143,12,21425
"Fairview Shores CDP, Florida",6616,6445,171,11011,12,21750
"Fanning Springs city, Florida",448,430,18,1114,12,21850
"Feather Sound CDP, Florida",2126,2039,87,3289,12,21945
"Fellsmere city, Florida",2408,1946,462,4885,12,22100
"Fernandina Beach city, Florida",6143,5967,176,13028,12,22175
"Ferndale CDP, Florida",407,407,0,612,12,22225
"Fern Park CDP, Florida",4770,4563,207,8207,12,22250
"Ferry Pass CDP, Florida",16647,15310,1337,32447,12,22275
"Fidelis CDP, Florida",32,32,0,62,12,22325
"Fisher Island CDP, Florida",282,282,0,681,12,22375
"Fish Hawk CDP, Florida",11608,10962,646,25179,12,22387
"Five Points CDP, Florida",360,281,79,1022,12,22475
"Flagler Beach city, Florida",1871,1828,43,5100,12,22550
"Flagler Estates CDP, Florida",1670,1560,110,3608,12,22560
"Fleming Island CDP, Florida",14199,13588,611,29810,12,22660
"Floral City CDP, Florida",1683,1607,76,4830,12,22775
"Florida City city, Florida",4908,4477,431,12841,12,22975
"Florida Gulf Coast University CDP, Florida",1902,1698,204,3793,12,23005
"Florida Ridge CDP, Florida",10355,10003,352,22549,12,23050
"Floridatown CDP, Florida",93,93,0,237,12,23125
"Forest City CDP, Florida",7971,7734,237,14851,12,23375
"Fort Braden CDP, Florida",351,338,13,732,12,23680
"Fort Denaud CDP, Florida",673,673,0,1652,12,23730
"Fort Green CDP, Florida",55,55,0,105,12,23850
"Fort Green Springs CDP, Florida",208,208,0,573,12,23875
"Fort Lauderdale city, Florida",100518,95064,5454,182673,12,24000
"Fort Meade city, Florida",1802,1637,165,5133,12,24100
"Fort Myers city, Florida",39768,38134,1634,88699,12,24125
"Fort Myers Beach town, Florida",1840,1773,67,5650,12,24150
"Fort Myers Shores CDP, Florida",3021,2782,239,5990,12,24175
"Fort Pierce city, Florida",20049,17957,2092,47153,12,24300
"Fort Pierce North CDP, Florida",2680,2541,139,6519,12,24337
"Fort Pierce South CDP, Florida",2628,2588,40,5314,12,24387
"Fort Walton Beach city, Florida",10174,9782,392,20919,12,24475
"Fort White town, Florida",292,278,14,576,12,24500
"Fountainebleau CDP, Florida",33118,32231,887,57066,12,24562
"Four Corners CDP, Florida",31948,30368,1580,56537,12,24581
"Franklin Park CDP, Florida",385,385,0,1969,12,24710
"Freeport city, Florida",2807,2690,117,5858,12,24825
"Frostproof city, Florida",1041,956,85,2946,12,24900
"Fruit Cove CDP, Florida",17453,16987,466,35333,12,24925
"Fruitland Park city, Florida",3026,2892,134,8219,12,24975
"Fruitville CDP, Florida",8256,8032,224,15333,12,25000
"Fuller Heights CDP, Florida",6259,6023,236,11462,12,25025
"Fussels Corner CDP, Florida",2000,1884,116,5044,12,25125
"Gainesville city, Florida",72117,68127,3990,142414,12,25175
"Garcon Point CDP, Florida",155,155,0,421,12,25392
"Garden Grove CDP, Florida",588,579,9,1035,12,25475
"Gardner CDP, Florida",37,37,0,493,12,25550
"Gateway CDP, Florida",5233,5131,102,10395,12,25655
"Geneva CDP, Florida",1906,1889,17,3247,12,25750
"Gibsonton CDP, Florida",8847,8295,552,17879,12,25900
"Gifford CDP, Florida",1746,1522,224,4868,12,25925
"Gladeview CDP, Florida",5964,5563,401,14698,12,25987
"Glencoe CDP, Florida",833,814,19,1418,12,26000
"Glen Ridge town, Florida",118,108,10,219,12,26050
"Glen St. Mary town, Florida",215,212,3,712,12,26075
"Glenvar Heights CDP, Florida",9694,9316,378,17902,12,26100
"Golden Beach town, Florida",236,236,0,548,12,26250
"Golden Gate CDP, Florida",16981,16210,771,29400,12,26300
"Golden Glades CDP, Florida",16941,15558,1383,34725,12,26375
"Goldenrod CDP, Florida",7398,6750,648,12496,12,26475
"Golf village, Florida",86,86,0,255,12,26550
"Gonzalez CDP, Florida",6911,6651,260,13579,12,26700
"Goodland CDP, Florida",27,27,0,155,12,26775
"Gotha CDP, Florida",716,701,15,1640,12,26900
"Goulding CDP, Florida",839,716,123,3476,12,26925
"Goulds CDP, Florida",5897,5296,601,11943,12,26950
"Graceville city, Florida",1292,1229,63,2717,12,27000
"Grand Ridge town, Florida",394,385,9,824,12,27175
"Grant-Valkaria town, Florida",1945,1923,22,4520,12,27256
"Greenacres city, Florida",22980,21743,1237,43651,12,27322
"Greenbriar CDP, Florida",1262,1231,31,2356,12,27360
"Green Cove Springs city, Florida",4142,3919,223,9758,12,27400
"Greensboro town, Florida",264,264,0,762,12,27550
"Greenville town, Florida",319,319,0,1546,12,27575
"Greenwood town, Florida",300,297,3,713,12,27600
"Grenelefe CDP, Florida",1359,1359,0,2995,12,27635
"Gretna city, Florida",392,386,6,1208,12,27650
"Grove City CDP, Florida",510,468,42,1824,12,27775
"Groveland city, Florida",9026,8485,541,19240,12,27800
"Gulf Breeze city, Florida",3043,2702,341,6372,12,28000
"Gulf Gate CDP, Florida",4475,4284,191,8410,12,28045
"Gulfport city, Florida",5144,4842,302,11796,12,28175
"Gulf Stream town, Florida",334,314,20,848,12,28275
"Gun Club Estates CDP, Florida",358,345,13,629,12,28305
"Haines City city, Florida",13003,12376,627,28922,12,28400
"Hallandale Beach city, Florida",21578,19571,2007,41102,12,28452
"Hampton city, Florida",179,153,26,472,12,28575
"Harbor Bluffs CDP, Florida",1339,1210,129,2889,12,28650
"Harbour Heights CDP, Florida",1913,1589,324,4145,12,28800
"Harlem CDP, Florida",1232,1027,205,2576,12,28925
"Harlem Heights CDP, Florida",712,594,118,1694,12,28937
"Harold CDP, Florida",449,391,58,863,12,29000
"Hastings CDP, Florida",304,299,5,898,12,29100
"Havana town, Florida",916,890,26,2127,12,29150
"Haverhill town, Florida",1497,1426,71,2859,12,29200
"Hawthorne city, Florida",672,659,13,1683,12,29275
"Heathrow CDP, Florida",3564,3391,173,7084,12,29320
"Heritage Bay CDP, Florida",147,147,0,879,12,29381
"Heritage Pines CDP, Florida",154,137,17,1505,12,29385
"Hernando CDP, Florida",2709,2463,246,8911,12,29425
"Hernando Beach CDP, Florida",1415,1346,69,2558,12,29437
"Hialeah city, Florida",116974,112699,4275,222996,12,30000
"Hialeah Gardens city, Florida",12569,12202,367,22815,12,30025
"Highland Beach town, Florida",1235,1176,59,4261,12,30200
"Highland City CDP, Florida",6831,6666,165,12456,12,30225
"Highland Park village, Florida",90,88,2,178,12,30325
"High Point CDP, Florida",1205,1066,139,3685,12,30494
"High Springs city, Florida",2761,2680,81,6283,12,30525
"Hillcrest Heights town, Florida",163,160,3,360,12,30700
"Hilliard town, Florida",1393,1312,81,2975,12,30750
"Hill 'n Dale CDP, Florida",1517,1466,51,3010,12,30800
"Hillsboro Beach town, Florida",851,797,54,2225,12,30850
"Hillsboro Pines CDP, Florida",176,176,0,334,12,30858
"Hobe Sound CDP, Florida",6505,6161,344,14188,12,30975
"Holden Heights CDP, Florida",1797,1755,42,3479,12,31025
"Holden Lakes CDP, Florida",1910,1836,74,3591,12,31030
"Holiday CDP, Florida",9833,9041,792,21495,12,31075
"Holley CDP, Florida",944,897,47,2455,12,31275
"Holly Hill city, Florida",5516,5060,456,12919,12,31350
"Hollywood city, Florida",86226,80994,5232,152764,12,32000
"Holmes Beach city, Florida",1036,1011,25,3076,12,32150
"Homeland CDP, Florida",111,111,0,274,12,32250
"Homestead city, Florida",36872,35090,1782,79996,12,32275
"Homestead Base CDP, Florida",284,142,142,1242,12,32325
"Homosassa CDP, Florida",829,808,21,2016,12,32375
"Homosassa Springs CDP, Florida",5332,4864,468,15365,12,32400
"Horizon West CDP, Florida",30529,29479,1050,58595,12,32610
"Horseshoe Beach town, Florida",15,15,0,39,12,32650
"Hosford CDP, Florida",327,307,20,709,12,32675
"Howey-in-the-Hills town, Florida",959,932,27,2038,12,32775
"Hudson CDP, Florida",3727,3504,223,10821,12,32825
"Hunters Creek CDP, Florida",11598,11086,512,19895,12,32967
"Hurlburt Field CDP, Florida",626,626,0,2780,12,32975
"Hutchinson Island South CDP, Florida",1029,973,56,4203,12,32993
"Hypoluxo town, Florida",1640,1214,426,2723,12,33150
"Immokalee CDP, Florida",13533,12747,786,27753,12,33250
"Indialantic town, Florida",1474,1388,86,3016,12,33375
"Indian Creek village, Florida",24,24,0,54,12,33425
"Indian Harbour Beach city, Florida",3704,3544,160,8944,12,33450
"Indian Lake Estates CDP, Florida",156,156,0,672,12,33500
"Indian River Estates CDP, Florida",3058,2914,144,6965,12,33585
"Indian River Shores town, Florida",827,822,5,4266,12,33600
"Indian Rocks Beach city, Florida",2077,1975,102,3689,12,33625
"Indian Shores town, Florida",500,500,0,1182,12,33675
"Indiantown village, Florida",2700,2614,86,6624,12,33700
"Inglis town, Florida",677,627,50,1697,12,33800
"Interlachen town, Florida",594,505,89,1648,12,33900
"Inverness city, Florida",3139,2914,225,7602,12,33950
"Inverness Highlands North CDP, Florida",1228,1216,12,3007,12,33958
"Inverness Highlands South CDP, Florida",2938,2819,119,7788,12,33966
"Inwood CDP, Florida",3279,3051,228,7054,12,34000
"Iona CDP, Florida",4698,4581,117,14295,12,34012
"Islamorada, Village of Islands village, Florida",3418,3418,0,7044,12,34132
"Island Walk CDP, Florida",816,689,127,2679,12,34185
"Istachatta CDP, Florida",44,44,0,98,12,34275
"Ives Estates CDP, Florida",15160,14257,903,26814,12,34400
"Jacksonville city, Florida",481718,458659,23059,950203,12,35000
"Jacksonville Beach city, Florida",13931,13634,297,23583,12,35050
"Jacob City city, Florida",90,90,0,199,12,35200
"Jan Phyl Village CDP, Florida",2939,2830,109,6237,12,35300
"Jasmine Estates CDP, Florida",10637,10134,503,24032,12,35350
"Jasper city, Florida",704,670,34,4310,12,35375
"Jay town, Florida",305,274,31,773,12,35425
"Jennings town, Florida",194,194,0,733,12,35525
"Jensen Beach CDP, Florida",5552,5287,265,12581,12,35550
"June Park CDP, Florida",2728,2651,77,4757,12,35800
"Juno Beach town, Florida",1414,1289,125,3818,12,35850
"Juno Ridge CDP, Florida",671,655,16,1245,12,35862
"Jupiter town, Florida",31535,30271,1264,60926,12,35875
"Jupiter Farms CDP, Florida",6911,6716,195,13358,12,35890
"Jupiter Inlet Colony town, Florida",138,134,4,461,12,35900
"Jupiter Island town, Florida",321,230,91,866,12,35925
"Kathleen CDP, Florida",2865,2720,145,5843,12,35950
"Kendale Lakes CDP, Florida",27872,26656,1216,52661,12,36062
"Kendall CDP, Florida",42204,40872,1332,78402,12,36100
"Kendall West CDP, Florida",19952,19377,575,35606,12,36121
"Kenneth City town, Florida",2155,2063,92,5043,12,36175
"Kensington Park CDP, Florida",2134,2078,56,3620,12,36200
"Kenwood Estates CDP, Florida",678,674,4,1252,12,36220
"Key Biscayne village, Florida",6195,5940,255,14572,12,36300
"Key Colony Beach city, Florida",266,266,0,650,12,36325
"Key Largo CDP, Florida",6156,5834,322,12021,12,36375
"Keystone CDP, Florida",12846,12391,455,26059,12,36462
"Keystone Heights city, Florida",615,599,16,1398,12,36475
"Key Vista CDP, Florida",675,665,10,1510,12,36535
"Key West city, Florida",14872,14579,293,26078,12,36550
"Kissimmee city, Florida",40099,37461,2638,78478,12,36950
"LaBelle city, Florida",2378,2300,78,4963,12,37225
"Lacoochee CDP, Florida",936,440,496,1353,12,37275
"La Crosse town, Florida",86,82,4,163,12,37300
"Lady Lake town, Florida",5102,4710,392,16047,12,37375
"Laguna Beach CDP, Florida",2193,2191,2,4194,12,37500
"Lake Alfred city, Florida",3535,3299,236,6555,12,37525
"Lake Belvedere Estates CDP, Florida",1375,1308,67,2867,12,37542
"Lake Buena Vista city, Florida",1,1,0,7,12,37625
"Lake Butler CDP, Florida",8729,8581,148,17765,12,37648
"Lake Butler city, Florida",693,624,69,1842,12,37650
"Lake City city, Florida",5297,5010,287,12307,12,37775
"Lake Clarke Shores town, Florida",2054,1903,151,3553,12,37800
"Lake Hamilton town, Florida",651,647,4,1613,12,37975
"Lake Harbor CDP, Florida",0,0,0,0,12,38000
"Lake Hart CDP, Florida",207,207,0,507,12,38012
"Lake Helen city, Florida",1229,1181,48,2836,12,38025
"Lake Kathryn CDP, Florida",398,392,6,980,12,38162
"Lake Kerr CDP, Florida",623,525,98,1978,12,38238
"Lakeland city, Florida",52590,49759,2831,114404,12,38250
"Lakeland Highlands CDP, Florida",5477,5284,193,11276,12,38262
"Lake Lindsey CDP, Florida",53,53,0,139,12,38275
"Lake Lorraine CDP, Florida",3564,3504,60,7164,12,38287
"Lake Mack-Forest Hills CDP, Florida",1822,1256,566,2506,12,38332
"Lake Magdalene CDP, Florida",16323,15768,555,31546,12,38350
"Lake Mary city, Florida",9174,9019,155,16636,12,38425
"Lake Mary Jane CDP, Florida",1241,1203,38,2122,12,38430
"Lake Mystic CDP, Florida",201,153,48,529,12,38519
"Lake Panasoffkee CDP, Florida",1825,1749,76,4173,12,38575
"Lake Park town, Florida",4518,4094,424,8996,12,38600
"Lake Placid town, Florida",875,789,86,2349,12,38625
"Lake Sarasota CDP, Florida",2165,2098,67,3701,12,38690
"Lakeside CDP, Florida",16095,15059,1036,30973,12,38813
"Lake Wales city, Florida",6493,6126,367,16455,12,38950
"Lakewood Park CDP, Florida",6532,6283,249,14119,12,39062
"Lakewood Ranch CDP, Florida",14321,13946,375,34346,12,39067
"Lake Worth Beach city, Florida",23066,21610,1456,42188,12,39081
"Lamont CDP, Florida",0,0,0,0,12,39100
"Land O' Lakes CDP, Florida",21024,19893,1131,40843,12,39200
"Lantana town, Florida",6809,6174,635,11703,12,39375
"Largo city, Florida",41816,39713,2103,82541,12,39425
"Lauderdale-by-the-Sea town, Florida",2671,2591,80,6202,12,39475
"Lauderdale Lakes city, Florida",17411,15838,1573,35914,12,39525
"Lauderhill city, Florida",37038,33861,3177,73987,12,39550
"Laurel CDP, Florida",4790,4546,244,11858,12,39600
"Laurel Hill city, Florida",199,192,7,469,12,39650
"Lawtey city, Florida",661,488,173,1082,12,39700
"Layton city, Florida",73,73,0,144,12,39725
"Lazy Lake village, Florida",3,3,0,143,12,39750
"Lealman CDP, Florida",10619,9889,730,21237,12,39775
"Lecanto CDP, Florida",2137,2043,94,6938,12,39825
"Lee town, Florida",383,377,6,778,12,39850
"Leesburg city, Florida",11327,10147,1180,27226,12,39875
"Lehigh Acres CDP, Florida",59503,56213,3290,124440,12,39925
"Leisure City CDP, Florida",12780,11958,822,27033,12,39950
"Lely CDP, Florida",1459,1417,42,3548,12,39987
"Lely Resort CDP, Florida",2640,2576,64,7505,12,40037
"Lemon Grove CDP, Florida",322,307,15,610,12,40100
"Liberty Triangle CDP, Florida",8294,7670,624,23112,12,40387
"Lighthouse Point city, Florida",5434,5312,122,10496,12,40450
"Limestone CDP, Florida",14,14,0,32,12,40525
"Limestone Creek CDP, Florida",1049,996,53,1460,12,40562
"Lisbon CDP, Florida",90,90,0,249,12,40750
"Live Oak city, Florida",3330,2877,453,6811,12,40875
"Lloyd CDP, Florida",94,45,49,177,12,40950
"Lochmoor Waterway Estates CDP, Florida",2609,2450,159,5327,12,40985
"Lockhart CDP, Florida",9053,8511,542,15017,12,41025
"Longboat Key town, Florida",1481,1425,56,7479,12,41150
"Longwood city, Florida",8553,8057,496,15628,12,41250
"Loughman CDP, Florida",3804,3712,92,6296,12,41400
"Lower Grand Lagoon CDP, Florida",2462,2285,177,4733,12,41562
"Loxahatchee Groves town, Florida",1714,1651,63,3384,12,41577
"Lutz CDP, Florida",12595,12252,343,24721,12,41775
"Lynn Haven city, Florida",9990,9639,351,19421,12,41825
"Macclenny city, Florida",3454,3309,145,7354,12,41950
"McGregor CDP, Florida",3522,3345,177,7650,12,42090
"McIntosh town, Florida",77,77,0,285,12,42150
"Madeira Beach city, Florida",2021,1931,90,3931,12,42400
"Madison city, Florida",1263,1175,88,2930,12,42425
"Maitland city, Florida",12268,11702,566,19266,12,42575
"Malabar town, Florida",1635,1595,40,2982,12,42625
"Malone town, Florida",341,330,11,2162,12,42650
"Manalapan town, Florida",113,107,6,326,12,42700
"Manasota Key CDP, Florida",495,464,31,1718,12,42750
"Manatee Road CDP, Florida",681,651,30,2077,12,42787
"Mango CDP, Florida",5653,5353,300,12400,12,42850
"Mangonia Park town, Florida",953,913,40,1950,12,42900
"Marathon city, Florida",5606,5268,338,9789,12,43000
"Marco Island city, Florida",4868,4671,197,15942,12,43083
"Marco Shores-Hammock Bay CDP, Florida",171,171,0,617,12,43090
"Margate city, Florida",31633,30294,1339,58396,12,43125
"Marianna city, Florida",2210,2095,115,6681,12,43175
"Marineland town, Florida",7,7,0,12,12,43250
"Marion Oaks CDP, Florida",9784,9301,483,20283,12,43300
"Mary Esther city, Florida",1936,1813,123,4018,12,43375
"Masaryktown CDP, Florida",403,403,0,993,12,43400
"Mascotte city, Florida",3473,3350,123,6985,12,43425
"Matlacha CDP, Florida",278,254,24,837,12,43475
"Matlacha Isles-Matlacha Shores CDP, Florida",48,48,0,96,12,43484
"Mayo town, Florida",619,551,68,1466,12,43575
"Meadow Oaks CDP, Florida",1271,1269,2,2909,12,43785
"Meadow Woods CDP, Florida",23802,22664,1138,42207,12,43800
"Medley town, Florida",509,499,10,1018,12,43900
"Medulla CDP, Florida",5765,5598,167,11355,12,43925
"Melbourne city, Florida",41877,39938,1939,84982,12,43975
"Melbourne Beach town, Florida",1318,1301,17,3214,12,44000
"Melbourne Village town, Florida",322,305,17,785,12,44075
"Memphis CDP, Florida",5268,4843,425,10923,12,44175
"Merritt Island CDP, Florida",16243,15563,680,34300,12,44275
"Mexico Beach city, Florida",459,411,48,1054,12,44300
"Miami city, Florida",248254,235810,12444,443665,12,45000
"Miami Beach city, Florida",49177,47227,1950,82400,12,45025
"Miami Gardens city, Florida",54633,50303,4330,111618,12,45060
"Miami Lakes town, Florida",17673,17101,572,30621,12,45100
"Miami Shores village, Florida",5954,5537,417,11638,12,45175
"Miami Springs city, Florida",7620,7520,100,13729,12,45200
"Micanopy town, Florida",294,274,20,522,12,45225
"Micco CDP, Florida",2667,2514,153,9164,12,45275
"Miccosukee CDP, Florida",205,188,17,324,12,45300
"Middleburg CDP, Florida",6435,6135,300,11838,12,45350
"Midway city, Florida",1613,1541,72,3500,12,45425
"Midway CDP (Santa Rosa County), Florida",10078,9741,337,20141,12,45465
"Midway CDP (Seminole County), Florida",716,693,23,1431,12,45475
"Milton city, Florida",4671,4439,232,10254,12,45750
"Mims CDP, Florida",2432,2274,158,7222,12,45775
"Minneola city, Florida",7447,7185,262,14406,12,45900
"Miramar city, Florida",77759,74462,3297,135158,12,45975
"Miramar Beach CDP, Florida",4353,3961,392,9115,12,46000
"Molino CDP, Florida",773,773,0,1253,12,46225
"Monticello city, Florida",1094,1072,22,2589,12,46500
"Montura CDP, Florida",1580,1472,108,3400,12,46520
"Montverde town, Florida",951,931,20,1782,12,46525
"Moon Lake CDP, Florida",2007,1554,453,4214,12,46540
"Moore Haven city, Florida",761,718,43,2034,12,46550
"Morriston CDP, Florida",0,0,0,140,12,46725
"Mount Carmel CDP, Florida",119,119,0,207,12,47000
"Mount Dora city, Florida",7029,6602,427,16330,12,47050
"Mount Plymouth CDP, Florida",2821,2754,67,4798,12,47125
"Mulat CDP, Florida",109,109,0,174,12,47175
"Mulberry city, Florida",1829,1766,63,3962,12,47200
"Munson CDP, Florida",218,183,35,390,12,47300
"Myrtle Grove CDP, Florida",7821,6876,945,16945,12,47550
"Naples city, Florida",6471,6310,161,19315,12,47625
"Naples Manor CDP, Florida",3412,3242,170,5882,12,47650
"Naples Park CDP, Florida",2510,2477,33,5200,12,47675
"Naranja CDP, Florida",6009,5397,612,13261,12,47700
"Nassau Village-Ratliff CDP, Florida",1785,1701,84,4530,12,47787
"Navarre CDP, Florida",16300,15388,912,38829,12,48050
"Navarre Beach CDP, Florida",918,876,42,1594,12,48055
"Neptune Beach city, Florida",4328,4281,47,6743,12,48100
"Newberry city, Florida",3580,3388,192,7401,12,48200
"New Port Richey city, Florida",6731,6459,272,16742,12,48500
"New Port Richey East CDP, Florida",4798,4173,625,11170,12,48525
"New Smyrna Beach city, Florida",12647,12096,551,30449,12,48625
"Niceville city, Florida",7368,7277,91,15804,12,48750
"Nobleton CDP, Florida",88,36,52,250,12,48825
"Nocatee CDP, Florida",9576,8939,637,22950,12,48850
"Nokomis CDP, Florida",1819,1790,29,3458,12,48875
"Noma town, Florida",110,106,4,254,12,48900
"North Bay Village city, Florida",5340,5112,228,8024,12,49225
"North Brooksville CDP, Florida",1295,1206,89,3661,12,49237
"Northdale CDP, Florida",14983,14482,501,26079,12,49260
"North DeLand CDP, Florida",459,435,24,1220,12,49275
"North Fort Myers CDP, Florida",15523,14747,776,42492,12,49350
"North Key Largo CDP, Florida",273,223,50,1271,12,49406
"North Lauderdale city, Florida",26340,24709,1631,44635,12,49425
"North Merritt Island CDP, Florida",4085,3741,344,9033,12,49435
"North Miami city, Florida",30781,28905,1876,59854,12,49450
"North Miami Beach city, Florida",23286,22053,1233,43269,12,49475
"North Palm Beach village, Florida",6189,6072,117,13092,12,49600
"North Port city, Florida",33857,32731,1126,76975,12,49675
"North Redington Beach town, Florida",565,497,68,1349,12,49725
"North River Shores CDP, Florida",1336,1295,41,3390,12,49750
"North Sarasota CDP, Florida",1118,1045,73,2573,12,49787
"North Weeki Wachee CDP, Florida",3174,3030,144,7529,12,49905
"Oak Hill city, Florida",820,791,29,2107,12,50450
"Oakland town, Florida",1801,1751,50,3488,12,50525
"Oakland Park city, Florida",27424,25678,1746,44056,12,50575
"Oakleaf Plantation CDP, Florida",14011,13636,375,29265,12,50630
"Oak Ridge CDP, Florida",13293,12465,828,24476,12,50638
"Ocala city, Florida",29175,26751,2424,63504,12,50750
"Ocala Estates CDP, Florida",1012,890,122,3029,12,50756
"Ocean Breeze town, Florida",115,115,0,285,12,50875
"Ocean City CDP, Florida",3124,3072,52,6108,12,50925
"Ocean Ridge town, Florida",868,838,30,1712,12,50950
"Ocklawaha CDP, Florida",673,634,39,1637,12,51050
"Ocoee city, Florida",25605,24167,1438,47290,12,51075
"Odessa CDP, Florida",3815,3715,100,7538,12,51100
"Ojus CDP, Florida",9183,8737,446,16450,12,51125
"Okahumpka CDP, Florida",113,113,0,220,12,51150
"Okeechobee city, Florida",2531,2397,134,5319,12,51200
"Old Miakka CDP, Florida",817,817,0,1578,12,51342
"Oldsmar city, Florida",7824,7407,417,14877,12,51350
"Olga CDP, Florida",1300,1254,46,2753,12,51400
"Olympia Heights CDP, Florida",7212,7010,202,13824,12,51475
"Ona CDP, Florida",236,236,0,435,12,51500
"On Top of the World CDP, Florida",1484,1393,91,13056,12,51587
"Opa-locka city, Florida",7358,6974,384,16230,12,51650
"Orange City city, Florida",6185,5985,200,13254,12,51825
"Orange Park town, Florida",4657,4396,261,9047,12,52125
"Orangetree CDP, Florida",2432,2354,78,4929,12,52162
"Orchid town, Florida",160,160,0,537,12,52175
"Oriole Beach CDP, Florida",944,924,20,1731,12,52250
"Orlando city, Florida",178065,168816,9249,307738,12,53000
"Orlovista CDP, Florida",2837,2489,348,6661,12,53100
"Ormond Beach city, Florida",19246,18786,460,43127,12,53150
"Ormond-by-the-Sea CDP, Florida",2873,2606,267,6668,12,53200
"Osprey CDP, Florida",2144,2096,48,6195,12,53425
"Otter Creek town, Florida",60,60,0,130,12,53500
"Oviedo city, Florida",21577,20675,902,39552,12,53575
"Pace CDP, Florida",10992,10548,444,25657,12,53725
"Page Park CDP, Florida",492,384,108,856,12,53775
"Pahokee city, Florida",2034,1566,468,5548,12,53800
"Paisley CDP, Florida",464,430,34,1071,12,53850
"Palatka city, Florida",3625,3258,367,10471,12,53875
"Palm Bay city, Florida",57472,54214,3258,121513,12,54000
"Palm Beach town, Florida",2729,2575,154,9205,12,54025
"Palm Beach Gardens city, Florida",28495,27504,991,59088,12,54075
"Palm Beach Shores town, Florida",541,493,48,1217,12,54150
"Palm City CDP, Florida",12499,11744,755,25957,12,54175
"Palm Coast city, Florida",40057,38418,1639,91082,12,54200
"Palmer Ranch CDP, Florida",5292,5089,203,15278,12,54238
"Palmetto city, Florida",5859,5469,390,13384,12,54250
"Palmetto Bay village, Florida",12855,12394,461,24267,12,54275
"Palmetto Estates CDP, Florida",8605,8278,327,16776,12,54300
"Palm Harbor CDP, Florida",30504,29612,892,61589,12,54350
"Palmona Park CDP, Florida",389,366,23,1112,12,54357
"Palm River-Clair Mel CDP, Florida",13422,12748,674,25729,12,54387
"Palm Shores town, Florida",959,944,15,1577,12,54425
"Palm Springs village, Florida",14815,13797,1018,26692,12,54450
"Palm Springs North CDP, Florida",2788,2653,135,5303,12,54500
"Palm Valley CDP, Florida",9531,9275,256,19766,12,54525
"Panacea CDP, Florida",436,436,0,1152,12,54625
"Panama City city, Florida",16429,15586,843,34254,12,54700
"Panama City Beach city, Florida",10454,10157,297,18281,12,54725
"Paradise Heights CDP, Florida",561,561,0,808,12,54912
"Parker city, Florida",2195,2066,129,4309,12,55075
"Parkland city, Florida",16198,15470,728,34832,12,55125
"Pasadena Hills CDP, Florida",5573,5393,180,12654,12,55305
"Patrick AFB CDP, Florida",522,513,9,1606,12,55375
"Paxton town, Florida",279,245,34,583,12,55475
"Pea Ridge CDP, Florida",1981,1949,32,3765,12,55532
"Pebble Creek CDP, Florida",5622,5457,165,10976,12,55540
"Pelican Bay CDP, Florida",1344,1264,80,6380,12,55650
"Pelican Marsh CDP, Florida",529,511,18,2304,12,55680
"Pembroke Park town, Florida",2852,2657,195,6266,12,55750
"Pembroke Pines city, Florida",87905,83744,4161,170472,12,55775
"Penney Farms town, Florida",61,61,0,721,12,55875
"Pensacola city, Florida",26916,25423,1493,54059,12,55925
"Pensacola Station CDP, Florida",645,624,21,5015,12,56004
"Perry city, Florida",2880,2648,232,6879,12,56150
"Pierson town, Florida",546,546,0,1332,12,56425
"Pine Air CDP, Florida",906,826,80,2318,12,56475
"Pine Castle CDP, Florida",4251,4039,212,9556,12,56500
"Pinecraft CDP, Florida",242,222,20,463,12,56525
"Pinecrest village, Florida",8444,8034,410,18279,12,56625
"Pine Hills CDP, Florida",42403,37017,5386,83221,12,56825
"Pine Island CDP, Florida",57,57,0,136,12,56840
"Pine Island Center CDP, Florida",627,615,12,1626,12,56850
"Pine Lakes CDP, Florida",583,429,154,1274,12,56865
"Pineland CDP, Florida",175,175,0,379,12,56875
"Pine Level CDP, Florida",58,58,0,151,12,56955
"Pinellas Park city, Florida",27247,25846,1401,53352,12,56975
"Pine Manor CDP, Florida",1838,1623,215,3944,12,57025
"Pine Ridge CDP (Citrus County), Florida",2838,2693,145,10269,12,57058
"Pine Ridge CDP (Collier County), Florida",827,817,10,1640,12,57066
"Pinewood CDP, Florida",7937,7354,583,17163,12,57250
"Pioneer CDP, Florida",107,107,0,419,12,57320
"Pittman CDP, Florida",46,46,0,214,12,57380
"Plantation city, Florida",51478,49203,2275,93130,12,57425
"Plantation CDP, Florida",920,907,13,4274,12,57450
"Plantation Island CDP, Florida",0,0,0,0,12,57492
"Plantation Mobile Home Park CDP, Florida",1078,802,276,1540,12,57518
"Plant City city, Florida",21024,20346,678,39655,12,57550
"Poinciana CDP, Florida",31470,30056,1414,69311,12,57900
"Point Baker CDP, Florida",1846,1623,223,3591,12,57908
"Polk City town, Florida",1413,1372,41,2766,12,57950
"Pomona Park town, Florida",583,515,68,1408,12,58025
"Pompano Beach city, Florida",58648,53566,5082,111790,12,58050
"Ponce de Leon town, Florida",399,339,60,775,12,58175
"Ponce Inlet town, Florida",1133,1110,23,3364,12,58200
"Port Charlotte CDP, Florida",27063,25161,1902,63913,12,58350
"Port LaBelle CDP, Florida",3375,3110,265,5858,12,58420
"Port Orange city, Florida",30432,29244,1188,62849,12,58575
"Port Richey city, Florida",1242,1200,42,3132,12,58600
"Port St. Joe city, Florida",1561,1479,82,3533,12,58675
"Port St. John CDP, Florida",12715,11994,721,24366,12,58700
"Port St. Lucie city, Florida",102751,96939,5812,210520,12,58715
"Port Salerno CDP, Florida",5553,5232,321,11440,12,58727
"Pretty Bayou CDP, Florida",1075,985,90,2469,12,58962
"Princeton CDP, Florida",21186,20084,1102,37954,12,58975
"Progress Village CDP, Florida",6152,6061,91,10096,12,59050
"Punta Gorda city, Florida",5754,5473,281,19605,12,59200
"Punta Rassa CDP, Florida",89,89,0,1370,12,59250
"Quail Ridge CDP, Florida",1814,1765,49,2811,12,59311
"Quincy city, Florida",2651,2555,96,7811,12,59325
"Raiford town, Florida",90,80,10,270,12,59400
"Rainbow Lakes Estates CDP, Florida",1367,1318,49,3108,12,59450
"Rainbow Park CDP, Florida",851,751,100,2059,12,59466
"Rainbow Springs CDP, Florida",1310,1296,14,5189,12,59470
"Raleigh CDP, Florida",204,204,0,838,12,59475
"Reddick town, Florida",227,227,0,453,12,59675
"Redington Beach town, Florida",638,617,21,1320,12,59725
"Redington Shores town, Florida",903,886,17,2078,12,59750
"Richmond Heights CDP, Florida",4761,4495,266,9863,12,60225
"Richmond West CDP, Florida",18408,17746,662,36964,12,60230
"Ridgecrest CDP, Florida",1572,1406,166,3020,12,60275
"Ridge Manor CDP, Florida",1915,1827,88,4430,12,60325
"Ridge Wood Heights CDP, Florida",2672,2630,42,4812,12,60475
"Rio CDP, Florida",470,425,45,1373,12,60550
"Rio Pinar CDP, Florida",2844,2710,134,5663,12,60562
"River Park CDP, Florida",2856,2620,236,6186,12,60785
"River Ridge CDP, Florida",2697,2351,346,4705,12,60835
"Riverview CDP, Florida",55094,51997,3097,102467,12,60950
"Riviera Beach city, Florida",18339,16659,1680,37668,12,60975
"Rockledge city, Florida",14492,13938,554,27808,12,61500
"Roeville CDP, Florida",284,273,11,425,12,61615
"Roosevelt Gardens CDP, Florida",1114,1016,98,2322,12,61807
"Roseland CDP, Florida",667,667,0,1377,12,61875
"Rotonda CDP, Florida",2811,2691,120,10233,12,61937
"Royal Palm Beach village, Florida",21684,20642,1042,38874,12,62100
"Royal Palm Estates CDP, Florida",816,758,58,1759,12,62118
"Ruskin CDP, Florida",14319,13560,759,28878,12,62275
"Safety Harbor city, Florida",8813,8456,357,17087,12,62425
"St. Augustine city, Florida",7572,7326,246,14642,12,62500
"St. Augustine Beach city, Florida",3011,2767,244,6774,12,62525
"St. Augustine Shores CDP, Florida",4891,4711,180,9883,12,62550
"St. Augustine South CDP, Florida",2797,2731,66,5087,12,62562
"St. Cloud city, Florida",27780,25991,1789,59851,12,62625
"St. George Island CDP, Florida",438,438,0,970,12,62650
"St. James City CDP, Florida",1253,1123,130,3494,12,62675
"St. Leo town, Florida",965,865,100,2426,12,62775
"St. Lucie Village town, Florida",363,352,11,838,12,62800
"St. Marks city, Florida",90,85,5,291,12,62825
"St. Pete Beach city, Florida",4133,3899,234,8905,12,62885
"St. Petersburg city, Florida",142413,135842,6571,259343,12,63000
"Samoset CDP, Florida",2016,1881,135,4235,12,63225
"Samsula-Spruce Creek CDP, Florida",2159,2131,28,5137,12,63362
"San Antonio city, Florida",686,666,20,1375,12,63375
"San Carlos Park CDP, Florida",10650,10430,220,18888,12,63425
"San Castle CDP, Florida",1780,1693,87,3192,12,63435
"Sanford city, Florida",32990,31260,1730,61272,12,63650
"Sanibel city, Florida",2085,1990,95,6420,12,63700
"Sarasota city, Florida",25818,25061,757,55508,12,64175
"Sarasota Springs CDP, Florida",7384,7171,213,12500,12,64325
"Satellite Beach city, Florida",5472,5164,308,11176,12,64400
"Sawgrass CDP, Florida",2275,2234,41,4877,12,64525
"Schall Circle CDP, Florida",225,209,16,486,12,64547
"Scottsmoor CDP, Florida",395,326,69,914,12,64625
"Sea Ranch Lakes village, Florida",201,199,2,443,12,64725
"Sebastian city, Florida",10679,9649,1030,25266,12,64825
"Sebring city, Florida",4269,3726,543,11006,12,64875
"Seffner CDP, Florida",4426,4340,86,8597,12,64925
"Seminole city, Florida",9452,9141,311,19287,12,64975
"Seminole Manor CDP, Florida",1658,1456,202,2232,12,65100
"Seville CDP, Florida",502,493,9,1310,12,65200
"Sewall's Point town, Florida",923,904,19,1922,12,65225
"Shady Hills CDP, Florida",5082,4793,289,11724,12,65385
"Shalimar town, Florida",478,444,34,918,12,65425
"Sharpes CDP, Florida",1470,1388,82,2812,12,65525
"Siesta Key CDP, Florida",1687,1604,83,5535,12,66000
"Silver Lake CDP, Florida",1147,1069,78,2524,12,66062
"Silver Springs CDP, Florida",1566,1449,117,2593,12,66125
"Silver Springs Shores CDP, Florida",11088,10654,434,25453,12,66175
"Silver Springs Shores East CDP, Florida",475,441,34,1126,12,66179
"Sky Lake CDP, Florida",3488,3374,114,7424,12,66425
"Sneads town, Florida",799,752,47,1744,12,66725
"Solana CDP, Florida",393,379,14,1062,12,66875
"Sopchoppy city, Florida",174,169,5,426,12,66925
"Sorrento CDP, Florida",114,114,0,165,12,66975
"South Apopka CDP, Florida",3105,2936,169,7653,12,67163
"South Bay city, Florida",1055,956,99,4830,12,67175
"South Beach CDP, Florida",838,827,11,3120,12,67192
"South Bradenton CDP, Florida",12324,11575,749,25471,12,67258
"South Brooksville CDP, Florida",1920,1853,67,4577,12,67266
"Southchase CDP, Florida",8141,7702,439,15573,12,67270
"South Daytona city, Florida",6267,6007,260,13132,12,67325
"Southeast Arcadia CDP, Florida",3601,3062,539,7675,12,67355
"Southgate CDP, Florida",3179,2975,204,6183,12,67425
"South Gate Ridge CDP, Florida",3439,3212,227,5872,12,67450
"South Highpoint CDP, Florida",2922,2610,312,5325,12,67462
"South Miami city, Florida",6529,6274,255,11944,12,67550
"South Miami Heights CDP, Florida",18472,17389,1083,35705,12,67575
"South Palm Beach town, Florida",750,740,10,1648,12,67650
"South Pasadena city, Florida",1638,1526,112,5334,12,67675
"South Patrick Shores CDP, Florida",3203,3090,113,6899,12,67725
"South Sarasota CDP, Florida",1959,1883,76,4855,12,67887
"South Venice CDP, Florida",9083,8766,317,17469,12,68100
"Southwest Ranches town, Florida",3817,3755,62,7589,12,68135
"Springfield city, Florida",3914,3868,46,8295,12,68275
"Spring Hill CDP, Florida",51424,48131,3293,116882,12,68350
"Springhill CDP, Florida",24,24,0,78,12,68365
"Spring Lake CDP, Florida",121,121,0,370,12,68375
"Spring Ridge CDP, Florida",117,103,14,256,12,68435
"Stacey Street CDP, Florida",405,297,108,531,12,68487
"Starke city, Florida",2167,2083,84,5756,12,68525
"Steinhatchee CDP, Florida",201,201,0,514,12,68625
"Stock Island CDP, Florida",2503,2464,39,4564,12,68800
"Stuart city, Florida",8593,8219,374,17639,12,68875
"Sugarmill Woods CDP, Florida",3288,3136,152,10821,12,68950
"Sumatra CDP, Florida",0,0,0,35,12,69025
"Sun City Center CDP, Florida",6706,6371,335,29290,12,69250
"Suncoast Estates CDP, Florida",2047,1881,166,4208,12,69275
"Sunny Isles Beach city, Florida",10562,10136,426,22202,12,69555
"Sunrise city, Florida",53359,49893,3466,96510,12,69700
"Sunset CDP, Florida",7686,7567,119,13877,12,69812
"Surfside town, Florida",2421,2335,86,5625,12,70075
"Sweetwater city, Florida",10442,9943,499,19399,12,70345
"Taft CDP, Florida",725,712,13,1604,12,70525
"Tallahassee city, Florida",110875,103672,7203,198259,12,70600
"Tamarac city, Florida",36878,34712,2166,71578,12,70675
"Tamiami CDP, Florida",29070,28104,966,52851,12,70700
"Tampa city, Florida",206153,195458,10695,388768,12,71000
"Tangelo Park CDP, Florida",1275,1113,162,2371,12,71075
"Tangerine CDP, Florida",2091,2039,52,3870,12,71100
"Tarpon Springs city, Florida",11322,10695,627,25355,12,71150
"Tavares city, Florida",6811,6477,334,19088,12,71225
"Tavernier CDP, Florida",1229,1172,57,2261,12,71250
"Taylor Creek CDP, Florida",1616,1448,168,4566,12,71300
"Temple Terrace city, Florida",14691,14184,507,26818,12,71400
"Tequesta village, Florida",2871,2776,95,6116,12,71525
"The Acreage CDP, Florida",22455,21665,790,40160,12,71564
"The Crossings CDP, Florida",11970,11686,284,22708,12,71567
"The Hammocks CDP, Florida",30755,29751,1004,59843,12,71569
"The Meadows CDP, Florida",1673,1646,27,5752,12,71580
"The Villages CDP, Florida",9154,8903,251,79108,12,71625
"Thonotosassa CDP, Florida",6466,6099,367,14052,12,71725
"Three Lakes CDP, Florida",8696,8403,293,16596,12,71741
"Three Oaks CDP, Florida",4079,3927,152,6156,12,71758
"Tice CDP, Florida",2688,2651,37,5468,12,71800
"Tierra Verde CDP, Florida",1771,1691,80,4072,12,71825
"Tiger Point CDP, Florida",1433,1383,50,3511,12,71842
"Tildenville CDP, Florida",0,0,0,19,12,71850
"Timber Pines CDP, Florida",550,491,59,5059,12,71867
"Titusville city, Florida",22275,20897,1378,48595,12,71900
"Town 'n' Country CDP, Florida",51044,48250,2794,89456,12,72145
"Treasure Island city, Florida",3059,2892,167,6590,12,72325
"Trenton city, Florida",779,742,37,1843,12,72350
"Trilby CDP, Florida",228,228,0,329,12,72425
"Trinity CDP, Florida",8503,8147,356,18672,12,72442
"Tropical Park CDP, Florida",716,700,16,2257,12,72521
"Tyndall AFB CDP, Florida",102,92,10,746,12,72875
"Umatilla city, Florida",1528,1512,16,3738,12,73025
"Union Park CDP, Florida",6514,6291,223,10821,12,73075
"University CDP (Hillsborough County), Florida",25900,24347,1553,49148,12,73163
"University CDP (Orange County), Florida",15119,14192,927,43207,12,73172
"Upper Grand Lagoon CDP, Florida",8981,8740,241,17062,12,73312
"Valparaiso city, Florida",1911,1853,58,4889,12,73675
"Valrico CDP, Florida",20960,20104,856,38594,12,73700
"Vamo CDP, Florida",691,665,26,2656,12,73725
"Venice city, Florida",7544,7242,302,25710,12,73900
"Venice Gardens CDP, Florida",1581,1513,68,3301,12,73950
"Verandah CDP, Florida",423,368,55,1715,12,74016
"Vernon city, Florida",251,248,3,688,12,74125
"Vero Beach city, Florida",7692,7423,269,16531,12,74150
"Vero Beach South CDP, Florida",14528,13855,673,29965,12,74200
"Vero Lake Estates CDP, Florida",3065,2902,163,6714,12,74225
"Verona Walk CDP, Florida",959,886,73,2998,12,74235
"Viera East CDP, Florida",5057,4809,248,12547,12,74368
"Viera West CDP, Florida",6883,6666,217,15958,12,74370
"Vilano Beach CDP, Florida",1194,1153,41,2291,12,74400
"Villas CDP, Florida",7449,7185,264,13801,12,74512
"Vineyards CDP, Florida",1393,1373,20,3649,12,74562
"Virginia Gardens village, Florida",1543,1485,58,2419,12,74575
"Wabasso CDP, Florida",591,580,11,1179,12,74625
"Wabasso Beach CDP, Florida",614,614,0,2101,12,74635
"Wacissa CDP, Florida",177,155,22,330,12,74700
"Wahneta CDP, Florida",1664,1592,72,4406,12,74775
"Waldo city, Florida",576,545,31,1080,12,74925
"Wallace CDP, Florida",1764,1764,0,3652,12,74975
"Warm Mineral Springs CDP, Florida",800,768,32,4540,12,75175
"Warrington CDP, Florida",7973,7363,610,16567,12,75200
"Washington Park CDP, Florida",759,733,26,1775,12,75225
"Watergate CDP, Florida",1930,1736,194,3589,12,75275
"Watertown CDP, Florida",1067,858,209,2657,12,75300
"Wauchula city, Florida",1631,1591,40,4898,12,75375
"Waukeenah CDP, Florida",83,83,0,136,12,75425
"Wausau town, Florida",162,143,19,338,12,75450
"Waverly CDP, Florida",162,162,0,269,12,75475
"Webster city, Florida",538,511,27,1267,12,75600
"Wedgefield CDP, Florida",3915,3845,70,8277,12,75612
"Weeki Wachee Gardens CDP, Florida",466,326,140,927,12,75641
"Wekiwa Springs CDP, Florida",12748,12231,517,24270,12,75725
"Welaka town, Florida",278,263,15,948,12,75750
"Wellington village, Florida",30207,28827,1380,61373,12,75812
"Wesley Chapel CDP, Florida",37950,36137,1813,68814,12,75875
"West Bradenton CDP, Florida",2091,2007,84,3935,12,76050
"West Canaveral Groves CDP, Florida",150,144,6,167,12,76058
"Westchase CDP, Florida",13474,13122,352,24891,12,76062
"Westchester CDP, Florida",29027,27784,1243,53765,12,76075
"West DeLand CDP, Florida",1783,1634,149,3574,12,76087
"Westgate CDP, Florida",4535,4143,392,8340,12,76290
"Westlake city, Florida",973,913,60,1855,12,76417
"West Lealman CDP, Florida",6443,6094,349,14277,12,76481
"West Little River CDP, Florida",14856,13902,954,33465,12,76487
"West Melbourne city, Florida",13065,12428,637,26762,12,76500
"West Miami city, Florida",3896,3751,145,7104,12,76525
"Weston city, Florida",33482,32286,1196,68029,12,76582
"West Palm Beach city, Florida",62457,58582,3875,117588,12,76600
"West Park city, Florida",8245,7538,707,15074,12,76658
"West Pensacola CDP, Florida",9424,8777,647,21246,12,76675
"West Perrine CDP, Florida",5025,4622,403,10597,12,76700
"West Samoset CDP, Florida",3145,2909,236,6985,12,76740
"West Vero Corridor CDP, Florida",3140,2888,252,10315,12,76937
"Westview CDP, Florida",4848,4753,95,10992,12,76950
"Westville town, Florida",132,131,1,268,12,76975
"Westwood Lakes CDP, Florida",5684,5297,387,10725,12,77075
"Wewahitchka city, Florida",796,769,27,1668,12,77100
"Whiskey Creek CDP, Florida",2604,2507,97,5302,12,77137
"White City CDP, Florida",2557,2488,69,5494,12,77275
"White Springs town, Florida",285,242,43,781,12,77400
"Whitfield CDP (Manatee County), Florida",2563,2469,94,5048,12,77467
"Whitfield CDP (Santa Rosa County), Florida",308,271,37,629,12,77470
"Wildwood city, Florida",5582,5148,434,15735,12,77675
"Williamsburg CDP, Florida",3716,3584,132,6908,12,77735
"Williston city, Florida",1254,1219,35,2980,12,77825
"Williston Highlands CDP, Florida",1454,1454,0,3164,12,77837
"Willow Oak CDP, Florida",2881,2756,125,6885,12,77862
"Wilton Manors city, Florida",6909,6638,271,11451,12,78000
"Wimauma CDP, Florida",4748,4617,131,12439,12,78025
"Windermere town, Florida",1494,1462,32,3043,12,78050
"Winding Cypress CDP, Florida",337,337,0,924,12,78063
"Windsor CDP, Florida",86,86,0,236,12,78110
"Winter Beach CDP, Florida",1236,1152,84,4273,12,78225
"Winter Garden city, Florida",24675,22979,1696,46518,12,78250
"Winter Haven city, Florida",22274,21343,931,50778,12,78275
"Winter Park city, Florida",14328,13767,561,29985,12,78300
"Winter Springs city, Florida",21545,20648,897,38205,12,78325
"Wiscon CDP, Florida",260,226,34,628,12,78340
"Woodlawn Beach CDP, Florida",1426,1372,54,3128,12,78500
"Woodville CDP, Florida",1848,1732,116,4356,12,78700
"World Golf Village CDP, Florida",10730,10200,530,22137,12,78740
"Worthington Springs town, Florida",107,103,4,269,12,78775
"Wright CDP, Florida",12765,12313,452,26272,12,78800
"Yalaha CDP, Florida",434,434,0,1404,12,78900
"Yankeetown town, Florida",172,156,16,629,12,78925
"Yeehaw Junction CDP, Florida",96,78,18,134,12,78975
"Yulee CDP, Florida",6648,6523,125,13776,12,79175
"Zellwood CDP, Florida",1244,1240,4,2850,12,79200
"Zephyrhills city, Florida",6303,6045,258,17575,12,79225
"Zephyrhills North CDP, Florida",1187,1057,130,3280,12,79231
"Zephyrhills South CDP, Florida",1558,1434,124,5470,12,79237
"Zephyrhills West CDP, Florida",1752,1706,46,6147,12,79243
"Zolfo Springs town, Florida",793,749,44,1759,12,79250
"Abbeville city, Georgia",370,332,38,2752,13,00184
"Acworth city, Georgia",12458,11933,525,22318,13,00408
"Adairsville city, Georgia",2163,2155,8,4911,13,00436
"Adel city, Georgia",2747,2577,170,5571,13,00576
"Adrian city, Georgia",281,219,62,614,13,00660
"Ailey city, Georgia",242,213,29,583,13,00828
"Alamo town, Georgia",889,750,139,3180,13,00996
"Alapaha town, Georgia",342,295,47,592,13,01024
"Albany city, Georgia",29798,26725,3073,68926,13,01052
"Aldora town, Georgia",0,0,0,0,13,01248
"Allenhurst city, Georgia",256,241,15,515,13,01472
"Allentown city, Georgia",64,62,2,204,13,01500
"Alma city, Georgia",1055,1034,21,3433,13,01612
"Alpharetta city, Georgia",36188,34458,1730,65884,13,01696
"Alston town, Georgia",64,64,0,223,13,01808
"Alto town, Georgia",571,546,25,1328,13,01948
"Ambrose city, Georgia",106,94,12,221,13,02060
"Americus city, Georgia",7433,6924,509,16020,13,02116
"Andersonville city, Georgia",100,90,10,296,13,02256
"Antioch CDP, Georgia",309,289,20,605,13,02364
"Appling CDP, Georgia",272,230,42,701,13,02536
"Arabi town, Georgia",334,308,26,663,13,02564
"Aragon city, Georgia",639,588,51,1764,13,02592
"Arcade city, Georgia",904,853,51,1829,13,02648
"Argyle town, Georgia",274,272,2,504,13,02844
"Arlington city, Georgia",489,445,44,1141,13,02928
"Arnoldsville city, Georgia",244,239,5,486,13,03124
"Ashburn city, Georgia",1609,1435,174,4223,13,03236
"Athens-Clarke County unified government (balance), Georgia",65991,62443,3548,126672,13,03440
"Atlanta city, Georgia",280422,264039,16383,494838,13,04000
"Attapulgus city, Georgia",362,356,6,715,13,04084
"Auburn city, Georgia",4278,4060,218,7794,13,04140
"Augusta-Richmond County consolidated government (balance), Georgia",92455,84796,7659,201615,13,04204
"Austell city, Georgia",4459,4211,248,8109,13,04252
"Avalon town, Georgia",115,115,0,285,13,04392
"Avera city, Georgia",122,118,4,248,13,04448
"Avondale Estates city, Georgia",1772,1772,0,3507,13,04644
"Axson CDP, Georgia",197,197,0,381,13,04700
"Baconton city, Georgia",510,476,34,964,13,04840
"Bainbridge city, Georgia",5237,4740,497,14234,13,04896
"Baldwin city, Georgia",1740,1736,4,3817,13,04980
"Ball Ground city, Georgia",1504,1450,54,2527,13,05036
"Barnesville city, Georgia",2960,2890,70,6200,13,05344
"Bartow town, Georgia",141,136,5,219,13,05680
"Barwick city, Georgia",102,100,2,316,13,05708
"Baxley city, Georgia",1592,1434,158,4971,13,06016
"Bellville city, Georgia",102,102,0,196,13,06688
"Belvedere Park CDP, Georgia",8165,7538,627,14558,13,06884
"Bemiss CDP, Georgia",3467,3276,191,9049,13,06968
"Berkeley Lake city, Georgia",1315,1283,32,2527,13,07248
"Berlin city, Georgia",357,338,19,769,13,07304
"Berry College CDP, Georgia",1022,955,67,1727,13,07380
"Bethlehem town, Georgia",310,297,13,598,13,07612
"Between town, Georgia",309,294,15,491,13,07640
"Bishop town, Georgia",269,264,5,456,13,08200
"Blackshear city, Georgia",1520,1469,51,3521,13,08284
"Blairsville city, Georgia",227,222,5,736,13,08480
"Blakely city, Georgia",2200,2076,124,5299,13,08536
"Bloomingdale city, Georgia",1581,1538,43,2933,13,08844
"Blue Ridge city, Georgia",442,438,4,1366,13,08928
"Bluffton town, Georgia",111,111,0,295,13,08956
"Blythe city, Georgia",325,309,16,672,13,09040
"Bogart town, Georgia",657,649,8,1276,13,09068
"Bolingbroke CDP, Georgia",122,122,0,331,13,09152
"Bonanza CDP, Georgia",2023,1845,178,3638,13,09272
"Boston city, Georgia",553,494,59,1108,13,09460
"Bostwick city, Georgia",158,158,0,373,13,09488
"Bowdon city, Georgia",1033,995,38,2590,13,09544
"Bowersville town, Georgia",197,195,2,469,13,09656
"Bowman city, Georgia",354,317,37,889,13,09712
"Box Springs CDP, Georgia",80,80,0,238,13,09768
"Boykin CDP, Georgia",13,13,0,35,13,09852
"Braselton town, Georgia",7199,7049,150,13804,13,10076
"Braswell town, Georgia",169,164,5,369,13,10104
"Bremen city, Georgia",4040,4004,36,7209,13,10132
"Brinson town, Georgia",106,106,0,195,13,10608
"Bristol CDP, Georgia",29,29,0,119,13,10664
"Bronwood town, Georgia",144,140,4,323,13,10860
"Brookhaven city, Georgia",34886,33832,1054,56848,13,10944
"Brooklet city, Georgia",712,710,2,1528,13,11000
"Brooks town, Georgia",302,298,4,719,13,11056
"Broxton city, Georgia",307,307,0,1082,13,11504
"Brunswick city, Georgia",6592,5991,601,15243,13,11560
"Buchanan city, Georgia",524,461,63,1238,13,11616
"Buckhead CDP, Georgia",2355,2143,212,4815,13,11626
"Buckhead town, Georgia",98,91,7,183,13,11672
"Buena Vista city, Georgia",609,607,2,1964,13,11728
"Buford city, Georgia",7354,7137,217,17222,13,11784
"Butler city, Georgia",769,744,25,2059,13,12120
"Byromville town, Georgia",230,229,1,583,13,12232
"Byron city, Georgia",2921,2822,99,5687,13,12260
"Cadwell town, Georgia",239,233,6,633,13,12344
"Cairo city, Georgia",4163,3846,317,10091,13,12400
"Calhoun city, Georgia",7959,7767,192,17184,13,12456
"Calvary CDP, Georgia",68,68,0,82,13,12484
"Camak town, Georgia",186,174,12,434,13,12512
"Camilla city, Georgia",1883,1671,212,5163,13,12624
"Candler-McAfee CDP, Georgia",11593,10075,1518,22707,13,12834
"Canon city, Georgia",270,269,1,912,13,12932
"Canoochee CDP, Georgia",49,49,0,104,13,12960
"Canton city, Georgia",17894,16640,1254,33499,13,12988
"Carl town, Georgia",115,110,5,296,13,13184
"Carlton city, Georgia",154,134,20,403,13,13212
"Carnesville city, Georgia",516,464,52,935,13,13352
"Carrollton city, Georgia",13477,12700,777,26622,13,13492
"Cartersville city, Georgia",11441,11116,325,23103,13,13688
"Cataula CDP, Georgia",953,953,0,1829,13,14024
"Cave Spring city, Georgia",419,373,46,982,13,14108
"Cecil city, Georgia",133,133,0,349,13,14192
"Cedar Springs CDP, Georgia",24,24,0,24,13,14472
"Cedartown city, Georgia",4340,4017,323,10166,13,14500
"Centerville city, Georgia",3297,3231,66,8220,13,14920
"Centralhatchee town, Georgia",208,186,22,515,13,15026
"Chamblee city, Georgia",18384,18034,350,29980,13,15172
"Chatsworth city, Georgia",2022,1837,185,4840,13,15508
"Chattahoochee Hills city, Georgia",1490,1463,27,3273,13,15552
"Chattanooga Valley CDP, Georgia",1662,1497,165,4166,13,15585
"Chauncey city, Georgia",147,146,1,369,13,15648
"Cherry Log CDP, Georgia",0,0,0,0,13,15844
"Chester town, Georgia",184,179,5,1702,13,15900
"Chickamauga city, Georgia",1723,1723,0,2978,13,15984
"Clarkesville city, Georgia",678,660,18,1885,13,16460
"Clarkston city, Georgia",7077,6467,610,14553,13,16544
"Claxton city, Georgia",1111,1075,36,2573,13,16600
"Clayton city, Georgia",1071,1010,61,2277,13,16656
"Clermont town, Georgia",639,627,12,1092,13,16796
"Cleveland city, Georgia",1787,1745,42,3512,13,16824
"Climax city, Georgia",72,62,10,186,13,16908
"Clyattville CDP, Georgia",137,137,0,283,13,17132
"Cobbtown city, Georgia",231,217,14,565,13,17272
"Cochran city, Georgia",1823,1632,191,4867,13,17328
"Cogdell CDP, Georgia",13,13,0,24,13,17468
"Cohutta city, Georgia",334,317,17,729,13,17496
"Colbert city, Georgia",253,252,1,601,13,17552
"Coleman CDP, Georgia",0,0,0,0,13,17580
"College Park city, Georgia",7839,6822,1017,14113,13,17776
"Collins city, Georgia",267,262,5,598,13,17832
"Colquitt city, Georgia",851,774,77,2131,13,18000
"Columbus city, Georgia",89396,82874,6522,204572,13,19000
"Comer city, Georgia",708,680,28,1810,13,19084
"Commerce city, Georgia",3243,3237,6,7391,13,19112
"Concord city, Georgia",210,210,0,442,13,19168
"Conley CDP, Georgia",2830,2701,129,5892,13,19280
"Conyers city, Georgia",9031,8079,952,17415,13,19336
"Coolidge city, Georgia",392,392,0,775,13,19392
"Cordele city, Georgia",4714,4300,414,10210,13,19616
"Cornelia city, Georgia",2366,2337,29,4648,13,19728
"Country Club Estates CDP, Georgia",5012,4764,248,9057,13,19830
"Covington city, Georgia",7210,6771,439,14190,13,20064
"Crawford city, Georgia",438,429,9,1019,13,20288
"Crawfordville city, Georgia",230,230,0,589,13,20316
"Crescent CDP, Georgia",240,240,0,653,13,20372
"Crooked Creek CDP, Georgia",204,200,4,674,13,20550
"Culloden city, Georgia",143,141,2,254,13,20848
"Cumming city, Georgia",3676,3499,177,7371,13,20932
"Cusseta-Chattahoochee County unified government, Georgia",1631,1494,137,9402,13,21017
"Cuthbert city, Georgia",1211,1204,7,3109,13,21072
"Dacula city, Georgia",3087,2929,158,6906,13,21184
"Dahlonega city, Georgia",2889,2763,126,7083,13,21240
"Daisy city, Georgia",99,99,0,371,13,21268
"Dallas city, Georgia",6855,6504,351,14126,13,21324
"Dalton city, Georgia",16888,16222,666,34358,13,21380
"Damascus city, Georgia",145,143,2,331,13,21436
"Danielsville city, Georgia",612,583,29,953,13,21632
"Danville town, Georgia",46,46,0,186,13,21688
"Darien city, Georgia",645,624,21,1253,13,21716
"Dasher town, Georgia",499,493,6,1063,13,21744
"Davisboro city, Georgia",293,280,13,2196,13,21800
"Dawson city, Georgia",1467,1267,200,4342,13,21912
"Dawsonville city, Georgia",1916,1832,84,3871,13,21940
"Dearing town, Georgia",315,305,10,662,13,22024
"Decatur city, Georgia",11422,10989,433,24421,13,22052
"Deenwood CDP, Georgia",753,728,25,2146,13,22080
"Deepstep town, Georgia",81,81,0,135,13,22108
"Demorest city, Georgia",1090,1015,75,2293,13,22304
"Denton city, Georgia",59,59,0,257,13,22388
"De Soto city, Georgia",31,31,0,67,13,22472
"Dewy Rose CDP, Georgia",165,165,0,269,13,22724
"Dexter town, Georgia",467,443,24,1042,13,22752
"Dillard city, Georgia",128,122,6,284,13,22976
"Dixie CDP, Georgia",125,125,0,170,13,23060
"Dixie Union CDP, Georgia",13,13,0,48,13,23144
"Dock Junction CDP, Georgia",3589,3425,164,8176,13,23200
"Doerun city, Georgia",309,303,6,897,13,23284
"Donalsonville city, Georgia",1125,1058,67,2824,13,23368
"Dooling town, Georgia",31,30,1,41,13,23480
"Doraville city, Georgia",5623,5510,113,10691,13,23536
"Douglas city, Georgia",4719,4585,134,11694,13,23872
"Douglasville city, Georgia",19020,17965,1055,35252,13,23900
"Druid Hills CDP, Georgia",4483,4336,147,8467,13,24264
"Dublin city, Georgia",5802,5368,434,15985,13,24376
"Dudley city, Georgia",319,319,0,666,13,24488
"Duluth city, Georgia",18351,17583,768,31742,13,24600
"Dunwoody city, Georgia",27704,27214,490,51458,13,24768
"Du Pont town, Georgia",19,19,0,142,13,24796
"Dutch Island CDP, Georgia",507,507,0,1268,13,24876
"Eagle Grove CDP, Georgia",0,0,0,25,13,24964
"East Dublin city, Georgia",1433,1329,104,2889,13,25300
"East Ellijay city, Georgia",233,208,25,530,13,25356
"East Griffin CDP, Georgia",445,412,33,1206,13,25440
"Eastman city, Georgia",2146,2102,44,5635,13,25552
"East Newnan CDP, Georgia",364,322,42,917,13,25692
"East Point city, Georgia",21292,19772,1520,38113,13,25720
"Eatonton city, Georgia",2720,2586,134,6369,13,26084
"Echols County consolidated government, Georgia",1940,1901,39,3707,13,26156
"Edge Hill city, Georgia",14,14,0,19,13,26224
"Edison city, Georgia",522,432,90,1229,13,26448
"Elberton city, Georgia",1956,1791,165,4627,13,26616
"Ellaville city, Georgia",515,486,29,1492,13,26980
"Ellenton town, Georgia",131,125,6,296,13,27008
"Ellerslie CDP, Georgia",663,663,0,1037,13,27064
"Ellijay city, Georgia",653,602,51,1750,13,27092
"Emerson city, Georgia",810,757,53,1594,13,27344
"Empire CDP, Georgia",203,203,0,488,13,27512
"Enigma town, Georgia",353,353,0,1251,13,27596
"Ephesus city, Georgia",276,264,12,553,13,27708
"Epworth CDP, Georgia",374,374,0,575,13,27736
"Eton city, Georgia",710,691,19,1574,13,27932
"Euharlee city, Georgia",2418,2316,102,4258,13,27988
"Eulonia CDP, Georgia",260,260,0,567,13,28016
"Evans CDP, Georgia",18060,17068,992,37456,13,28044
"Everett CDP, Georgia",22,22,0,54,13,28100
"Experiment CDP, Georgia",813,747,66,2578,13,28296
"Faceville CDP, Georgia",75,65,10,151,13,28324
"Fairburn city, Georgia",8597,8149,448,16469,13,28380
"Fairfield Plantation CDP, Georgia",2835,2737,98,6464,13,28440
"Fairmount city, Georgia",516,497,19,1213,13,28492
"Fair Oaks CDP, Georgia",5430,5065,365,9614,13,28520
"Fairplay CDP, Georgia",865,865,0,1234,13,28548
"Fairview CDP, Georgia",2440,2368,72,5718,13,28632
"Fargo city, Georgia",225,224,1,460,13,28744
"Fayetteville city, Georgia",8880,8350,530,19010,13,28968
"Fitzgerald city, Georgia",3992,3747,245,8972,13,29528
"Flemington city, Georgia",473,452,21,1202,13,30088
"Flovilla city, Georgia",491,438,53,1165,13,30312
"Flowery Branch city, Georgia",5587,5482,105,9700,13,30340
"Folkston city, Georgia",1868,1548,320,4544,13,30424
"Forest Park city, Georgia",8651,7877,774,19619,13,30536
"Forsyth city, Georgia",2119,1978,141,4549,13,30732
"Fort Gaines city, Georgia",381,346,35,1035,13,30816
"Fort Oglethorpe city, Georgia",4712,4434,278,10203,13,30956
"Fort Stewart CDP, Georgia",1774,1535,239,9324,13,31068
"Fort Valley city, Georgia",3606,3267,339,8821,13,31096
"Franklin city, Georgia",331,318,13,938,13,31292
"Franklin Springs city, Georgia",478,472,6,1040,13,31320
"Funston city, Georgia",388,388,0,838,13,31684
"Gainesville city, Georgia",20865,19975,890,42780,13,31908
"Garden City city, Georgia",5468,5016,452,10352,13,32048
"Gardi CDP, Georgia",29,29,0,36,13,32132
"Garfield city, Georgia",103,84,19,205,13,32188
"Gay town, Georgia",82,81,1,122,13,32384
"Geneva town, Georgia",48,48,0,140,13,32412
"Georgetown CDP, Georgia",6967,6557,410,12490,13,32482
"Georgetown-Quitman County unified government, Georgia",686,525,161,2180,13,32528
"Gibson city, Georgia",257,249,8,898,13,32748
"Gillsville city, Georgia",136,134,2,286,13,32860
"Girard town, Georgia",47,46,1,202,13,32916
"Glenn CDP, Georgia",0,0,0,9,13,33280
"Glennville city, Georgia",1681,1539,142,5204,13,33336
"Glenwood city, Georgia",448,447,1,739,13,33392
"Godfrey CDP, Georgia",84,84,0,133,13,33672
"Good Hope city, Georgia",161,161,0,365,13,33896
"Gordon city, Georgia",690,629,61,2107,13,33980
"Gough CDP, Georgia",26,26,0,115,13,34176
"Graham city, Georgia",134,124,10,672,13,34260
"Grantville city, Georgia",1763,1707,56,3175,13,34428
"Gray city, Georgia",1507,1457,50,3415,13,34512
"Grayson city, Georgia",2108,2074,34,4572,13,34596
"Greensboro city, Georgia",1661,1494,167,3573,13,34876
"Greenville city, Georgia",590,535,55,1088,13,35016
"Gresham Park CDP, Georgia",4159,3972,187,7816,13,35240
"Griffin city, Georgia",10664,10077,587,23485,13,35324
"Grovetown city, Georgia",8515,8441,74,16049,13,35716
"Gumbranch city, Georgia",198,194,4,648,13,35800
"Gumlog CDP, Georgia",987,938,49,2212,13,35814
"Guyton city, Georgia",1158,969,189,2405,13,35884
"Hagan city, Georgia",653,598,55,1444,13,36024
"Hahira city, Georgia",1526,1450,76,3361,13,36052
"Hamilton city, Georgia",755,697,58,1946,13,36220
"Hampton city, Georgia",3654,3523,131,8244,13,36276
"Hannahs Mill CDP, Georgia",1606,1598,8,3632,13,36416
"Hapeville city, Georgia",4021,3770,251,6566,13,36472
"Haralson town, Georgia",95,90,5,236,13,36528
"Hardwick CDP, Georgia",1248,1187,61,3202,13,36668
"Harlem city, Georgia",1726,1663,63,3682,13,36696
"Harrison town, Georgia",116,112,4,345,13,36920
"Hartwell city, Georgia",2060,2053,7,4481,13,37144
"Hawkinsville city, Georgia",1857,1810,47,4007,13,37396
"Hazlehurst city, Georgia",1548,1393,155,4075,13,37564
"Helen city, Georgia",234,229,5,505,13,37788
"Henderson CDP, Georgia",1666,1559,107,3005,13,37910
"Hephzibah city, Georgia",1728,1530,198,3869,13,38040
"Heron Bay CDP, Georgia",2107,1997,110,3899,13,38105
"Hiawassee city, Georgia",464,464,0,1140,13,38124
"Hickox CDP, Georgia",72,72,0,382,13,38292
"Higgston town, Georgia",173,158,15,355,13,38348
"Hilltop CDP, Georgia",109,98,11,211,13,38866
"Hiltonia town, Georgia",138,106,32,456,13,38920
"Hinesville city, Georgia",14434,13188,1246,34732,13,38964
"Hiram city, Georgia",2535,2491,44,4911,13,39076
"Hoboken city, Georgia",470,467,3,858,13,39216
"Hogansville city, Georgia",1686,1671,15,3240,13,39244
"Holly Springs city, Georgia",9215,8931,284,16675,13,39524
"Homeland city, Georgia",666,654,12,1155,13,39692
"Homer town, Georgia",741,706,35,1659,13,39720
"Homerville city, Georgia",493,483,10,2049,13,39748
"Hortense CDP, Georgia",164,164,0,352,13,40028
"Hoschton city, Georgia",1650,1634,16,3099,13,40056
"Howard CDP, Georgia",0,0,0,0,13,40196
"Hull city, Georgia",67,64,3,205,13,40532
"Ideal city, Georgia",168,157,11,625,13,40812
"Ila city, Georgia",145,135,10,406,13,40840
"Indian Springs CDP, Georgia",1204,1173,31,1983,13,41036
"Iron City town, Georgia",103,97,6,322,13,41344
"Irondale CDP, Georgia",3533,3326,207,8305,13,41347
"Irwinton city, Georgia",304,269,35,572,13,41400
"Isle of Hope CDP, Georgia",1012,994,18,2137,13,41484
"Ivey city, Georgia",403,362,41,1060,13,41540
"Jackson city, Georgia",2082,1950,132,5497,13,41596
"Jacksonville city, Georgia",25,25,0,103,13,41708
"Jakin city, Georgia",80,80,0,235,13,41792
"Jasper city, Georgia",1592,1575,17,4177,13,41932
"Jefferson city, Georgia",6878,6734,144,13496,13,41988
"Jeffersonville city, Georgia",271,271,0,968,13,42100
"Jekyll Island CDP, Georgia",243,243,0,946,13,42128
"Jenkinsburg city, Georgia",153,146,7,303,13,42156
"Jersey city, Georgia",60,60,0,164,13,42184
"Jesup city, Georgia",3970,3723,247,9820,13,42268
"Johns Creek city, Georgia",42395,40832,1563,82230,13,42425
"Jonesboro city, Georgia",1277,1198,79,4415,13,42604
"Juliette CDP, Georgia",44,44,0,242,13,42772
"Junction City town, Georgia",149,140,9,409,13,42800
"Kennesaw city, Georgia",18983,17959,1024,33360,13,43192
"Kennesaw State University CDP, Georgia",725,601,124,2642,13,43210
"Keysville city, Georgia",109,109,0,403,13,43360
"Kings Bay Base CDP, Georgia",379,338,41,2449,13,43580
"Kingsland city, Georgia",8024,7728,296,18563,13,43640
"Kingston city, Georgia",389,354,35,774,13,43668
"Kite city, Georgia",35,35,0,199,13,43892
"Knoxville CDP, Georgia",30,30,0,108,13,44060
"LaFayette city, Georgia",2716,2573,143,6929,13,44312
"LaGrange city, Georgia",14737,13957,780,31173,13,44340
"Lake City city, Georgia",1634,1605,29,2916,13,44508
"Lakeland city, Georgia",906,905,1,2928,13,44592
"Lake Park city, Georgia",440,435,5,980,13,44704
"Lakeview CDP, Georgia",2363,2282,81,4664,13,44900
"Lakeview Estates CDP, Georgia",1331,1292,39,2714,13,44956
"Lavonia city, Georgia",919,814,105,2617,13,45460
"Lawrenceville city, Georgia",15448,14468,980,30465,13,45488
"Leary city, Georgia",142,142,0,373,13,45600
"Leesburg city, Georgia",1797,1491,306,3465,13,45768
"Lenox town, Georgia",453,424,29,887,13,45936
"Leslie city, Georgia",220,211,9,525,13,46020
"Lexington city, Georgia",162,161,1,410,13,46188
"Lilburn city, Georgia",6598,6294,304,14741,13,46356
"Lilly city, Georgia",43,37,6,144,13,46384
"Lincoln Park CDP, Georgia",431,431,0,739,13,46524
"Lincolnton city, Georgia",686,676,10,1876,13,46552
"Lindale CDP, Georgia",2088,1967,121,4568,13,46580
"Lithia Springs CDP, Georgia",8507,8138,369,16020,13,46832
"Lithonia city, Georgia",1408,1305,103,2614,13,46860
"Locust Grove city, Georgia",4916,4496,420,9367,13,47140
"Loganville city, Georgia",7773,7445,328,14287,13,47196
"Lone Oak town, Georgia",35,35,0,182,13,47252
"Lookout Mountain city, Georgia",848,818,30,1793,13,47336
"Louisville city, Georgia",1013,982,31,2704,13,47560
"Lovejoy city, Georgia",4044,3779,265,10429,13,47616
"Ludowici city, Georgia",553,517,36,2137,13,47784
"Lula city, Georgia",1424,1393,31,2880,13,47896
"Lumber City city, Georgia",386,358,28,1127,13,47952
"Lumpkin city, Georgia",360,360,0,776,13,47980
"Luthersville city, Georgia",357,347,10,792,13,48008
"Lyerly town, Georgia",231,216,15,548,13,48092
"Lyons city, Georgia",1506,1431,75,4219,13,48232
"Mableton CDP, Georgia",23444,21882,1562,41647,13,48288
"McCaysville city, Georgia",788,785,3,1639,13,48428
"McDonough city, Georgia",15749,14769,980,29134,13,48624
"McIntyre town, Georgia",313,313,0,718,13,48848
"Macon-Bibb County, Georgia",70220,64934,5286,156554,13,49008
"McRae-Helena city, Georgia",1509,1495,14,6338,13,49100
"Madison city, Georgia",2241,2222,19,4574,13,49196
"Manassas city, Georgia",48,48,0,82,13,49504
"Manchester city, Georgia",1292,1207,85,3612,13,49532
"Manor CDP, Georgia",49,49,0,116,13,49588
"Mansfield city, Georgia",184,178,6,338,13,49616
"Marietta city, Georgia",33574,32420,1154,61387,13,49756
"Marshallville city, Georgia",446,388,58,1014,13,49924
"Martin town, Georgia",168,141,27,359,13,50008
"Martinez CDP, Georgia",16775,16123,652,33773,13,50036
"Matthews CDP, Georgia",51,51,0,185,13,50176
"Maxeys town, Georgia",229,223,6,482,13,50260
"Maysville town, Georgia",668,658,10,1665,13,50484
"Meansville city, Georgia",107,85,22,239,13,50596
"Meigs city, Georgia",316,262,54,934,13,50680
"Mendes CDP, Georgia",140,140,0,227,13,50820
"Menlo city, Georgia",260,248,12,469,13,50848
"Mershon CDP, Georgia",12,12,0,16,13,50960
"Metter city, Georgia",1572,1479,93,3976,13,51072
"Midville city, Georgia",207,182,25,423,13,51240
"Midway city, Georgia",1239,1163,76,2453,13,51352
"Milan city, Georgia",213,180,33,649,13,51408
"Milledgeville city, Georgia",6627,6149,478,17021,13,51492
"Millen city, Georgia",1030,927,103,2973,13,51520
"Millwood CDP, Georgia",15,15,0,58,13,51576
"Milner city, Georgia",285,275,10,616,13,51604
"Milstead CDP, Georgia",291,258,33,810,13,51660
"Milton city, Georgia",22182,21471,711,41029,13,51670
"Mineral Bluff CDP, Georgia",242,226,16,370,13,51744
"Mitchell town, Georgia",72,71,1,127,13,51968
"Molena city, Georgia",225,209,16,667,13,52108
"Monroe city, Georgia",5886,5229,657,15036,13,52192
"Montezuma city, Georgia",1244,1165,79,3040,13,52304
"Montgomery CDP, Georgia",2383,2338,45,4606,13,52332
"Monticello city, Georgia",1231,1160,71,2593,13,52416
"Montrose town, Georgia",147,125,22,398,13,52500
"Moody AFB CDP, Georgia",164,164,0,1506,13,52556
"Moreland town, Georgia",262,251,11,608,13,52668
"Morgan city, Georgia",82,50,32,1832,13,52696
"Morganton city, Georgia",131,125,6,288,13,52724
"Morrow city, Georgia",2922,2597,325,6563,13,53004
"Morven city, Georgia",247,219,28,587,13,53032
"Moultrie city, Georgia",6690,6133,557,14533,13,53060
"Mountain City town, Georgia",403,403,0,991,13,53116
"Mountain Park city, Georgia",581,566,15,959,13,53172
"Mountain Park CDP, Georgia",6766,6548,218,13334,13,53186
"Mount Airy town, Georgia",614,612,2,1373,13,53284
"Mount Vernon city, Georgia",795,665,130,2251,13,53508
"Mount Zion city, Georgia",1151,1106,45,2346,13,53620
"Musella CDP, Georgia",79,33,46,125,13,54012
"Nahunta city, Georgia",560,541,19,1386,13,54124
"Nashville city, Georgia",1904,1766,138,4907,13,54264
"Naylor CDP, Georgia",27,27,0,39,13,54404
"Nelson city, Georgia",498,485,13,946,13,54572
"Newborn town, Georgia",369,331,38,643,13,54656
"New England CDP, Georgia",201,192,9,474,13,54768
"Newington town, Georgia",212,198,14,406,13,54992
"Newnan city, Georgia",22107,21418,689,42689,13,55020
"Newton city, Georgia",187,182,5,504,13,55244
"Nicholls city, Georgia",423,386,37,3062,13,55440
"Nicholson city, Georgia",1094,960,134,2067,13,55468
"Norcross city, Georgia",9839,9657,182,17530,13,55776
"Norman Park city, Georgia",512,480,32,1121,13,55860
"Norristown CDP, Georgia",15,15,0,25,13,55944
"North Decatur CDP, Georgia",9938,9489,449,17183,13,56112
"North Druid Hills CDP, Georgia",10634,10235,399,17241,13,56168
"North High Shoals town, Georgia",362,352,10,725,13,56308
"Norwood city, Georgia",77,75,2,277,13,56560
"Nunez city, Georgia",70,70,0,167,13,56644
"Oak Park town, Georgia",221,193,28,528,13,57232
"Oakwood city, Georgia",3032,2911,121,5132,13,57260
"Ochlocknee town, Georgia",324,294,30,672,13,57372
"Ocilla city, Georgia",1338,1284,54,3338,13,57428
"Oconee city, Georgia",125,114,11,297,13,57456
"Odum city, Georgia",138,135,3,355,13,57540
"Offerman city, Georgia",148,140,8,935,13,57568
"Oglethorpe city, Georgia",336,314,22,1084,13,57736
"Ohoopee CDP, Georgia",8,8,0,41,13,57876
"Oliver city, Georgia",120,114,6,286,13,58100
"Omega city, Georgia",560,544,16,1302,13,58184
"Orchard Hill town, Georgia",86,81,5,192,13,58296
"Oxford city, Georgia",933,890,43,2033,13,58744
"Palmetto city, Georgia",2618,2437,181,4650,13,58884
"Panthersville CDP, Georgia",4793,4471,322,9197,13,59080
"Parrott town, Georgia",47,44,3,102,13,59416
"Patterson city, Georgia",347,343,4,729,13,59500
"Pavo city, Georgia",317,311,6,715,13,59556
"Peachtree City city, Georgia",18007,17337,670,38414,13,59724
"Peachtree Corners city, Georgia",23277,22519,758,42147,13,59735
"Pearson city, Georgia",922,878,44,1826,13,59808
"Pelham city, Georgia",1288,1119,169,3501,13,59976
"Pembroke city, Georgia",1306,1205,101,2542,13,60004
"Pendergrass town, Georgia",910,884,26,1705,13,60032
"Perkins CDP, Georgia",101,101,0,101,13,60312
"Perry city, Georgia",10265,9881,384,21279,13,60340
"Phillipsburg CDP, Georgia",60,60,0,467,13,60508
"Pinehurst city, Georgia",106,97,9,440,13,60984
"Pine Lake city, Georgia",512,489,23,888,13,61040
"Pine Mountain town, Georgia",592,565,27,1474,13,61124
"Pineview town, Georgia",186,176,10,609,13,61320
"Piney Grove CDP, Georgia",262,238,24,381,13,61376
"Pitts city, Georgia",240,234,6,509,13,61544
"Plains city, Georgia",190,190,0,781,13,61628
"Plainville city, Georgia",148,145,3,314,13,61684
"Pooler city, Georgia",15097,14282,815,26264,13,62104
"Portal town, Georgia",318,301,17,622,13,62216
"Porterdale city, Georgia",578,556,22,1602,13,62244
"Port Wentworth city, Georgia",6188,5720,468,11103,13,62328
"Poulan city, Georgia",372,362,10,768,13,62496
"Powder Springs city, Georgia",9361,8939,422,16930,13,62524
"Pulaski town, Georgia",92,92,0,230,13,63000
"Putney CDP, Georgia",1632,1377,255,3295,13,63084
"Quitman city, Georgia",1547,1453,94,4050,13,63224
"Ranger town, Georgia",35,35,0,57,13,63560
"Raoul CDP, Georgia",532,509,23,2529,13,63588
"Ray City city, Georgia",395,354,41,1043,13,63728
"Rayle town, Georgia",38,33,5,166,13,63756
"Rebecca town, Georgia",154,148,6,315,13,63840
"Redan CDP, Georgia",17561,15854,1707,31326,13,63952
"Reed Creek CDP, Georgia",1093,1035,58,2803,13,64288
"Register town, Georgia",70,62,8,209,13,64372
"Reidsville city, Georgia",1096,1068,28,2538,13,64512
"Remerton city, Georgia",892,825,67,1602,13,64596
"Rentz city, Georgia",91,91,0,242,13,64680
"Resaca town, Georgia",405,402,3,1363,13,64736
"Rest Haven town, Georgia",23,23,0,40,13,64792
"Reynolds city, Georgia",309,304,5,793,13,64876
"Rhine town, Georgia",403,397,6,573,13,64932
"Riceboro city, Georgia",420,352,68,967,13,64960
"Richland city, Georgia",560,530,30,1290,13,65016
"Richmond Hill city, Georgia",7796,7408,388,16703,13,65044
"Riddleville town, Georgia",75,66,9,110,13,65156
"Rincon city, Georgia",5541,5215,326,10910,13,65296
"Ringgold city, Georgia",1703,1634,69,3418,13,65324
"Riverdale city, Georgia",8267,8018,249,14933,13,65464
"Roberta city, Georgia",511,447,64,1462,13,65856
"Robins AFB CDP, Georgia",203,188,15,1316,13,65968
"Rochelle city, Georgia",351,322,29,992,13,66024
"Rockingham CDP, Georgia",77,77,0,151,13,66220
"Rockmart city, Georgia",2094,1933,161,5113,13,66276
"Rock Spring CDP, Georgia",883,824,59,1415,13,66304
"Rocky Ford town, Georgia",96,82,14,246,13,66444
"Rome city, Georgia",16501,15751,750,37621,13,66668
"Roopville town, Georgia",140,140,0,423,13,66696
"Rossville city, Georgia",1943,1840,103,3982,13,67256
"Roswell city, Georgia",51463,49265,2198,92770,13,67284
"Royston city, Georgia",846,748,98,2305,13,67452
"Russell CDP, Georgia",697,656,41,1402,13,67676
"Rutledge city, Georgia",475,447,28,1069,13,67760
"St. Marys city, Georgia",7638,7170,468,18507,13,67984
"St. Simons CDP, Georgia",7291,7096,195,15983,13,68040
"Sale City city, Georgia",166,158,8,415,13,68096
"Salem CDP, Georgia",170,170,0,377,13,68129
"Sandersville city, Georgia",2342,2157,185,5727,13,68208
"Sandy Springs city, Georgia",65145,62743,2402,107221,13,68516
"Santa Claus city, Georgia",61,59,2,146,13,68600
"Sardis city, Georgia",664,629,35,1108,13,68740
"Sasser town, Georgia",189,157,32,345,13,68796
"Satilla CDP, Georgia",130,121,9,266,13,68805
"Sautee-Nacoochee CDP, Georgia",138,131,7,486,13,68880
"Savannah city, Georgia",75347,69906,5441,147583,13,69000
"Scotland city, Georgia",92,92,0,315,13,69336
"Scottdale CDP, Georgia",5572,5286,286,10566,13,69392
"Screven city, Georgia",297,287,10,689,13,69448
"Senoia city, Georgia",2802,2700,102,5115,13,69672
"Seville CDP, Georgia",18,18,0,36,13,69728
"Shady Dale town, Georgia",137,133,4,288,13,69784
"Shannon CDP, Georgia",692,684,8,1673,13,69868
"Sharon city, Georgia",21,18,3,47,13,69896
"Sharpsburg town, Georgia",189,185,4,380,13,69980
"Shellman city, Georgia",342,248,94,928,13,70120
"Shiloh city, Georgia",245,245,0,565,13,70428
"Siloam town, Georgia",144,144,0,396,13,70932
"Skidaway Island CDP, Georgia",2944,2741,203,9292,13,71184
"Sky Valley city, Georgia",307,292,15,599,13,71282
"Smarr CDP, Georgia",169,169,0,281,13,71296
"Smithville city, Georgia",144,140,4,320,13,71464
"Smyrna city, Georgia",34812,33359,1453,55863,13,71492
"Snellville city, Georgia",10355,9934,421,20895,13,71604
"Social Circle city, Georgia",2616,2444,172,5011,13,71660
"Soperton city, Georgia",938,789,149,2905,13,71772
"South Fulton city, Georgia",59462,54796,4666,107865,13,72122
"Sparks town, Georgia",779,719,60,2459,13,72556
"Sparta city, Georgia",680,601,79,1944,13,72584
"Springfield city, Georgia",1441,1427,14,2753,13,72780
"Stapleton city, Georgia",157,150,7,377,13,73004
"Statesboro city, Georgia",16483,14625,1858,33185,13,73256
"Statham city, Georgia",1709,1638,71,2829,13,73312
"Sterling CDP, Georgia",910,820,90,1903,13,73452
"Stillmore city, Georgia",274,230,44,712,13,73620
"Stockbridge city, Georgia",15988,15185,803,28858,13,73704
"Stockton CDP, Georgia",180,180,0,242,13,73760
"Stonecrest city, Georgia",32432,29655,2777,59445,13,73784
"Stone Mountain city, Georgia",3444,3251,193,6638,13,73816
"Sugar Hill city, Georgia",13082,12594,488,24947,13,74180
"Summertown city, Georgia",86,69,17,260,13,74348
"Summerville city, Georgia",1432,1365,67,4381,13,74376
"Sumner town, Georgia",170,164,6,404,13,74432
"Sunny Side city, Georgia",65,64,1,174,13,74572
"Sunnyside CDP, Georgia",397,397,0,962,13,74628
"Sunset Village CDP, Georgia",387,387,0,702,13,74768
"Surrency town, Georgia",122,112,10,281,13,74852
"Suwanee city, Georgia",13093,12434,659,21238,13,74936
"Swainsboro city, Georgia",2766,2400,366,7542,13,74964
"Sycamore city, Georgia",420,353,67,1223,13,75104
"Sylvania city, Georgia",1062,1050,12,2618,13,75160
"Sylvester city, Georgia",2577,2372,205,5622,13,75188
"Talahi Island CDP, Georgia",696,696,0,1185,13,75239
"Talbotton city, Georgia",294,272,22,728,13,75244
"Talking Rock town, Georgia",47,42,5,106,13,75272
"Tallapoosa city, Georgia",1250,1249,1,3232,13,75300
"Tallulah Falls town, Georgia",59,59,0,236,13,75328
"Talmo town, Georgia",246,236,10,442,13,75412
"Tarrytown town, Georgia",32,28,4,117,13,75496
"Tate City CDP, Georgia",0,0,0,0,13,75580
"Taylorsville town, Georgia",119,118,1,355,13,75664
"Tazewell CDP, Georgia",0,0,0,0,13,75692
"Temple city, Georgia",2653,2653,0,5395,13,75832
"Tennille city, Georgia",687,653,34,1522,13,75888
"The Rock CDP, Georgia",9,9,0,33,13,76112
"Thomaston city, Georgia",3569,3386,183,9720,13,76168
"Thomasville city, Georgia",9090,8685,405,18744,13,76224
"Thomson city, Georgia",3000,2798,202,6839,13,76280
"Thunderbolt town, Georgia",1345,1296,49,2552,13,76364
"Tifton city, Georgia",7428,7244,184,17059,13,76476
"Tiger town, Georgia",181,178,3,549,13,76504
"Tignall town, Georgia",343,311,32,1163,13,76532
"Toccoa city, Georgia",4263,3825,438,9055,13,76756
"Toomsboro city, Georgia",316,293,23,657,13,76952
"Trenton city, Georgia",996,959,37,2188,13,77372
"Trion town, Georgia",980,941,39,2389,13,77540
"Tucker city, Georgia",19507,18338,1169,36994,13,77652
"Tunnel Hill city, Georgia",475,457,18,1168,13,77736
"Turin town, Georgia",204,204,0,378,13,77764
"Twin City city, Georgia",691,619,72,1849,13,77988
"Tybee Island city, Georgia",1270,1224,46,3126,13,78036
"Tyrone town, Georgia",3830,3725,105,7710,13,78044
"Ty Ty city, Georgia",300,285,15,613,13,78100
"Unadilla city, Georgia",634,554,80,3073,13,78156
"Union City city, Georgia",13871,13229,642,26869,13,78324
"Union Point city, Georgia",626,621,5,1661,13,78380
"Unionville CDP, Georgia",802,710,92,2215,13,78464
"Uvalda city, Georgia",196,180,16,387,13,78744
"Valdosta city, Georgia",24794,23384,1410,55266,13,78800
"Varnell city, Georgia",1201,1145,56,2410,13,78996
"Vernonburg town, Georgia",49,47,2,116,13,79164
"Vidalia city, Georgia",4292,3975,317,10732,13,79388
"Vidette city, Georgia",99,88,11,191,13,79416
"Vienna city, Georgia",1179,996,183,2944,13,79444
"Villa Rica city, Georgia",9292,8885,407,17354,13,79528
"Vinings CDP, Georgia",9085,8890,195,12947,13,79612
"Waco city, Georgia",305,285,20,776,13,79808
"Wadley city, Georgia",704,633,71,2049,13,79864
"Waleska city, Georgia",361,312,49,764,13,79948
"Walnut Grove city, Georgia",975,944,31,1620,13,80228
"Walthourville city, Georgia",1632,1505,127,3719,13,80256
"Waresboro CDP, Georgia",191,170,21,463,13,80368
"Warm Springs city, Georgia",205,197,8,543,13,80480
"Warner Robins city, Georgia",39614,37047,2567,80374,13,80508
"Warrenton city, Georgia",747,669,78,1847,13,80592
"Warthen CDP, Georgia",46,46,0,158,13,80648
"Warwick city, Georgia",338,253,85,583,13,80676
"Washington city, Georgia",1704,1667,37,3742,13,80704
"Watkinsville city, Georgia",1696,1608,88,2998,13,80788
"Waverly CDP, Georgia",121,121,0,259,13,80816
"Waverly Hall town, Georgia",247,234,13,700,13,80844
"Waycross city, Georgia",4748,4441,307,13856,13,80956
"Waynesboro city, Georgia",2681,2552,129,5720,13,80984
"Waynesville CDP, Georgia",374,374,0,586,13,81012
"Webster County unified government, Georgia",1090,993,97,2354,13,81128
"Wenona CDP, Georgia",88,88,0,220,13,81208
"West Brow CDP, Georgia",611,564,47,1167,13,81488
"West Point city, Georgia",1424,1316,108,3508,13,82132
"Whigham city, Georgia",282,267,15,621,13,82412
"White city, Georgia",456,425,31,819,13,82468
"Whitemarsh Island CDP, Georgia",3351,3204,147,6790,13,82636
"White Plains city, Georgia",107,105,2,182,13,82692
"Whitesburg city, Georgia",343,317,26,659,13,82720
"Wildwood CDP, Georgia",265,144,121,559,13,82916
"Willacoochee city, Georgia",626,609,17,1452,13,82972
"Williamson city, Georgia",383,373,10,774,13,83084
"Wilmington Island CDP, Georgia",8027,7766,261,15235,13,83168
"Winder city, Georgia",9184,8650,534,18414,13,83420
"Winterville city, Georgia",1021,997,24,2165,13,83728
"Woodbine city, Georgia",433,380,53,1043,13,83868
"Woodbury city, Georgia",380,380,0,872,13,83896
"Woodland city, Georgia",99,89,10,296,13,83952
"Woodstock city, Georgia",20654,20068,586,35171,13,84176
"Woodville city, Georgia",84,78,6,261,13,84260
"Woolsey town, Georgia",101,99,2,231,13,84288
"Wrens city, Georgia",727,685,42,2063,13,84456
"Wrightsville city, Georgia",850,763,87,3471,13,84512
"Yatesville town, Georgia",190,188,2,358,13,84708
"Yonah CDP, Georgia",466,441,25,568,13,84832
"Young Harris city, Georgia",576,529,47,1066,13,84960
"Zebulon city, Georgia",661,608,53,1625,13,85128
"Ahuimanu CDP, Hawaii",4625,4539,86,9177,15,00400
"Aiea CDP, Hawaii",4669,4452,217,9571,15,00550
"Ainaloa CDP, Hawaii",1539,1389,150,3832,15,01085
"Anahola CDP, Hawaii",1186,1113,73,2853,15,02200
"Black Sands CDP, Hawaii",37,37,0,179,15,02832
"Captain Cook CDP, Hawaii",1981,1853,128,4135,15,03850
"Discovery Harbour CDP, Hawaii",459,395,64,1241,15,05900
"East Honolulu CDP, Hawaii",25107,24165,942,49491,15,06290
"East Kapolei CDP, Hawaii",2481,2407,74,5026,15,06300
"Eden Roc CDP, Hawaii",347,258,89,920,15,06325
"Eleele CDP, Hawaii",1184,1160,24,2255,15,07000
"Ewa Beach CDP, Hawaii",7878,7551,327,15167,15,07450
"Ewa Gentry CDP, Hawaii",14214,13721,493,27198,15,07470
"Ewa Villages CDP, Hawaii",3052,3013,39,6550,15,07485
"Fern Acres CDP, Hawaii",739,613,126,1781,15,07542
"Fern Forest CDP, Hawaii",286,280,6,824,15,07675
"Haena CDP, Hawaii",176,165,11,501,15,08950
"Haiku-Pauwela CDP, Hawaii",4849,4530,319,9245,15,09260
"Halaula CDP, Hawaii",360,342,18,959,15,09700
"Halawa CDP, Hawaii",7257,7020,237,14411,15,10000
"Haleiwa CDP, Hawaii",2484,2378,106,4708,15,10750
"Haliimaile CDP, Hawaii",461,418,43,1077,15,10900
"Hana CDP, Hawaii",406,337,69,731,15,11350
"Hanalei CDP, Hawaii",101,83,18,300,15,11500
"Hanamaulu CDP, Hawaii",2450,2289,161,4628,15,11650
"Hanapepe CDP, Hawaii",1348,1261,87,2242,15,11800
"Hauula CDP, Hawaii",1560,1452,108,3593,15,12400
"Hawaiian Acres CDP, Hawaii",1643,1554,89,3484,15,12450
"Hawaiian Beaches CDP, Hawaii",1318,1174,144,3879,15,12500
"Hawaiian Ocean View CDP, Hawaii",1391,1226,165,3587,15,12530
"Hawaiian Paradise Park CDP, Hawaii",6200,6093,107,13041,15,12600
"Hawi CDP, Hawaii",710,613,97,1383,15,13600
"Heeia CDP, Hawaii",2525,2472,53,4786,15,13900
"Helemano CDP, Hawaii",736,640,96,3334,15,13970
"Hickam Housing CDP, Hawaii",2289,2062,227,9502,15,14200
"Hilo CDP, Hawaii",22638,21094,1544,47627,15,14650
"Holualoa CDP, Hawaii",1445,1373,72,3083,15,15700
"Honalo CDP, Hawaii",542,526,16,981,15,16000
"Honaunau-Napoopoo CDP, Hawaii",1530,1370,160,2764,15,16160
"Honokaa CDP, Hawaii",1102,1050,52,2290,15,16450
"Honomu CDP, Hawaii",218,209,9,413,15,17450
"Iroquois Point CDP, Hawaii",2256,2054,202,5921,15,19100
"Kaaawa CDP, Hawaii",636,611,25,1259,15,19550
"Kaanapali CDP, Hawaii",457,359,98,1227,15,20000
"Kahaluu CDP, Hawaii",2641,2494,147,5065,15,21200
"Kahaluu-Keauhou CDP, Hawaii",3208,3051,157,7001,15,21230
"Kahuku CDP, Hawaii",1000,878,122,2274,15,22250
"Kahului CDP, Hawaii",13988,13334,654,27233,15,22700
"Kailua CDP (Hawaii County), Hawaii",11258,10847,411,21449,15,23000
"Kailua CDP (Honolulu County), Hawaii",19551,18898,653,40323,15,23150
"Kaiminani CDP, Hawaii",6317,6159,158,11731,15,23675
"Kalaeloa CDP, Hawaii",1366,1262,104,2971,15,24850
"Kalaheo CDP, Hawaii",2163,2091,72,4651,15,24950
"Kalapana CDP, Hawaii",17,6,11,56,15,25700
"Kalihiwai CDP, Hawaii",124,114,10,256,15,26750
"Kaloko CDP, Hawaii",807,708,99,1527,15,26867
"Kamaili CDP, Hawaii",40,40,0,156,15,27350
"Kaneohe CDP, Hawaii",17943,17142,801,35493,15,28250
"Kaneohe Base CDP, Hawaii",1910,1749,161,11683,15,28287
"Kapaa CDP, Hawaii",5943,5830,113,10846,15,28850
"Kapaau CDP, Hawaii",1100,1041,59,1972,15,29000
"Kapalua CDP, Hawaii",189,181,8,392,15,29725
"Kapolei CDP, Hawaii",11222,10588,634,22701,15,30300
"Kaumakani CDP, Hawaii",854,838,16,1498,15,30650
"Kaunakakai CDP, Hawaii",1411,1325,86,3553,15,31100
"Kawela Bay CDP, Hawaii",180,176,4,365,15,32700
"Keaau CDP, Hawaii",585,582,3,1290,15,32900
"Kealakekua CDP, Hawaii",1003,984,19,2188,15,33950
"Kekaha CDP, Hawaii",1405,1377,28,3149,15,35600
"Keokea CDP, Hawaii",1389,1268,121,2872,15,36050
"Kihei CDP, Hawaii",13010,12164,846,22247,15,36500
"Kilauea CDP, Hawaii",1731,1660,71,3386,15,36650
"Koloa CDP, Hawaii",1134,1026,108,2281,15,39200
"Ko Olina CDP, Hawaii",776,753,23,1871,15,39400
"Kualapuu CDP, Hawaii",825,778,47,2157,15,39500
"Kukuihaele CDP, Hawaii",170,142,28,380,15,41000
"Kula CDP, Hawaii",2958,2840,118,6578,15,41600
"Kurtistown CDP, Hawaii",1267,1166,101,2896,15,42800
"Lahaina CDP, Hawaii",7538,7109,429,12906,15,42950
"Laie CDP, Hawaii",3005,2736,269,5411,15,43250
"Lanai City CDP, Hawaii",1722,1680,42,3174,15,43700
"Launiupoko CDP, Hawaii",310,280,30,649,15,44075
"Laupahoehoe CDP, Hawaii",370,316,54,954,15,44150
"Lawai CDP, Hawaii",1278,1122,156,2902,15,44450
"Leilani Estates CDP, Hawaii",687,555,132,1611,15,44562
"Lihue CDP, Hawaii",4185,4139,46,8649,15,45200
"Maalaea CDP, Hawaii",92,77,15,214,15,46400
"Mahinahina CDP, Hawaii",676,648,28,1116,15,47050
"Maili CDP, Hawaii",5041,4403,638,12114,15,47300
"Makaha CDP, Hawaii",3707,3346,361,10042,15,47450
"Makaha Valley CDP, Hawaii",79,72,7,158,15,47560
"Makakilo CDP, Hawaii",10688,10087,601,21055,15,47600
"Makawao CDP, Hawaii",3760,3646,114,7704,15,48050
"Makena CDP, Hawaii",46,44,2,158,15,48350
"Manele CDP, Hawaii",11,11,0,44,15,49425
"Maunaloa CDP, Hawaii",127,124,3,279,15,50150
"Mauna Loa Estates CDP, Hawaii",441,389,52,812,15,50375
"Maunawili CDP, Hawaii",1115,1092,23,2067,15,50750
"Mililani Mauka CDP, Hawaii",11510,11279,231,21546,15,51000
"Mililani Town CDP, Hawaii",13813,13322,491,27423,15,51050
"Mokuleia CDP, Hawaii",895,863,32,1782,15,52550
"Mountain View CDP, Hawaii",1434,1317,117,3627,15,53300
"Naalehu CDP, Hawaii",294,281,13,890,15,53600
"Nanakuli CDP, Hawaii",5293,4707,586,12370,15,53900
"Nanawale Estates CDP, Hawaii",584,546,38,1666,15,53975
"Napili-Honokowai CDP, Hawaii",4295,3989,306,6779,15,54100
"Ocean Pointe CDP, Hawaii",7203,6994,209,16173,15,56685
"Olinda CDP, Hawaii",590,573,17,1018,15,57350
"Olowalu CDP, Hawaii",51,51,0,88,15,57650
"Omao CDP, Hawaii",711,656,55,1414,15,57800
"Orchidlands Estates CDP, Hawaii",867,767,100,2400,15,58775
"Paauilo CDP, Hawaii",286,246,40,548,15,59300
"Pahala CDP, Hawaii",751,604,147,1897,15,59750
"Pahoa CDP, Hawaii",591,540,51,1372,15,59900
"Paia CDP, Hawaii",1444,1258,186,2211,15,60200
"Pakala Village CDP, Hawaii",71,65,6,309,15,60350
"Papaikou CDP, Hawaii",573,541,32,1096,15,61550
"Paukaa CDP, Hawaii",258,253,5,561,15,61700
"Pearl City CDP, Hawaii",23005,22385,620,46812,15,62600
"Pepeekeo CDP, Hawaii",698,639,59,1462,15,63650
"Poipu CDP, Hawaii",519,507,12,1085,15,64550
"Princeville CDP, Hawaii",900,852,48,2007,15,65075
"Puako CDP, Hawaii",94,85,9,294,15,65150
"Puhi CDP, Hawaii",2397,2331,66,3961,15,65750
"Pukalani CDP, Hawaii",4547,4397,150,7930,15,65900
"Punaluu CDP, Hawaii",458,438,20,917,15,66500
"Pupukea CDP, Hawaii",2513,2357,156,5130,15,66800
"Royal Hawaiian Estates CDP, Hawaii",564,552,12,958,15,68807
"Royal Kunia CDP, Hawaii",7887,7386,501,13919,15,68815
"Schofield Barracks CDP, Hawaii",2521,2297,224,18133,15,69050
"Seaview CDP, Hawaii",54,43,11,230,15,69238
"Tiki Gardens CDP, Hawaii",81,13,68,324,15,70280
"Ualapue CDP, Hawaii",189,189,0,480,15,70700
"Urban Honolulu CDP, Hawaii",184019,174684,9335,348547,15,71550
"Volcano CDP, Hawaii",296,295,1,608,15,72350
"Volcano Golf Course CDP, Hawaii",405,405,0,996,15,72468
"Wahiawa CDP, Hawaii",8364,8061,303,17400,15,72650
"Waiahole-Waikane CDP, Hawaii",359,343,16,853,15,72957
"Waialua CDP, Hawaii",1568,1475,93,3053,15,74000
"Waianae CDP, Hawaii",5945,5368,577,13749,15,74450
"Waihee-Waiehu CDP, Hawaii",5257,5096,161,11029,15,75510
"Waikapu CDP, Hawaii",2027,1975,52,3887,15,75950
"Waikele CDP, Hawaii",4504,4481,23,7551,15,76250
"Waikoloa Beach Resort CDP, Hawaii",116,110,6,662,15,76584
"Waikoloa Village CDP, Hawaii",3789,3418,371,7418,15,76600
"Wailea CDP, Hawaii",3211,3025,186,6517,15,76925
"Wailua CDP, Hawaii",1181,1084,97,2438,15,77000
"Wailua Homesteads CDP, Hawaii",3571,3433,138,7189,15,77225
"Wailuku CDP, Hawaii",8315,8021,294,16590,15,77450
"Waimalu CDP, Hawaii",7654,7091,563,13932,15,77750
"Waimanalo CDP, Hawaii",2741,2626,115,5743,15,78050
"Waimanalo Beach CDP, Hawaii",2143,2041,102,4475,15,78200
"Waimea CDP (Hawaii County), Hawaii",5413,5102,311,10458,15,78500
"Waimea CDP (Kauai County), Hawaii",1075,1023,52,1951,15,78800
"Wainaku CDP, Hawaii",461,439,22,1023,15,78950
"Wainiha CDP, Hawaii",61,55,6,130,15,79250
"Waiohinu CDP, Hawaii",91,77,14,210,15,79550
"Waipahu CDP, Hawaii",19027,18108,919,39873,15,79700
"Waipio CDP, Hawaii",5746,5598,148,11138,15,79860
"Waipio Acres CDP, Hawaii",2647,2581,66,5393,15,80000
"West Loch Estate CDP, Hawaii",3214,3157,57,6469,15,80470
"Wheeler AFB CDP, Hawaii",509,465,44,2219,15,80600
"Whitmore Village CDP, Hawaii",1765,1703,62,3909,15,80900
"Aberdeen city, Idaho",1331,1208,123,2611,16,00100
"Acequia city, Idaho",73,60,13,187,16,00280
"Albion city, Idaho",163,147,16,375,16,01000
"American Falls city, Idaho",2194,2022,172,4573,16,01900
"Ammon city, Idaho",7824,7581,243,17921,16,01990
"Arbon Valley CDP, Idaho",362,317,45,784,16,02935
"Arco city, Idaho",253,253,0,749,16,03160
"Arimo city, Idaho",153,148,5,326,16,03340
"Ashton city, Idaho",706,644,62,1367,16,03610
"Athol city, Idaho",304,302,2,790,16,03700
"Atomic City city, Idaho",5,5,0,21,16,03970
"Avimor CDP, Idaho",602,540,62,1314,16,04105
"Bancroft city, Idaho",175,175,0,347,16,04420
"Banks CDP, Idaho",5,5,0,5,16,04600
"Basalt city, Idaho",217,213,4,430,16,05230
"Bellevue city, Idaho",1472,1435,37,2554,16,06220
"Bennington CDP, Idaho",59,59,0,142,16,06670
"Blackfoot city, Idaho",5490,5003,487,12349,16,07840
"Blanchard CDP, Idaho",28,28,0,438,16,08290
"Bliss city, Idaho",117,94,23,281,16,08470
"Bloomington city, Idaho",96,90,6,193,16,08560
"Boise City city, Idaho",133385,128339,5046,234192,16,08830
"Bonners Ferry city, Idaho",1181,1170,11,2558,16,09370
"Bovill city, Idaho",64,63,1,196,16,09730
"Bruneau CDP, Idaho",24,24,0,41,16,10450
"Buhl city, Idaho",2152,2065,87,4577,16,10810
"Burley city, Idaho",5707,5493,214,11506,16,11260
"Butte City city, Idaho",30,27,3,72,16,11710
"Caldwell city, Idaho",28013,26572,1441,61212,16,12250
"Cambridge city, Idaho",77,70,7,326,16,12520
"Carey city, Idaho",541,516,25,1244,16,12790
"Cascade city, Idaho",234,223,11,1197,16,13150
"Castleford city, Idaho",84,78,6,196,16,13240
"Challis city, Idaho",373,368,5,840,16,13780
"Chubbuck city, Idaho",7570,7271,299,15638,16,14680
"Clark Fork city, Idaho",495,431,64,963,16,14950
"Clayton city, Idaho",0,0,0,15,16,15490
"Clifton city, Idaho",382,373,9,735,16,16120
"Coeur d'Alene city, Idaho",27905,27348,557,54599,16,16750
"Conkling Park CDP, Idaho",23,23,0,130,16,17830
"Coolin CDP, Idaho",0,0,0,9,16,18010
"Cottonwood city, Idaho",523,466,57,1243,16,18640
"Council city, Idaho",182,153,29,655,16,18820
"Craigmont city, Idaho",237,226,11,501,16,19270
"Crouch city, Idaho",111,111,0,202,16,19720
"Culdesac city, Idaho",163,151,12,392,16,19900
"Dalton Gardens city, Idaho",1100,1074,26,2510,16,20350
"Dayton city, Idaho",232,218,14,505,16,20710
"Deary city, Idaho",278,277,1,501,16,20890
"Declo city, Idaho",243,236,7,498,16,20980
"De Smet CDP, Idaho",35,35,0,122,16,21520
"Dietrich city, Idaho",133,128,5,294,16,21790
"Donnelly city, Idaho",39,38,1,215,16,22330
"Dover city, Idaho",243,238,5,720,16,22510
"Downey city, Idaho",356,354,2,806,16,22600
"Driggs city, Idaho",1538,1528,10,2548,16,22690
"Drummond city, Idaho",0,0,0,3,16,22780
"Dubois city, Idaho",290,287,3,530,16,22960
"Eagle city, Idaho",13889,13676,213,30635,16,23410
"East Hope city, Idaho",93,93,0,222,16,23680
"Eden city, Idaho",133,127,6,396,16,24310
"Elk City CDP, Idaho",71,55,16,253,16,25030
"Elk River city, Idaho",65,65,0,164,16,25120
"Emmett city, Idaho",3360,3350,10,7694,16,25570
"Fairfield city, Idaho",205,179,26,463,16,26290
"Ferdinand city, Idaho",100,96,4,179,16,27460
"Fernan Lake Village city, Idaho",56,54,2,135,16,27550
"Fernwood CDP, Idaho",45,45,0,146,16,27640
"Filer city, Idaho",1051,1016,35,2766,16,27730
"Firth city, Idaho",201,201,0,516,16,27910
"Fort Hall CDP, Idaho",1117,980,137,2608,16,28360
"Franklin city, Idaho",444,443,1,856,16,28810
"Fruitland city, Idaho",2758,2676,82,6169,16,28990
"Gannett CDP, Idaho",264,264,0,316,16,29440
"Garden City city, Idaho",6030,5819,211,12301,16,29620
"Garden Valley CDP, Idaho",269,269,0,409,16,29710
"Genesee city, Idaho",560,546,14,1209,16,30160
"Georgetown city, Idaho",363,343,20,757,16,30340
"Glenns Ferry city, Idaho",547,534,13,1327,16,31690
"Gooding city, Idaho",1732,1554,178,3673,16,32140
"Grace city, Idaho",705,687,18,1413,16,32500
"Grand View city, Idaho",216,197,19,485,16,32770
"Grangeville city, Idaho",1762,1701,61,3369,16,32950
"Greenleaf city, Idaho",519,488,31,995,16,33490
"Groveland CDP, Idaho",452,434,18,1190,16,34030
"Hagerman city, Idaho",492,482,10,1198,16,34300
"Hailey city, Idaho",5390,5218,172,9238,16,34390
"Hamer city, Idaho",17,17,0,38,16,34570
"Hammett CDP, Idaho",94,92,2,253,16,34750
"Hansen city, Idaho",546,543,3,1462,16,34930
"Harrison city, Idaho",109,98,11,277,16,35200
"Hauser city, Idaho",542,522,20,935,16,35830
"Hayden city, Idaho",7597,7318,279,15703,16,36370
"Hayden Lake city, Idaho",298,291,7,770,16,36460
"Hazelton city, Idaho",573,532,41,1094,16,36730
"Heyburn city, Idaho",1862,1785,77,3640,16,37360
"Hidden Springs CDP, Idaho",1577,1551,26,3584,16,37500
"Hollister city, Idaho",203,184,19,376,16,38080
"Homedale city, Idaho",1415,1358,57,2926,16,38170
"Hope city, Idaho",36,29,7,96,16,38440
"Horseshoe Bend city, Idaho",384,380,4,794,16,38620
"Huetter city, Idaho",92,92,0,161,16,39070
"Idaho City city, Idaho",315,296,19,673,16,39610
"Idaho Falls city, Idaho",31851,30317,1534,65685,16,39700
"Inkom city, Idaho",408,393,15,954,16,40330
"Iona city, Idaho",1122,1101,21,2746,16,40420
"Irwin city, Idaho",63,63,0,196,16,40510
"Island Park city, Idaho",60,60,0,144,16,40600
"Jerome city, Idaho",6003,5789,214,12482,16,41320
"Juliaetta city, Idaho",277,277,0,585,16,42130
"Kamiah city, Idaho",460,432,28,1210,16,42400
"Kellogg city, Idaho",1020,872,148,2294,16,42580
"Kendrick city, Idaho",130,122,8,313,16,42760
"Ketchum city, Idaho",2322,2300,22,3490,16,43030
"Kimberly city, Idaho",2224,2211,13,4696,16,43570
"Kooskia city, Idaho",157,150,7,608,16,44110
"Kootenai city, Idaho",618,589,29,1152,16,44200
"Kuna city, Idaho",12431,12165,266,24845,16,44290
"Laclede CDP, Idaho",156,156,0,291,16,44560
"Lapwai city, Idaho",509,460,49,1310,16,45370
"Lava Hot Springs city, Idaho",173,161,12,293,16,45820
"Leadore city, Idaho",58,58,0,132,16,45910
"Letha CDP, Idaho",432,432,0,572,16,46450
"Lewiston city, Idaho",16924,16381,543,34270,16,46540
"Lewisville city, Idaho",200,186,14,451,16,46720
"Lincoln CDP, Idaho",1769,1668,101,3638,16,47080
"Lost River city, Idaho",0,0,0,10,16,47890
"Lowman CDP, Idaho",14,14,0,22,16,48250
"McCall city, Idaho",2034,2001,33,3731,16,48790
"McCammon city, Idaho",487,462,25,1017,16,48880
"Mackay city, Idaho",113,113,0,587,16,49240
"Malad City city, Idaho",990,986,4,2219,16,50140
"Malta city, Idaho",88,88,0,294,16,50230
"Marsing city, Idaho",526,515,11,1244,16,50950
"Melba city, Idaho",242,239,3,602,16,51850
"Menan city, Idaho",318,301,17,759,16,52030
"Meridian city, Idaho",63547,61821,1726,119872,16,52120
"Middleton city, Idaho",4559,4445,114,9614,16,52660
"Midvale city, Idaho",86,81,5,273,16,52750
"Minidoka city, Idaho",63,50,13,175,16,53110
"Montpelier city, Idaho",1211,1122,89,2649,16,53920
"Moore city, Idaho",61,61,0,211,16,54100
"Moreland CDP, Idaho",514,514,0,1343,16,54370
"Moscow city, Idaho",13993,13097,896,25616,16,54550
"Mountain Home city, Idaho",5774,5429,345,16026,16,54730
"Mountain Home AFB CDP, Idaho",461,417,44,3184,16,54820
"Moyie Springs city, Idaho",431,404,27,1293,16,55270
"Mud Lake city, Idaho",201,191,10,468,16,55450
"Mullan city, Idaho",259,249,10,692,16,55630
"Murphy CDP, Idaho",116,116,0,172,16,55720
"Murtaugh city, Idaho",98,94,4,154,16,55900
"Nampa city, Idaho",51434,49881,1553,102598,16,56260
"Newdale city, Idaho",256,254,2,493,16,56800
"New Meadows city, Idaho",153,147,6,293,16,56890
"New Plymouth city, Idaho",726,668,58,1645,16,56980
"Nezperce city, Idaho",165,158,7,518,16,57250
"Notus city, Idaho",357,331,26,633,16,58060
"Oakley city, Idaho",299,294,5,795,16,58330
"Oldtown city, Idaho",227,193,34,480,16,58600
"Onaway city, Idaho",106,87,19,223,16,58870
"Orofino city, Idaho",1226,1181,45,3251,16,59320
"Osburn city, Idaho",783,754,29,1625,16,59590
"Oxford city, Idaho",12,12,0,38,16,60040
"Paris city, Idaho",248,240,8,727,16,60580
"Parker city, Idaho",326,291,35,661,16,60760
"Parkline CDP, Idaho",27,27,0,45,16,60880
"Parma city, Idaho",811,753,58,1937,16,60940
"Paul city, Idaho",638,628,10,1334,16,61210
"Payette city, Idaho",3505,3253,252,8182,16,61300
"Peck city, Idaho",69,69,0,165,16,61840
"Pierce city, Idaho",155,151,4,388,16,62740
"Pinehurst city, Idaho",859,825,34,1993,16,63100
"Placerville city, Idaho",8,7,1,41,16,63550
"Plummer city, Idaho",564,540,24,1158,16,63910
"Pocatello city, Idaho",27402,25916,1486,56582,16,64090
"Ponderay city, Idaho",618,581,37,1208,16,64450
"Post Falls city, Idaho",19104,18471,633,40002,16,64810
"Potlatch city, Idaho",427,387,40,876,16,64900
"Preston city, Idaho",2452,2438,14,5668,16,65260
"Priest River city, Idaho",871,862,9,2170,16,65530
"Princeton CDP, Idaho",111,111,0,149,16,65620
"Rathdrum city, Idaho",5231,4988,243,9556,16,66340
"Reubens city, Idaho",34,34,0,72,16,67150
"Rexburg city, Idaho",22688,20922,1766,38803,16,67420
"Richfield city, Idaho",253,227,26,509,16,67600
"Rigby city, Idaho",2272,2221,51,5097,16,67780
"Riggins city, Idaho",86,75,11,258,16,67870
"Ririe city, Idaho",435,435,0,802,16,67960
"Riverside CDP, Idaho",582,582,0,1074,16,68230
"Roberts city, Idaho",226,204,22,461,16,68500
"Robie Creek CDP, Idaho",581,581,0,1237,16,68545
"Rockford CDP, Idaho",61,61,0,199,16,68860
"Rockford Bay CDP, Idaho",96,85,11,306,16,68950
"Rockland city, Idaho",57,57,0,151,16,69130
"Rupert city, Idaho",2935,2849,86,6066,16,70660
"St. Anthony city, Idaho",1451,1334,117,3730,16,71020
"St. Charles city, Idaho",69,69,0,123,16,71110
"St. Maries city, Idaho",1034,979,55,2410,16,71470
"Salmon city, Idaho",1445,1356,89,3147,16,71650
"Sandpoint city, Idaho",4330,4215,115,8899,16,72100
"Shelley city, Idaho",2674,2423,251,4878,16,73450
"Shoshone city, Idaho",851,778,73,1687,16,73900
"Silverton CDP, Idaho",171,162,9,576,16,74440
"Smelterville city, Idaho",386,386,0,728,16,75070
"Smiths Ferry CDP, Idaho",7,7,0,82,16,75160
"Soda Springs city, Idaho",1515,1477,38,3124,16,75195
"Spencer city, Idaho",17,13,4,23,16,75970
"Spirit Lake city, Idaho",1112,1070,42,2375,16,76060
"Stanley city, Idaho",221,221,0,225,16,76780
"Star city, Idaho",6161,5712,449,11971,16,76870
"State Line city, Idaho",16,16,0,16,16,77050
"Stites city, Idaho",52,52,0,163,16,77500
"Sugar City city, Idaho",993,949,44,2055,16,78040
"Sun Valley city, Idaho",868,868,0,1383,16,78850
"Swan Valley city, Idaho",118,111,7,255,16,79120
"Sweetwater CDP, Idaho",87,87,0,172,16,79300
"Tensed city, Idaho",26,24,2,72,16,80200
"Teton city, Idaho",394,375,19,909,16,80380
"Tetonia city, Idaho",224,224,0,389,16,80470
"Troy city, Idaho",474,451,23,945,16,82360
"Twin Falls city, Idaho",25723,24926,797,52315,16,82810
"Tyhee CDP, Idaho",633,572,61,1469,16,83170
"Ucon city, Idaho",866,822,44,1631,16,83350
"Victor city, Idaho",1746,1746,0,2876,16,84250
"Viola CDP, Idaho",22,22,0,57,16,84430
"Wallace city, Idaho",459,443,16,1083,16,84790
"Wardner city, Idaho",181,169,12,330,16,85240
"Warm River city, Idaho",0,0,0,0,16,85420
"Weippe city, Idaho",114,114,0,369,16,86050
"Weiser city, Idaho",2243,2113,130,5678,16,86140
"Wendell city, Idaho",1353,1324,29,2900,16,86320
"Weston city, Idaho",216,201,15,527,16,87040
"White Bird city, Idaho",10,10,0,50,16,87310
"Wilder city, Idaho",769,764,5,1672,16,87670
"Winchester city, Idaho",104,98,6,263,16,87850
"Worley city, Idaho",123,115,8,258,16,88480
"Yellow Pine CDP, Idaho",99,99,0,327,16,88660
"Abingdon city, Illinois",1691,1562,129,3399,17,00113
"Adair CDP, Illinois",181,181,0,247,17,00178
"Adams CDP, Illinois",39,39,0,39,17,00191
"Addieville village, Illinois",190,186,4,286,17,00230
"Addison village, Illinois",20797,19960,837,35685,17,00243
"Adeline village, Illinois",44,44,0,83,17,00295
"Albany village, Illinois",309,288,21,691,17,00516
"Albers village, Illinois",825,803,22,1448,17,00555
"Albion city, Illinois",1008,889,119,2136,17,00568
"Alden CDP, Illinois",34,34,0,168,17,00594
"Aledo city, Illinois",2100,2065,35,3808,17,00646
"Alexander CDP, Illinois",153,153,0,272,17,00659
"Alexis village, Illinois",368,348,20,715,17,00672
"Algonquin village, Illinois",18313,17461,852,29888,17,00685
"Alhambra village, Illinois",292,269,23,622,17,00737
"Allendale village, Illinois",279,221,58,521,17,00815
"Allenville village, Illinois",45,44,1,95,17,00867
"Allerton village, Illinois",96,92,4,183,17,00880
"Alma village, Illinois",139,132,7,330,17,00919
"Alpha village, Illinois",366,359,7,792,17,00971
"Alsey village, Illinois",68,64,4,164,17,00997
"Alsip village, Illinois",9823,9164,659,18866,17,01010
"Altamont city, Illinois",1027,1005,22,2231,17,01049
"Alton city, Illinois",12130,11327,803,25642,17,01114
"Altona village, Illinois",308,252,56,562,17,01140
"Alto Pass village, Illinois",185,176,9,381,17,01205
"Alvan (Alvin) village, Illinois",87,87,0,172,17,01242
"Amboy city, Illinois",1331,1256,75,2413,17,01270
"Anchor village, Illinois",96,96,0,249,17,01361
"Andalusia village, Illinois",590,566,24,1065,17,01426
"Andover village, Illinois",212,205,7,434,17,01491
"Andres CDP, Illinois",31,22,9,41,17,01517
"Anna city, Illinois",1714,1571,143,4259,17,01543
"Annapolis CDP, Illinois",26,20,6,57,17,01556
"Annawan town, Illinois",420,395,25,790,17,01569
"Antioch village, Illinois",8135,7566,569,14714,17,01595
"Apple Canyon Lake CDP, Illinois",229,229,0,704,17,01647
"Apple River village, Illinois",170,167,3,350,17,01673
"Arbury Hills CDP, Illinois",998,987,11,1435,17,01803
"Arcola city, Illinois",1421,1356,65,2726,17,01881
"Arenzville village, Illinois",160,160,0,326,17,01946
"Argenta village, Illinois",425,412,13,900,17,01972
"Argyle CDP, Illinois",399,377,22,576,17,02050
"Arlington village, Illinois",93,81,12,202,17,02102
"Arlington Heights village, Illinois",41206,39770,1436,76794,17,02154
"Armington village, Illinois",151,144,7,386,17,02206
"Aroma Park village, Illinois",354,341,13,679,17,02258
"Arrowsmith village, Illinois",148,132,16,398,17,02342
"Arthur village, Illinois",936,881,55,1992,17,02414
"Ashkum village, Illinois",469,456,13,828,17,02479
"Ashland village, Illinois",640,620,20,1171,17,02505
"Ashley city, Illinois",153,144,9,411,17,02531
"Ashmore village, Illinois",407,352,55,764,17,02557
"Ashton village, Illinois",393,348,45,808,17,02583
"Assumption city, Illinois",547,524,23,1024,17,02609
"Astoria town, Illinois",551,525,26,1126,17,02635
"Athens city, Illinois",1308,1215,93,2398,17,02674
"Atkinson town, Illinois",578,530,48,1067,17,02726
"Atlanta city, Illinois",916,874,42,1996,17,02752
"Atwood village, Illinois",419,409,10,979,17,02882
"Auburn city, Illinois",2203,2186,17,4535,17,02921
"Augusta village, Illinois",313,288,25,690,17,02986
"Aurora city, Illinois",101132,95497,5635,181405,17,03012
"Ava city, Illinois",250,244,6,557,17,03103
"Aviston village, Illinois",1252,1241,11,2342,17,03181
"Avon village, Illinois",362,349,13,627,17,03207
"Baileyville CDP, Illinois",65,65,0,137,17,03337
"Baldwin village, Illinois",158,126,32,369,17,03454
"Banner village, Illinois",61,57,4,152,17,03571
"Bannockburn village, Illinois",552,540,12,1065,17,03610
"Bardolph village, Illinois",134,123,11,247,17,03675
"Barrington village, Illinois",4963,4771,192,11244,17,03844
"Barrington Hills village, Illinois",1752,1696,56,3890,17,03883
"Barry city, Illinois",720,684,36,1531,17,03948
"Barstow CDP, Illinois",43,36,7,65,17,03987
"Bartelso village, Illinois",483,479,4,822,17,04000
"Bartlett village, Illinois",23344,22831,513,40829,17,04013
"Bartonville village, Illinois",3179,3101,78,5952,17,04039
"Basco village, Illinois",49,42,7,85,17,04052
"Batavia city, Illinois",14462,13934,528,26355,17,04078
"Batchtown village, Illinois",79,79,0,195,17,04117
"Bath village, Illinois",94,88,6,216,17,04156
"Baylis village, Illinois",67,65,2,144,17,04247
"Bay View Gardens village, Illinois",143,139,4,342,17,04273
"Beach Park village, Illinois",6897,6386,511,13995,17,04303
"Beardstown city, Illinois",2778,2547,231,5884,17,04351
"Beason CDP, Illinois",112,112,0,157,17,04403
"Beaverville village, Illinois",164,152,12,346,17,04507
"Beckemeyer village, Illinois",461,422,39,1042,17,04533
"Bedford Park village, Illinois",290,275,15,619,17,04572
"Beecher village, Illinois",2413,2373,40,4560,17,04585
"Beecher City village, Illinois",199,194,5,431,17,04598
"Belgium village, Illinois",143,135,8,286,17,04689
"Belknap village, Illinois",72,68,4,138,17,04715
"Belle Prairie City town, Illinois",26,26,0,56,17,04793
"Belle Rive village, Illinois",185,179,6,324,17,04806
"Belleville city, Illinois",21844,20536,1308,42155,17,04845
"Bellevue village, Illinois",1100,1024,76,2300,17,04871
"Bellflower village, Illinois",181,172,9,379,17,04897
"Bellmont village, Illinois",72,65,7,225,17,04936
"Bellwood village, Illinois",9310,8549,761,18611,17,04975
"Belvidere city, Illinois",13593,12827,766,25389,17,05092
"Bement village, Illinois",961,926,35,1549,17,05144
"Benld city, Illinois",694,658,36,1531,17,05209
"Bensenville village, Illinois",10544,10106,438,18673,17,05248
"Benson village, Illinois",262,257,5,446,17,05261
"Bentley town, Illinois",8,8,0,16,17,05274
"Benton city, Illinois",3007,2853,154,6999,17,05300
"Berkeley village, Illinois",2770,2616,154,5283,17,05404
"Berlin village, Illinois",66,66,0,108,17,05443
"Berwyn city, Illinois",30272,28751,1521,56556,17,05573
"Bethalto village, Illinois",4705,4485,220,9281,17,05599
"Bethany village, Illinois",586,583,3,1227,17,05612
"Beverly CDP, Illinois",12,12,0,70,17,05729
"Big Foot Prairie CDP, Illinois",0,0,0,0,17,05859
"Biggsville village, Illinois",187,181,6,311,17,05898
"Big Rock village, Illinois",628,603,25,1221,17,05976
"Bingham village, Illinois",57,57,0,141,17,06028
"Bishop Hill village, Illinois",78,78,0,151,17,06171
"Bismarck village, Illinois",262,244,18,591,17,06184
"Blairsville CDP, Illinois",190,190,0,280,17,06444
"Blandinsville village, Illinois",295,288,7,636,17,06470
"Bloomfield CDP, Illinois",37,37,0,98,17,06565
"Bloomingdale village, Illinois",11987,11518,469,22435,17,06587
"Bloomington city, Illinois",40884,39540,1344,78788,17,06613
"Blue Island city, Illinois",12154,10409,1745,22934,17,06704
"Blue Mound village, Illinois",440,435,5,934,17,06756
"Bluffs village, Illinois",356,354,2,704,17,06899
"Bluford village, Illinois",308,287,21,555,17,06964
"Bolingbrook village, Illinois",41771,39593,2178,73755,17,07133
"Bondville village, Illinois",169,165,4,343,17,07211
"Bone Gap village, Illinois",82,64,18,198,17,07224
"Bonfield village, Illinois",271,255,16,480,17,07237
"Bonnie village, Illinois",217,207,10,403,17,07263
"Bonnie Brae CDP, Illinois",633,596,37,1070,17,07276
"Boody CDP, Illinois",221,201,20,411,17,07315
"Boulder Hill CDP, Illinois",5314,4974,340,9547,17,07419
"Bourbonnais village, Illinois",9157,8666,491,18125,17,07471
"Bowen village, Illinois",332,328,4,710,17,07510
"Braceville village, Illinois",338,327,11,733,17,07640
"Bradford village, Illinois",353,346,7,764,17,07692
"Bradley village, Illinois",8446,8080,366,15379,17,07744
"Braidwood city, Illinois",3187,3077,110,6160,17,07770
"Breese city, Illinois",2382,2294,88,4376,17,07913
"Bridgeport city, Illinois",913,830,83,2030,17,08186
"Bridgeview village, Illinois",8200,7503,697,16939,17,08225
"Brighton village, Illinois",1141,1111,30,2440,17,08264
"Brimfield village, Illinois",332,323,9,695,17,08303
"Broadlands village, Illinois",146,139,7,295,17,08420
"Broadview village, Illinois",4023,3687,336,7957,17,08446
"Broadwell village, Illinois",62,49,13,120,17,08472
"Brocton village, Illinois",132,128,4,280,17,08524
"Brookfield village, Illinois",10796,10500,296,19349,17,08576
"Brooklyn village, Illinois",307,270,37,629,17,08667
"Brookport city, Illinois",333,318,15,752,17,08706
"Broughton village, Illinois",58,51,7,156,17,08875
"Browning village, Illinois",46,43,3,99,17,08953
"Browns village, Illinois",108,108,0,235,17,08979
"Brownstown village, Illinois",309,285,24,749,17,08992
"Brussels village, Illinois",64,62,2,111,17,09148
"Bryant village, Illinois",101,85,16,225,17,09161
"Buckingham village, Illinois",122,119,3,235,17,09304
"Buckley village, Illinois",200,196,4,477,17,09317
"Buckner village, Illinois",133,121,12,280,17,09330
"Buda village, Illinois",257,239,18,529,17,09356
"Buffalo village, Illinois",196,195,1,397,17,09434
"Buffalo Grove village, Illinois",23654,22864,790,42934,17,09447
"Buffalo Prairie CDP, Illinois",0,0,0,0,17,09499
"Bull Valley village, Illinois",605,574,31,1248,17,09531
"Bulpitt village, Illinois",127,123,4,238,17,09538
"Buncombe village, Illinois",126,116,10,391,17,09551
"Bunker Hill city, Illinois",707,663,44,1393,17,09577
"Burbank city, Illinois",14516,13394,1122,29122,17,09642
"Bureau Junction village, Illinois",153,146,7,248,17,09681
"Burlington village, Illinois",226,222,4,429,17,09759
"Burnham village, Illinois",2139,1875,264,4028,17,09798
"Burnt Prairie village, Illinois",58,58,0,97,17,09889
"Burr Ridge village, Illinois",5401,5215,186,11131,17,09980
"Burton CDP, Illinois",49,49,0,111,17,10006
"Burtons Bridge CDP, Illinois",102,83,19,211,17,10045
"Bush village, Illinois",167,163,4,324,17,10084
"Bushnell city, Illinois",1467,1391,76,2850,17,10110
"Butler village, Illinois",184,182,2,350,17,10149
"Byron city, Illinois",1967,1903,64,3739,17,10240
"Cabery village, Illinois",97,88,9,242,17,10292
"Cable CDP, Illinois",40,40,0,105,17,10305
"Cahokia Heights city, Illinois",6947,6160,787,17753,17,10373
"Cairo city, Illinois",593,497,96,1510,17,10383
"Caledonia village, Illinois",163,162,1,241,17,10422
"Calhoun village, Illinois",111,97,14,170,17,10448
"Calumet City city, Illinois",17968,16334,1634,35708,17,10487
"Calumet Park village, Illinois",3242,2767,475,7193,17,10513
"Camargo village, Illinois",268,265,3,540,17,10591
"Cambria village, Illinois",618,584,34,1231,17,10630
"Cambridge village, Illinois",1350,1284,66,2251,17,10643
"Camden village, Illinois",25,23,2,83,17,10695
"Cameron CDP, Illinois",215,215,0,331,17,10747
"Campbell Hill village, Illinois",139,126,13,291,17,10773
"Campbell's Island CDP, Illinois",297,297,0,417,17,10786
"Camp Point village, Illinois",644,628,16,1399,17,10877
"Campton Hills village, Illinois",5795,5451,344,10556,17,10906
"Campus village, Illinois",72,68,4,156,17,10916
"Candlewick Lake CDP, Illinois",2559,2477,82,5080,17,10936
"Canton city, Illinois",5936,5527,409,13380,17,11007
"Cantrall village, Illinois",85,83,2,139,17,11033
"Capron village, Illinois",809,743,66,1363,17,11124
"Carbon Cliff village, Illinois",888,816,72,2012,17,11150
"Carbondale city, Illinois",11041,9979,1062,22039,17,11163
"Carbon Hill village, Illinois",220,202,18,437,17,11176
"Carlinville city, Illinois",2557,2534,23,5724,17,11202
"Carlock village, Illinois",366,356,10,585,17,11215
"Carlyle city, Illinois",1905,1813,92,3252,17,11228
"Carman CDP, Illinois",136,111,25,195,17,11267
"Carmi city, Illinois",2084,2044,40,5042,17,11293
"Carol Stream village, Illinois",22665,21618,1047,39656,17,11332
"Carpentersville village, Illinois",21098,19672,1426,37834,17,11358
"Carrier Mills village, Illinois",796,729,67,1759,17,11397
"Carrollton city, Illinois",1280,1258,22,2546,17,11462
"Carterville city, Illinois",2559,2491,68,5836,17,11514
"Carthage city, Illinois",1513,1493,20,2560,17,11527
"Cary village, Illinois",10623,10093,530,17880,17,11592
"Casey city, Illinois",1116,1047,69,2294,17,11618
"Caseyville village, Illinois",1677,1605,72,3893,17,11644
"Catlin village, Illinois",1189,1189,0,2091,17,11774
"Cave-In-Rock village, Illinois",76,76,0,197,17,11826
"Cedar Point village, Illinois",125,119,6,200,17,11982
"Cedarville village, Illinois",322,311,11,621,17,12008
"Central City village, Illinois",502,486,16,1154,17,12151
"Centralia city, Illinois",5231,4581,650,12096,17,12164
"Cerro Gordo village, Illinois",673,594,79,1411,17,12268
"Chadwick village, Illinois",325,318,7,552,17,12294
"Champaign city, Illinois",45620,43433,2187,88628,17,12385
"Chandlerville village, Illinois",281,241,40,605,17,12450
"Channahon village, Illinois",7435,6843,592,13807,17,12476
"Channel Lake CDP, Illinois",778,768,10,1784,17,12489
"Chapin village, Illinois",289,278,11,567,17,12528
"Charleston city, Illinois",10423,9742,681,17795,17,12567
"Chatham village, Illinois",7312,7076,236,14437,17,12684
"Chatsworth town, Illinois",644,607,37,1296,17,12710
"Chebanse village, Illinois",590,583,7,1046,17,12801
"Chemung CDP, Illinois",43,40,3,386,17,12879
"Chenoa city, Illinois",743,718,25,1552,17,12931
"Cherry village, Illinois",182,180,2,460,17,12970
"Cherry Valley village, Illinois",1432,1397,35,2951,17,13074
"Chester city, Illinois",2172,2091,81,6941,17,13139
"Chesterfield village, Illinois",100,85,15,202,17,13165
"Chestnut CDP, Illinois",80,80,0,171,17,13230
"Chicago city, Illinois",1504459,1381118,123341,2721914,17,14000
"Chicago Heights city, Illinois",12650,10901,1749,27366,17,14026
"Chicago Ridge village, Illinois",7152,6840,312,14284,17,14065
"Chillicothe city, Illinois",2628,2450,178,6130,17,14117
"Chrisman city, Illinois",580,497,83,1457,17,14273
"Christopher city, Illinois",1023,947,76,2507,17,14286
"Cicero town, Illinois",41223,39602,1621,84189,17,14351
"Cisco village, Illinois",130,116,14,277,17,14442
"Cisne village, Illinois",296,275,21,545,17,14455
"Cissna Park village, Illinois",342,341,1,882,17,14468
"Claremont village, Illinois",94,78,16,159,17,14533
"Clarendon Hills village, Illinois",4173,4055,118,8658,17,14572
"Clay City village, Illinois",388,364,24,883,17,14715
"Clayton village, Illinois",276,273,3,564,17,14767
"Clear Lake village, Illinois",177,139,38,316,17,14845
"Cleveland village, Illinois",80,79,1,170,17,14923
"Clifton village, Illinois",710,692,18,1293,17,14936
"Clinton city, Illinois",3501,3301,200,6889,17,15001
"Coal City village, Illinois",2645,2542,103,5218,17,15170
"Coalton village, Illinois",162,153,9,343,17,15209
"Coal Valley village, Illinois",1893,1829,64,3959,17,15235
"Coatsburg village, Illinois",128,128,0,198,17,15261
"Cobden village, Illinois",391,367,24,1023,17,15300
"Coffeen city, Illinois",253,240,13,610,17,15352
"Colchester city, Illinois",636,609,27,1120,17,15378
"Coleta village, Illinois",88,86,2,202,17,15469
"Colfax village, Illinois",527,492,35,1017,17,15495
"Collinsville city, Illinois",13614,12987,627,24294,17,15599
"Colona city, Illinois",3216,3107,109,5404,17,15664
"Colp village, Illinois",81,77,4,234,17,15807
"Columbia city, Illinois",6179,6141,38,11036,17,15833
"Columbus village, Illinois",54,54,0,106,17,15846
"Como CDP, Illinois",286,267,19,601,17,15950
"Compton village, Illinois",114,111,3,247,17,15989
"Concord village, Illinois",45,44,1,156,17,16054
"Congerville village, Illinois",341,339,2,710,17,16119
"Cooksville village, Illinois",85,85,0,148,17,16210
"Coral CDP, Illinois",0,0,0,0,17,16301
"Cordova village, Illinois",355,338,17,651,17,16366
"Cornell village, Illinois",213,210,3,439,17,16405
"Cornland CDP, Illinois",40,40,0,46,17,16431
"Cortland town, Illinois",2947,2790,157,4734,17,16470
"Coulterville village, Illinois",314,263,51,759,17,16613
"Country Club Hills city, Illinois",8190,7504,686,16578,17,16691
"Countryside city, Illinois",3831,3531,300,6322,17,16873
"Cowden village, Illinois",182,174,8,492,17,17055
"Coyne Center CDP, Illinois",401,394,7,948,17,17077
"Crab Orchard CDP, Illinois",153,153,0,259,17,17094
"Crainville village, Illinois",806,763,43,1439,17,17185
"Creal Springs city, Illinois",172,154,18,425,17,17289
"Crescent City village, Illinois",246,220,26,489,17,17406
"Crest Hill city, Illinois",9631,9045,586,19886,17,17458
"Creston village, Illinois",292,279,13,554,17,17471
"Crestwood village, Illinois",5473,5187,286,10737,17,17497
"Crete village, Illinois",4468,4102,366,8425,17,17523
"Creve Coeur village, Illinois",2361,2285,76,4695,17,17549
"Crossville village, Illinois",354,330,24,745,17,17783
"Crystal Lake city, Illinois",22609,21499,1110,40463,17,17887
"Crystal Lawns CDP, Illinois",1237,1183,54,1848,17,17939
"Cuba city, Illinois",436,418,18,903,17,17991
"Cullom village, Illinois",231,225,6,495,17,18030
"Curran village, Illinois",93,88,5,171,17,18147
"Custer Park CDP, Illinois",219,219,0,444,17,18212
"Cutler village, Illinois",134,132,2,315,17,18225
"Cypress village, Illinois",88,88,0,223,17,18251
"Dahlgren village, Illinois",241,204,37,641,17,18303
"Dakota village, Illinois",265,256,9,597,17,18342
"Dallas City city, Illinois",394,363,31,846,17,18420
"Dalton City village, Illinois",385,372,13,674,17,18446
"Dalzell village, Illinois",350,327,23,682,17,18459
"Damiansville village, Illinois",322,317,5,529,17,18472
"Dana village, Illinois",78,55,23,166,17,18485
"Danforth village, Illinois",201,194,7,548,17,18498
"Danvers village, Illinois",499,476,23,1039,17,18537
"Danville city, Illinois",11443,10388,1055,29100,17,18563
"Darien city, Illinois",12356,11846,510,21953,17,18628
"Darmstadt CDP, Illinois",0,0,0,0,17,18641
"Davis village, Illinois",236,228,8,442,17,18706
"Davis Junction village, Illinois",1422,1324,98,2697,17,18719
"Dawson village, Illinois",375,357,18,669,17,18745
"Dayton CDP, Illinois",245,242,3,498,17,18771
"Decatur city, Illinois",32707,29805,2902,70975,17,18823
"Deer Creek village, Illinois",335,329,6,586,17,18940
"Deerfield village, Illinois",10437,10191,246,19173,17,18992
"Deer Grove village, Illinois",33,27,6,49,17,19031
"Deer Park village, Illinois",1684,1645,39,3694,17,19083
"DeKalb city, Illinois",22813,20378,2435,40697,17,19161
"De Land village, Illinois",231,222,9,477,17,19200
"Delavan city, Illinois",704,649,55,1708,17,19226
"De Pue village, Illinois",868,831,37,1640,17,19499
"De Soto village, Illinois",906,835,71,1684,17,19616
"Des Plaines city, Illinois",32121,30633,1488,60087,17,19642
"Detroit village, Illinois",13,13,0,27,17,19681
"Dewey CDP, Illinois",84,72,12,127,17,19746
"De Witt village, Illinois",88,83,5,187,17,19798
"Diamond village, Illinois",1348,1332,16,2861,17,19837
"Dieterich village, Illinois",501,482,19,1018,17,19915
"Divernon village, Illinois",591,564,27,1190,17,20045
"Dix village, Illinois",235,229,6,544,17,20123
"Dixmoor village, Illinois",1444,1364,80,3017,17,20149
"Dixon city, Illinois",6521,6335,186,15573,17,20162
"Dolton village, Illinois",9711,8476,1235,21283,17,20292
"Dongola village, Illinois",201,180,21,716,17,20305
"Donnellson village, Illinois",32,32,0,142,17,20318
"Donovan village, Illinois",159,129,30,304,17,20331
"Dorchester village, Illinois",68,67,1,165,17,20370
"Dover village, Illinois",41,39,2,107,17,20526
"Dowell village, Illinois",143,125,18,282,17,20565
"Downers Grove village, Illinois",27004,25889,1115,49996,17,20591
"Downs village, Illinois",758,754,4,1530,17,20643
"Du Bois village, Illinois",120,120,0,194,17,20890
"Dundas CDP, Illinois",245,245,0,307,17,21020
"Dunfermline village, Illinois",181,168,13,385,17,21098
"Dunlap village, Illinois",700,680,20,1417,17,21176
"Dupo village, Illinois",2343,2206,137,3960,17,21254
"Du Quoin city, Illinois",2169,1918,251,5822,17,21267
"Durand village, Illinois",657,645,12,1465,17,21280
"Dwight village, Illinois",2056,2022,34,3814,17,21358
"Eagarville village, Illinois",89,73,16,204,17,21410
"Eagle Lake CDP, Illinois",50,50,0,116,17,21475
"Earlville city, Illinois",987,917,70,1838,17,21540
"East Alton village, Illinois",3091,2981,110,5782,17,21553
"East Brooklyn village, Illinois",28,25,3,55,17,21579
"East Cape Girardeau village, Illinois",109,109,0,343,17,21605
"East Carondelet village, Illinois",134,128,6,267,17,21618
"East Dubuque city, Illinois",934,895,39,1634,17,21683
"East Dundee village, Illinois",1936,1895,41,3157,17,21696
"East Galesburg village, Illinois",312,299,13,618,17,21826
"East Gillespie village, Illinois",132,130,2,289,17,21852
"East Hazel Crest village, Illinois",731,621,110,1341,17,21904
"East Lynn CDP, Illinois",190,190,0,397,17,22021
"East Moline city, Illinois",9569,9176,393,20937,17,22073
"Easton village, Illinois",114,97,17,255,17,22151
"East Peoria city, Illinois",11703,11266,437,22552,17,22164
"East St. Louis city, Illinois",8147,7083,1064,18796,17,22255
"Eddyville village, Illinois",46,46,0,66,17,22398
"Edgewood village, Illinois",222,210,12,429,17,22567
"Edgington CDP, Illinois",212,212,0,415,17,22619
"Edinburg village, Illinois",551,530,21,1130,17,22645
"Edwardsville city, Illinois",13893,13014,879,26622,17,22697
"Effingham city, Illinois",6154,5978,176,12244,17,22736
"Elburn village, Illinois",2963,2951,12,5958,17,22931
"El Dara village, Illinois",51,51,0,127,17,22957
"Eldorado city, Illinois",1458,1439,19,3797,17,23009
"Eldred village, Illinois",96,96,0,168,17,23022
"Elgin city, Illinois",60842,57217,3625,114190,17,23074
"Eliza CDP, Illinois",0,0,0,0,17,23139
"Elizabeth village, Illinois",421,419,2,816,17,23165
"Elizabethtown village, Illinois",55,51,4,314,17,23191
"Elk Grove Village village, Illinois",17992,17244,748,32498,17,23256
"Elkhart village, Illinois",238,236,2,488,17,23269
"Elkville village, Illinois",352,340,12,818,17,23373
"Elliott village, Illinois",131,128,3,298,17,23425
"Ellis Grove village, Illinois",151,136,15,293,17,23503
"Ellisville village, Illinois",20,19,1,86,17,23529
"Ellsworth village, Illinois",96,92,4,211,17,23555
"Elmhurst city, Illinois",23780,22593,1187,45648,17,23620
"Elmwood city, Illinois",1056,1029,27,2159,17,23698
"Elmwood Park village, Illinois",13058,12241,817,24281,17,23724
"El Paso city, Illinois",1316,1255,61,2855,17,23737
"Elsah village, Illinois",283,270,13,629,17,23776
"Elvaston village, Illinois",73,73,0,166,17,23841
"Elwin CDP, Illinois",36,36,0,64,17,23919
"Elwood village, Illinois",1307,1265,42,2315,17,23945
"Emden village, Illinois",181,173,8,390,17,23971
"Emington village, Illinois",38,36,2,80,17,24062
"Energy village, Illinois",556,525,31,1227,17,24166
"Enfield village, Illinois",305,292,13,582,17,24179
"Equality village, Illinois",225,204,21,450,17,24348
"Erie village, Illinois",801,779,22,1703,17,24374
"Essex village, Illinois",478,467,11,955,17,24452
"Eureka city, Illinois",2909,2689,220,5504,17,24543
"Evanston city, Illinois",41500,38988,2512,77181,17,24582
"Evansville village, Illinois",409,363,46,847,17,24608
"Evergreen Park village, Illinois",10306,9914,392,19730,17,24634
"Ewing village, Illinois",208,193,15,396,17,24673
"Exeter village, Illinois",54,54,0,115,17,24699
"Fairbury city, Illinois",1727,1665,62,3731,17,24764
"Fairfield city, Illinois",2191,2112,79,4773,17,24816
"Fairmont CDP, Illinois",1184,1070,114,2595,17,24920
"Fairmont City village, Illinois",934,923,11,2125,17,24933
"Fairmount village, Illinois",318,300,18,632,17,24985
"Fairview village, Illinois",190,190,0,380,17,25063
"Fairview Heights city, Illinois",8560,8043,517,16360,17,25141
"Fall Creek CDP, Illinois",0,0,0,0,17,25245
"Farina village, Illinois",292,260,32,687,17,25375
"Farmer City city, Illinois",1019,958,61,1861,17,25414
"Farmersville village, Illinois",309,303,6,716,17,25440
"Farmington city, Illinois",1110,1017,93,2097,17,25531
"Fayetteville village, Illinois",175,172,3,398,17,25713
"Ferris village, Illinois",73,64,9,159,17,25895
"Fidelity village, Illinois",13,13,0,75,17,25960
"Fieldon village, Illinois",96,90,6,184,17,26012
"Fillmore village, Illinois",127,122,5,275,17,26077
"Findlay village, Illinois",371,352,19,697,17,26116
"Fisher village, Illinois",986,972,14,1722,17,26194
"Fithian village, Illinois",239,222,17,551,17,26233
"Flanagan village, Illinois",437,396,41,938,17,26311
"Flat Rock village, Illinois",209,194,15,455,17,26350
"Flora city, Illinois",2111,1967,144,4701,17,26454
"Floraville CDP, Illinois",0,0,0,22,17,26467
"Florence village, Illinois",5,5,0,12,17,26480
"Flossmoor village, Illinois",4817,4348,469,9405,17,26571
"Foosland village, Illinois",13,13,0,25,17,26662
"Ford Heights village, Illinois",599,532,67,1618,17,26710
"Forest City village, Illinois",80,75,5,204,17,26753
"Forest Lake CDP, Illinois",1018,963,55,1344,17,26896
"Forest Park village, Illinois",8521,8103,418,14165,17,26935
"Forest View village, Illinois",516,497,19,1078,17,26987
"Forrest village, Illinois",543,520,23,1019,17,27026
"Forreston village, Illinois",523,508,15,1140,17,27065
"Forsyth village, Illinois",1681,1588,93,3856,17,27091
"Fowler CDP, Illinois",20,20,0,82,17,27377
"Fox Lake village, Illinois",5825,5631,194,10798,17,27442
"Fox Lake Hills CDP, Illinois",1285,1198,87,2398,17,27455
"Fox River Grove village, Illinois",2702,2606,96,4600,17,27533
"Frankfort village, Illinois",10715,10312,403,20260,17,27624
"Frankfort Square CDP, Illinois",5750,5276,474,9367,17,27644
"Franklin village, Illinois",275,267,8,628,17,27663
"Franklin Grove village, Illinois",501,492,9,1102,17,27689
"Franklin Park village, Illinois",10105,9590,515,18374,17,27702
"Franklinville CDP, Illinois",0,0,0,0,17,27728
"Freeburg village, Illinois",2280,2193,87,4203,17,27806
"Freeman Spur village, Illinois",64,57,7,213,17,27858
"Freeport city, Illinois",10862,10154,708,23884,17,27884
"Fulton city, Illinois",1558,1503,55,3519,17,28144
"Fults village, Illinois",9,9,0,18,17,28170
"Gages Lake CDP, Illinois",6278,5774,504,10897,17,28248
"Galatia village, Illinois",462,438,24,964,17,28261
"Galena city, Illinois",1461,1461,0,2992,17,28300
"Galesburg city, Illinois",12278,11636,642,29923,17,28326
"Galt CDP, Illinois",55,55,0,114,17,28404
"Galva city, Illinois",1183,1145,38,2473,17,28430
"Garden Prairie CDP, Illinois",73,73,0,328,17,28612
"Gardner village, Illinois",861,721,140,1477,17,28638
"Garrett village, Illinois",46,46,0,80,17,28742
"Gays village, Illinois",84,83,1,171,17,28807
"Geneseo city, Illinois",3115,2957,158,6421,17,28846
"Geneva city, Illinois",11922,11679,243,21390,17,28872
"Genoa city, Illinois",3066,2919,147,5044,17,28898
"Georgetown CDP, Illinois",231,217,14,423,17,28950
"Georgetown city, Illinois",1578,1470,108,3144,17,28963
"Germantown village, Illinois",602,599,3,1199,17,29041
"Germantown Hills village, Illinois",1810,1750,60,3433,17,29080
"German Valley village, Illinois",253,248,5,497,17,29093
"Gibson City city, Illinois",1893,1778,115,3615,17,29125
"Gifford village, Illinois",407,401,6,827,17,29145
"Gilberts village, Illinois",4644,4585,59,8180,17,29171
"Gillespie city, Illinois",1515,1437,78,3193,17,29236
"Gilman city, Illinois",841,794,47,1530,17,29275
"Gilson CDP, Illinois",69,69,0,121,17,29340
"Girard city, Illinois",667,595,72,1492,17,29392
"Gladstone village, Illinois",97,78,19,167,17,29431
"Glasford village, Illinois",487,463,24,885,17,29483
"Glasgow village, Illinois",60,58,2,139,17,29496
"Glen Carbon village, Illinois",7258,6957,301,13654,17,29639
"Glencoe village, Illinois",3455,3320,135,8787,17,29652
"Glendale Heights village, Illinois",19124,18269,855,33088,17,29730
"Glen Ellyn village, Illinois",13974,13258,716,28304,17,29756
"Glenview village, Illinois",23751,22876,875,47896,17,29938
"Glenwood village, Illinois",4252,3562,690,8542,17,30029
"Godfrey village, Illinois",9469,9115,354,17791,17,30094
"Godley village, Illinois",288,266,22,551,17,30120
"Golconda city, Illinois",200,166,34,818,17,30133
"Golden village, Illinois",374,364,10,771,17,30159
"Golden Gate village, Illinois",19,19,0,90,17,30250
"Golf village, Illinois",283,264,19,546,17,30328
"Goodenow CDP, Illinois",9,9,0,9,17,30419
"Goodfield village, Illinois",417,415,2,906,17,30445
"Good Hope village, Illinois",203,196,7,416,17,30458
"Goofy Ridge CDP, Illinois",57,50,7,208,17,30510
"Goreville village, Illinois",452,444,8,1146,17,30575
"Gorham village, Illinois",129,67,62,303,17,30588
"Grafton city, Illinois",178,174,4,570,17,30653
"Grand Detour CDP, Illinois",174,145,29,302,17,30705
"Grand Ridge village, Illinois",348,337,11,593,17,30757
"Grand Tower city, Illinois",251,228,23,505,17,30770
"Grandview village, Illinois",751,683,68,1391,17,30835
"Grandwood Park CDP, Illinois",3220,3156,64,5391,17,30900
"Granite City city, Illinois",13415,12345,1070,27026,17,30926
"Grantfork village, Illinois",317,301,16,468,17,30978
"Grant Park village, Illinois",662,612,50,1641,17,30991
"Granville village, Illinois",702,684,18,1474,17,31017
"Grayslake village, Illinois",11915,11177,738,20801,17,31121
"Grayville city, Illinois",763,722,41,1542,17,31165
"Greenfield city, Illinois",645,622,23,1297,17,31368
"Green Oaks village, Illinois",1623,1586,37,4096,17,31446
"Greenup village, Illinois",869,854,15,1824,17,31524
"Green Valley village, Illinois",419,416,3,772,17,31563
"Greenview village, Illinois",508,479,29,953,17,31576
"Greenville city, Illinois",2942,2863,79,7121,17,31589
"Greenwood village, Illinois",278,266,12,512,17,31667
"Gridley village, Illinois",566,545,21,1217,17,31732
"Griggsville city, Illinois",677,662,15,1283,17,31771
"Gulfport village, Illinois",57,46,11,81,17,31991
"Gurnee village, Illinois",17287,16580,707,30629,17,32018
"Hainesville village, Illinois",2252,2191,61,3547,17,32200
"Hamburg village, Illinois",30,29,1,196,17,32395
"Hamel village, Illinois",470,468,2,948,17,32408
"Hamilton city, Illinois",1227,1208,19,2743,17,32434
"Hamlet CDP, Illinois",0,0,0,0,17,32473
"Hammond village, Illinois",235,192,43,546,17,32499
"Hampshire village, Illinois",3883,3807,76,8113,17,32525
"Hampton village, Illinois",1028,977,51,2063,17,32564
"Hanaford village, Illinois",158,150,8,351,17,32616
"Hanna City village, Illinois",763,748,15,1417,17,32668
"Hanover village, Illinois",379,369,10,849,17,32707
"Hanover Park village, Illinois",19253,18239,1014,37222,17,32746
"Hardin village, Illinois",296,294,2,774,17,32850
"Harding CDP, Illinois",21,21,0,110,17,32876
"Harmon village, Illinois",33,29,4,78,17,32967
"Harmony CDP, Illinois",0,0,0,0,17,33019
"Harrisburg city, Illinois",3782,3491,291,8380,17,33136
"Harrison CDP, Illinois",395,350,45,974,17,33162
"Harristown village, Illinois",711,680,31,1494,17,33227
"Hartford village, Illinois",715,668,47,1626,17,33279
"Hartland CDP, Illinois",0,0,0,117,17,33292
"Hartsburg village, Illinois",242,215,27,375,17,33318
"Harvard city, Illinois",4979,4670,309,9705,17,33331
"Harvel village, Illinois",111,108,3,231,17,33357
"Harvey city, Illinois",9317,7953,1364,20035,17,33383
"Harwood Heights village, Illinois",4950,4731,219,8942,17,33435
"Havana city, Illinois",1570,1465,105,3242,17,33513
"Hawthorn Woods village, Illinois",4865,4696,169,9111,17,33630
"Hazel Crest village, Illinois",6515,5625,890,13737,17,33695
"Hebron village, Illinois",793,763,30,1456,17,33851
"Hecker village, Illinois",308,292,16,540,17,33877
"Henderson village, Illinois",99,92,7,254,17,34007
"Hennepin village, Illinois",458,444,14,766,17,34098
"Henning village, Illinois",164,153,11,263,17,34137
"Henry city, Illinois",1187,1160,27,2471,17,34163
"Heritage Lake CDP, Illinois",806,806,0,1595,17,34272
"Herrick village, Illinois",161,150,11,373,17,34332
"Herrin city, Illinois",6304,6012,292,12344,17,34358
"Herscher village, Illinois",639,607,32,1253,17,34384
"Hettick village, Illinois",66,66,0,138,17,34423
"Heyworth village, Illinois",1233,1200,33,2725,17,34449
"Hickory Hills city, Illinois",7563,7216,347,14915,17,34514
"Hidalgo village, Illinois",45,37,8,97,17,34553
"Highland city, Illinois",5527,5395,132,10215,17,34670
"Highland Park city, Illinois",15300,14776,524,30209,17,34722
"Highwood city, Illinois",2860,2667,193,5227,17,34865
"Hillcrest village, Illinois",946,895,51,1694,17,34982
"Hillsboro city, Illinois",1485,1405,80,5673,17,35047
"Hillsdale village, Illinois",296,244,52,552,17,35073
"Hillside village, Illinois",4357,4166,191,8213,17,35086
"Hillview village, Illinois",58,58,0,125,17,35203
"Hinckley village, Illinois",1135,964,171,2154,17,35268
"Hindsboro village, Illinois",234,233,1,410,17,35281
"Hinsdale village, Illinois",7752,7550,202,17169,17,35307
"Hodgkins village, Illinois",772,745,27,1714,17,35385
"Hoffman village, Illinois",276,273,3,652,17,35398
"Hoffman Estates village, Illinois",29523,28435,1088,51744,17,35411
"Holcomb CDP, Illinois",75,75,0,167,17,35463
"Holiday Hills village, Illinois",341,330,11,676,17,35515
"Holiday Shores CDP, Illinois",2002,1856,146,3285,17,35541
"Hollowayville village, Illinois",30,30,0,41,17,35671
"Homer village, Illinois",605,592,13,1060,17,35814
"Homer Glen village, Illinois",12510,11882,628,24507,17,35835
"Hometown city, Illinois",2270,2137,133,4299,17,35866
"Homewood village, Illinois",9568,8954,614,19868,17,35879
"Hoopeston city, Illinois",2240,1986,254,4940,17,36061
"Hooppole village, Illinois",79,77,2,188,17,36074
"Hopedale village, Illinois",342,318,24,747,17,36126
"Hopewell village, Illinois",246,241,5,477,17,36150
"Hopkins Park village, Illinois",198,190,8,606,17,36190
"Hoyleton village, Illinois",232,225,7,473,17,36347
"Hudson village, Illinois",1066,1044,22,2225,17,36438
"Huey village, Illinois",62,62,0,133,17,36477
"Hull village, Illinois",256,255,1,460,17,36516
"Humboldt village, Illinois",213,191,22,400,17,36542
"Hume village, Illinois",243,236,7,466,17,36568
"Huntley village, Illinois",11745,11355,390,27652,17,36750
"Hurst city, Illinois",310,301,9,769,17,36815
"Hutsonville village, Illinois",294,284,10,619,17,36841
"Illinois City CDP, Illinois",0,0,0,37,17,37062
"Illiopolis village, Illinois",400,390,10,822,17,37127
"Ina village, Illinois",250,221,29,1754,17,37179
"Indian Creek village, Illinois",368,356,12,664,17,37218
"Indian Head Park village, Illinois",1840,1705,135,4022,17,37257
"Indianola village, Illinois",89,69,20,197,17,37348
"Industry village, Illinois",303,289,14,571,17,37439
"Ingalls Park CDP, Illinois",1696,1538,158,3102,17,37465
"Inverness village, Illinois",3604,3522,82,7722,17,37608
"Iola village, Illinois",28,28,0,58,17,37621
"Ipava village, Illinois",226,198,28,452,17,37647
"Iroquois village, Illinois",73,73,0,244,17,37712
"Irving village, Illinois",214,184,30,431,17,37738
"Irvington village, Illinois",260,239,21,545,17,37777
"Irwin village, Illinois",26,26,0,47,17,37803
"Island Lake village, Illinois",4427,4129,298,8039,17,37894
"Itasca village, Illinois",5854,5680,174,9627,17,37907
"Iuka village, Illinois",210,171,39,468,17,37933
"Ivesdale village, Illinois",119,113,6,238,17,37998
"Jacksonville city, Illinois",8005,7348,657,17639,17,38115
"Janesville CDP, Illinois",14,14,0,44,17,38232
"Jeffersonville village, Illinois",139,128,11,256,17,38323
"Jeisyville village, Illinois",52,52,0,92,17,38349
"Jerome village, Illinois",1229,1204,25,2194,17,38375
"Jerseyville city, Illinois",3402,3310,92,7623,17,38414
"Jewett village, Illinois",111,104,7,261,17,38427
"Johnsburg village, Illinois",3368,3233,135,6387,17,38479
"Johnsonville village, Illinois",27,27,0,50,17,38531
"Johnston City city, Illinois",1680,1589,91,3377,17,38544
"Joliet city, Illinois",79929,74997,4932,150221,17,38570
"Jonesboro city, Illinois",754,716,38,1817,17,38635
"Joppa village, Illinois",140,88,52,333,17,38674
"Joslin CDP, Illinois",0,0,0,59,17,38726
"Joy village, Illinois",197,186,11,374,17,38739
"Junction village, Illinois",24,24,0,59,17,38778
"Junction City village, Illinois",314,268,46,670,17,38791
"Justice village, Illinois",6742,6404,338,12525,17,38830
"Kampsville village, Illinois",88,80,8,258,17,38856
"Kane village, Illinois",102,96,6,227,17,38869
"Kaneville village, Illinois",311,301,10,571,17,38895
"Kangley village, Illinois",121,111,10,234,17,38921
"Kankakee city, Illinois",10755,9964,791,24795,17,38934
"Kansas village, Illinois",299,267,32,732,17,38986
"Kappa village, Illinois",116,116,0,198,17,39038
"Karnak village, Illinois",147,141,6,439,17,39077
"Kaskaskia village, Illinois",12,12,0,36,17,39129
"Keenes village, Illinois",26,26,0,60,17,39233
"Keensburg village, Illinois",84,80,4,151,17,39259
"Keithsburg city, Illinois",286,253,33,570,17,39298
"Kell village, Illinois",83,69,14,180,17,39324
"Kempton village, Illinois",138,118,20,280,17,39441
"Kenilworth village, Illinois",963,931,32,2537,17,39519
"Kenney village, Illinois",141,121,20,369,17,39532
"Kewanee city, Illinois",5123,4769,354,12179,17,39727
"Keyesport village, Illinois",239,190,49,613,17,39753
"Kilbourne village, Illinois",130,111,19,290,17,39857
"Kildeer village, Illinois",2168,2101,67,4133,17,39883
"Kincaid village, Illinois",594,571,23,1146,17,39909
"Kinderhook village, Illinois",138,124,14,266,17,39922
"Kings CDP, Illinois",130,126,4,347,17,39987
"Kingston CDP, Illinois",55,55,0,118,17,40052
"Kingston village, Illinois",775,690,85,1361,17,40065
"Kingston Mines village, Illinois",71,71,0,194,17,40091
"Kinmundy city, Illinois",356,303,53,874,17,40117
"Kinsman village, Illinois",46,42,4,68,17,40143
"Kirkland village, Illinois",825,789,36,1493,17,40156
"Kirkwood village, Illinois",370,355,15,735,17,40182
"Knollwood CDP, Illinois",519,519,0,1763,17,40364
"Knoxville city, Illinois",1461,1394,67,3318,17,40416
"La Clede CDP, Illinois",66,66,0,172,17,40520
"Lacon city, Illinois",731,671,60,1753,17,40559
"Ladd village, Illinois",723,675,48,1314,17,40598
"La Fayette village, Illinois",67,67,0,155,17,40676
"La Grange village, Illinois",8105,7941,164,16128,17,40767
"La Grange Park village, Illinois",6640,6385,255,13332,17,40793
"La Harpe city, Illinois",570,541,29,1179,17,40832
"Lake Barrington village, Illinois",2444,2287,157,5377,17,40884
"Lake Bluff village, Illinois",2880,2815,65,5919,17,40910
"Lake Camelot CDP, Illinois",751,735,16,1565,17,40962
"Lake Carroll CDP, Illinois",221,221,0,758,17,40980
"Lake Catherine CDP, Illinois",771,694,77,1311,17,40988
"Lake City CDP, Illinois",0,0,0,39,17,41040
"Lake Forest city, Illinois",8939,8662,277,19436,17,41105
"Lake Holiday CDP, Illinois",3019,2806,213,5485,17,41157
"Lake in the Hills village, Illinois",16709,15771,938,28958,17,41183
"Lake Ka-Ho village, Illinois",96,89,7,281,17,41214
"Lakemoor village, Illinois",3534,3446,88,6128,17,41326
"Lake of the Woods CDP, Illinois",1238,1147,91,2350,17,41346
"Lake Petersburg CDP, Illinois",354,346,8,763,17,41404
"Lake Summerset CDP, Illinois",978,873,105,2115,17,41456
"Lake Villa village, Illinois",4751,4431,320,8701,17,41586
"Lakewood village, Illinois",2334,2318,16,4698,17,41651
"Lakewood CDP, Illinois",9,9,0,19,17,41677
"Lakewood Shores CDP, Illinois",258,252,6,550,17,41716
"Lake Zurich village, Illinois",11648,11241,407,19749,17,41742
"La Moille village, Illinois",448,445,3,778,17,41794
"Lanark city, Illinois",816,783,33,1553,17,41859
"Lane CDP, Illinois",64,64,0,129,17,41950
"Langleyville CDP, Illinois",112,112,0,342,17,42002
"Lansing village, Illinois",15362,13681,1681,28713,17,42028
"LaPlace CDP, Illinois",95,81,14,149,17,42067
"La Prairie village, Illinois",20,16,4,51,17,42080
"La Rose village, Illinois",72,53,19,109,17,42171
"LaSalle city, Illinois",4978,4715,263,9562,17,42184
"Latham village, Illinois",258,246,12,450,17,42249
"Lawrence CDP, Illinois",128,120,8,201,17,42392
"Lawrenceville city, Illinois",1758,1637,121,4210,17,42405
"Leaf River village, Illinois",247,240,7,437,17,42457
"Lebanon city, Illinois",2446,2416,30,4683,17,42496
"Lee village, Illinois",162,157,5,325,17,42587
"Lee Center CDP, Illinois",0,0,0,0,17,42600
"Leland village, Illinois",603,553,50,1156,17,42756
"Leland Grove city, Illinois",705,689,16,1478,17,42769
"Lemont village, Illinois",8947,8597,350,17558,17,42795
"Lena village, Illinois",1370,1322,48,2811,17,42834
"Lenzburg village, Illinois",217,210,7,445,17,42860
"Leonore village, Illinois",71,68,3,132,17,42912
"Lerna village, Illinois",107,88,19,220,17,42938
"Le Roy city, Illinois",1779,1713,66,3223,17,42971
"Lewistown city, Illinois",860,727,133,1938,17,43055
"Lexington city, Illinois",1073,1049,24,2108,17,43094
"Liberty village, Illinois",211,209,2,401,17,43133
"Libertyville village, Illinois",10315,9981,334,20555,17,43250
"Lily Lake village, Illinois",765,721,44,1390,17,43406
"Lima village, Illinois",91,82,9,180,17,43445
"Limestone village, Illinois",816,769,47,1479,17,43510
"Lincoln city, Illinois",6761,6386,375,13371,17,43536
"Lincolnshire village, Illinois",3900,3811,89,7907,17,43666
"Lincolnwood village, Illinois",5687,5262,425,13268,17,43744
"Lindenhurst village, Illinois",8496,7924,572,14403,17,43770
"Lisbon village, Illinois",134,133,1,272,17,43900
"Lisle village, Illinois",13415,12736,679,23499,17,43939
"Litchfield city, Illinois",3239,3075,164,6937,17,43965
"Literberry CDP, Illinois",63,63,0,97,17,43978
"Littleton village, Illinois",61,61,0,101,17,44056
"Little York village, Illinois",198,194,4,402,17,44082
"Liverpool village, Illinois",43,43,0,111,17,44121
"Livingston village, Illinois",334,320,14,770,17,44160
"Loami village, Illinois",430,416,14,1035,17,44173
"Lockport city, Illinois",14957,14271,686,26119,17,44225
"Lockport Heights CDP, Illinois",508,480,28,841,17,44244
"Loda village, Illinois",134,131,3,287,17,44264
"Lomax village, Illinois",144,140,4,372,17,44381
"Lombard village, Illinois",25438,24318,1120,44055,17,44407
"London Mills village, Illinois",157,139,18,376,17,44446
"Long Creek village, Illinois",603,572,31,1318,17,44498
"Long Grove village, Illinois",4096,3977,119,8279,17,44524
"Long Lake CDP, Illinois",1667,1457,210,2939,17,44550
"Long Point village, Illinois",69,69,0,217,17,44576
"Longview village, Illinois",55,54,1,82,17,44602
"Loraine village, Illinois",161,150,11,350,17,44719
"Lorenzo CDP, Illinois",10,10,0,60,17,44784
"Lostant village, Illinois",226,216,10,401,17,44823
"Lost Nation CDP, Illinois",398,398,0,728,17,44836
"Louisville village, Illinois",553,515,38,1183,17,44927
"Loves Park city, Illinois",12177,11231,946,22935,17,45031
"Lovington village, Illinois",535,498,37,1093,17,45044
"Lowpoint CDP, Illinois",81,48,33,156,17,45109
"Ludlow village, Illinois",179,157,22,338,17,45174
"Lyndon village, Illinois",323,305,18,561,17,45278
"Lynn Center CDP, Illinois",12,12,0,24,17,45343
"Lynnville village, Illinois",50,50,0,129,17,45369
"Lynwood village, Illinois",4507,4281,226,9087,17,45421
"Lyons village, Illinois",5613,5372,241,10687,17,45434
"McClure village, Illinois",105,104,1,274,17,45525
"McCook village, Illinois",128,123,5,299,17,45564
"McCullom Lake village, Illinois",564,512,52,955,17,45616
"Macedonia village, Illinois",4,4,0,21,17,45642
"McHenry city, Illinois",15780,15098,682,27493,17,45694
"Machesney Park village, Illinois",12118,11369,749,22840,17,45726
"Mackinaw village, Illinois",894,857,37,1942,17,45785
"McLean village, Illinois",439,430,9,777,17,45811
"McLeansboro city, Illinois",1164,1150,14,2794,17,45824
"McNabb village, Illinois",119,116,3,231,17,45850
"Macomb city, Illinois",7631,6768,863,15207,17,45889
"Macon city, Illinois",536,523,13,1080,17,45941
"Madison city, Illinois",1490,1314,176,2677,17,45993
"Maeystown village, Illinois",37,28,9,85,17,46058
"Magnolia village, Illinois",126,119,7,224,17,46110
"Mahomet village, Illinois",4795,4745,50,9545,17,46136
"Makanda village, Illinois",224,222,2,500,17,46214
"Malden village, Illinois",213,178,35,393,17,46240
"Malta village, Illinois",793,770,23,1535,17,46279
"Manchester village, Illinois",102,93,9,185,17,46331
"Manhattan village, Illinois",5130,5027,103,9590,17,46357
"Manito village, Illinois",806,787,19,1719,17,46383
"Manlius village, Illinois",139,139,0,253,17,46422
"Mansfield village, Illinois",545,528,17,910,17,46487
"Manteno village, Illinois",4696,4503,193,8632,17,46500
"Maple Park village, Illinois",914,878,36,1635,17,46604
"Mapleton village, Illinois",151,149,2,299,17,46643
"Maquon village, Illinois",99,95,4,202,17,46695
"Marcelline CDP, Illinois",27,27,0,35,17,46734
"Marengo city, Illinois",3951,3671,280,7471,17,46786
"Marietta village, Illinois",39,36,3,81,17,46825
"Marine village, Illinois",596,596,0,1264,17,46864
"Marion city, Illinois",7866,7506,360,16867,17,46916
"Marissa village, Illinois",624,519,105,1200,17,46955
"Mark village, Illinois",293,290,3,531,17,46981
"Markham city, Illinois",4928,4238,690,11592,17,47007
"Marley CDP, Illinois",25,25,0,35,17,47046
"Maroa city, Illinois",752,711,41,1781,17,47072
"Marquette Heights city, Illinois",1427,1358,69,2672,17,47111
"Marseilles city, Illinois",1967,1860,107,4154,17,47150
"Marshall city, Illinois",1902,1880,22,3939,17,47163
"Martinsville city, Illinois",731,690,41,1373,17,47254
"Martinton village, Illinois",188,183,5,336,17,47280
"Maryville village, Illinois",4463,4181,282,8219,17,47397
"Mascoutah city, Illinois",4592,4386,206,8762,17,47423
"Mason town, Illinois",177,168,9,371,17,47449
"Mason City city, Illinois",989,964,25,2260,17,47475
"Matherville village, Illinois",320,301,19,794,17,47527
"Matteson village, Illinois",10152,8885,1267,18898,17,47540
"Mattoon city, Illinois",8442,7773,669,16830,17,47553
"Maunie village, Illinois",52,49,3,124,17,47592
"Maywood village, Illinois",10688,9725,963,23385,17,47774
"Mazon village, Illinois",641,620,21,1315,17,47787
"Mechanicsburg village, Illinois",451,435,16,775,17,48021
"Media village, Illinois",57,57,0,113,17,48073
"Medora village, Illinois",166,158,8,300,17,48138
"Melrose Park village, Illinois",13043,12385,658,25177,17,48242
"Melvin village, Illinois",223,205,18,446,17,48268
"Mendon village, Illinois",586,560,26,1131,17,48307
"Mendota city, Illinois",3551,3417,134,6961,17,48333
"Menominee village, Illinois",225,216,9,356,17,48359
"Meredosia village, Illinois",373,361,12,919,17,48424
"Merrionette Park village, Illinois",1315,1209,106,2014,17,48554
"Merritt CDP, Illinois",17,17,0,17,17,48567
"Metamora village, Illinois",2135,2135,0,4065,17,48606
"Metcalf village, Illinois",110,84,26,202,17,48632
"Metropolis city, Illinois",2222,2173,49,5963,17,48645
"Mettawa village, Illinois",277,258,19,601,17,48671
"Meyer CDP, Illinois",0,0,0,19,17,48684
"Middletown village, Illinois",93,88,5,254,17,48853
"Midlothian village, Illinois",7163,6778,385,14200,17,48892
"Milan village, Illinois",2626,2579,47,5066,17,49009
"Milford village, Illinois",545,526,19,1246,17,49048
"Millbrook village, Illinois",162,156,6,314,17,49100
"Mill Creek village, Illinois",18,14,4,45,17,49178
"Milledgeville village, Illinois",591,551,40,1148,17,49191
"Millersburg CDP, Illinois",8,8,0,62,17,49243
"Millington village, Illinois",310,301,9,555,17,49308
"Mill Shoals village, Illinois",68,67,1,167,17,49347
"Millstadt village, Illinois",2457,2346,111,4035,17,49386
"Milton village, Illinois",57,57,0,215,17,49477
"Mineral village, Illinois",100,96,4,168,17,49516
"Minier village, Illinois",573,550,23,1063,17,49555
"Minonk city, Illinois",902,831,71,1966,17,49568
"Minooka village, Illinois",7332,7008,324,12606,17,49607
"Mitchell CDP, Illinois",515,479,36,942,17,49698
"Modesto village, Illinois",81,79,2,183,17,49802
"Mokena village, Illinois",11453,11068,385,19886,17,49854
"Moline city, Illinois",21678,20234,1444,42452,17,49867
"Momence city, Illinois",1545,1470,75,3033,17,49893
"Monee village, Illinois",3160,3111,49,5120,17,49945
"Monmouth city, Illinois",4304,3843,461,8764,17,50010
"Monroe Center village, Illinois",274,269,5,460,17,50062
"Montgomery village, Illinois",11722,11081,641,20644,17,50218
"Monticello city, Illinois",3208,3154,54,6337,17,50244
"Montrose village, Illinois",140,136,4,232,17,50283
"Moro CDP, Illinois",248,248,0,420,17,50452
"Morris city, Illinois",7526,7358,168,14491,17,50491
"Morrison city, Illinois",1930,1853,77,3925,17,50530
"Morrisonville village, Illinois",429,421,8,935,17,50543
"Morton village, Illinois",7973,7803,170,16601,17,50621
"Morton Grove village, Illinois",12635,12161,474,24910,17,50647
"Mossville CDP, Illinois",69,60,9,220,17,50699
"Mound City city, Illinois",312,300,12,798,17,50751
"Mounds city, Illinois",213,196,17,831,17,50777
"Mound Station village, Illinois",74,74,0,162,17,50790
"Mount Auburn village, Illinois",259,242,17,528,17,50829
"Mount Carmel city, Illinois",3160,3014,146,6978,17,50868
"Mount Carroll city, Illinois",862,840,22,1560,17,50881
"Mount Clare village, Illinois",108,97,11,341,17,50920
"Mount Erie village, Illinois",64,64,0,135,17,50933
"Mount Morris village, Illinois",1267,1204,63,2853,17,50998
"Mount Olive city, Illinois",884,812,72,2144,17,51024
"Mount Prospect village, Illinois",30562,29491,1071,56191,17,51089
"Mount Pulaski city, Illinois",736,688,48,1636,17,51128
"Mount Sterling city, Illinois",1145,1109,36,2177,17,51154
"Mount Vernon city, Illinois",7181,6594,587,14740,17,51180
"Mount Zion village, Illinois",2943,2826,117,6255,17,51206
"Moweaqua village, Illinois",960,924,36,1947,17,51232
"Muddy village, Illinois",21,21,0,45,17,51271
"Mulberry Grove village, Illinois",368,349,19,727,17,51284
"Mulkeytown CDP, Illinois",18,18,0,79,17,51310
"Muncie village, Illinois",83,77,6,146,17,51336
"Mundelein village, Illinois",17750,17243,507,31583,17,51349
"Murphysboro city, Illinois",3200,2919,281,7101,17,51453
"Murrayville village, Illinois",306,295,11,664,17,51479
"Nachusa CDP, Illinois",35,35,0,138,17,51544
"Naperville city, Illinois",80271,76636,3635,149089,17,51622
"Naplate village, Illinois",249,234,15,477,17,51648
"Naples town, Illinois",57,52,5,145,17,51661
"Nashville city, Illinois",1541,1424,117,3025,17,51700
"Nason city, Illinois",123,99,24,246,17,51726
"Nauvoo city, Illinois",292,285,7,861,17,51791
"Nebo village, Illinois",105,102,3,355,17,51882
"Nekoma CDP, Illinois",0,0,0,52,17,51934
"Nelson village, Illinois",58,56,2,136,17,51947
"Neoga city, Illinois",524,515,9,1263,17,51986
"Neponset village, Illinois",233,219,14,415,17,51999
"Newark village, Illinois",678,669,9,1156,17,52103
"New Athens village, Illinois",949,900,49,1951,17,52116
"New Baden village, Illinois",1718,1645,73,3444,17,52142
"New Bedford village, Illinois",27,26,1,47,17,52155
"New Berlin village, Illinois",717,707,10,1247,17,52168
"New Boston city, Illinois",287,267,20,579,17,52220
"New Burnside village, Illinois",35,34,1,162,17,52285
"New Canton town, Illinois",99,96,3,228,17,52311
"New Douglas village, Illinois",159,158,1,329,17,52415
"New Grand Chain village, Illinois",65,55,10,140,17,52467
"New Haven village, Illinois",274,166,108,485,17,52506
"New Holland village, Illinois",131,118,13,238,17,52545
"New Lenox village, Illinois",14779,14359,420,27242,17,52584
"Newman city, Illinois",305,303,2,780,17,52623
"New Milford village, Illinois",714,676,38,1272,17,52701
"New Minden village, Illinois",129,122,7,227,17,52714
"New Salem village, Illinois",104,102,2,210,17,52805
"Newton city, Illinois",1471,1396,75,2957,17,52844
"Niantic village, Illinois",333,293,40,748,17,52961
"Niles village, Illinois",15187,14243,944,30637,17,53000
"Nilwood town, Illinois",57,57,0,150,17,53039
"Niota CDP, Illinois",4,4,0,13,17,53078
"Noble village, Illinois",277,254,23,649,17,53143
"Nokomis city, Illinois",1092,1059,33,2203,17,53169
"Nora village, Illinois",120,117,3,176,17,53195
"Normal town, Illinois",27760,26682,1078,52920,17,53234
"Norridge village, Illinois",7688,7206,482,15291,17,53377
"Norris village, Illinois",146,120,26,259,17,53390
"Norris City village, Illinois",551,490,61,1352,17,53403
"North Aurora village, Illinois",10334,9595,739,17750,17,53442
"North Barrington village, Illinois",1505,1430,75,3119,17,53455
"Northbrook village, Illinois",17267,16708,559,34950,17,53481
"North Chicago city, Illinois",11394,10308,1086,30890,17,53559
"North City village, Illinois",316,284,32,697,17,53585
"Northfield village, Illinois",2684,2645,39,5707,17,53663
"North Henderson village, Illinois",108,104,4,199,17,53793
"Northlake city, Illinois",6287,5986,301,12683,17,53871
"North Pekin village, Illinois",1009,957,52,1622,17,54092
"North Riverside village, Illinois",3299,3113,186,7245,17,54144
"North Utica village, Illinois",590,564,26,1136,17,54222
"Norwood village, Illinois",245,238,7,489,17,54404
"Oak Brook village, Illinois",3130,2805,325,8065,17,54534
"Oakbrook Terrace city, Illinois",1513,1419,94,2695,17,54560
"Oakdale village, Illinois",164,130,34,295,17,54586
"Oakford village, Illinois",108,101,7,223,17,54625
"Oak Forest city, Illinois",15278,14531,747,27199,17,54638
"Oak Grove village, Illinois",187,173,14,353,17,54703
"Oakland city, Illinois",434,416,18,926,17,54781
"Oak Lawn village, Illinois",28329,26673,1656,57665,17,54820
"Oak Park village, Illinois",29937,28460,1477,53834,17,54885
"Oak Run CDP, Illinois",324,320,4,673,17,54924
"Oakwood village, Illinois",570,561,9,1350,17,55002
"Oakwood Hills village, Illinois",1487,1402,85,2475,17,55041
"Oblong village, Illinois",708,665,43,1460,17,55106
"Oconee village, Illinois",90,85,5,179,17,55132
"Odell village, Illinois",396,379,17,909,17,55171
"Odin village, Illinois",447,407,40,960,17,55210
"O'Fallon city, Illinois",15305,14758,547,32104,17,55249
"Ogden village, Illinois",402,384,18,756,17,55275
"Oglesby city, Illinois",1785,1739,46,3739,17,55353
"Ohio village, Illinois",334,293,41,623,17,55379
"Ohlman village, Illinois",32,29,3,73,17,55418
"Okawville village, Illinois",642,613,29,1263,17,55470
"Old Mill Creek village, Illinois",55,53,2,122,17,55639
"Old Ripley village, Illinois",51,29,22,96,17,55717
"Old Shawneetown village, Illinois",32,32,0,142,17,55756
"Olive Branch CDP, Illinois",233,233,0,578,17,55847
"Olivet CDP, Illinois",74,74,0,160,17,55886
"Olmsted village, Illinois",94,93,1,248,17,55899
"Olney city, Illinois",4329,4087,242,8995,17,55912
"Olympia Fields village, Illinois",2330,2086,244,4922,17,55938
"Omaha village, Illinois",89,85,4,235,17,56003
"Onarga village, Illinois",607,546,61,1288,17,56081
"Oneida city, Illinois",295,284,11,732,17,56159
"Opdyke CDP, Illinois",123,123,0,259,17,56198
"Ophiem CDP, Illinois",89,89,0,190,17,56211
"Oquawka village, Illinois",380,356,24,930,17,56237
"Orangeville village, Illinois",519,451,68,917,17,56341
"Oreana village, Illinois",605,575,30,1076,17,56471
"Oregon city, Illinois",1653,1570,83,3963,17,56484
"Orient city, Illinois",145,132,13,311,17,56536
"Orion village, Illinois",987,952,35,1966,17,56601
"Orland Hills village, Illinois",4010,3812,198,6842,17,56627
"Orland Park village, Illinois",29312,27994,1318,58345,17,56640
"Osco CDP, Illinois",66,56,10,119,17,56796
"Oswego village, Illinois",18475,17930,545,34810,17,56887
"Ottawa city, Illinois",9604,8951,653,18708,17,56926
"Otterville town, Illinois",42,40,2,157,17,56978
"Owaneco village, Illinois",327,314,13,758,17,57043
"Oxville CDP, Illinois",4,4,0,23,17,57121
"Paderborn CDP, Illinois",0,0,0,0,17,57160
"Palatine village, Illinois",38870,37047,1823,67223,17,57225
"Palestine village, Illinois",608,588,20,1379,17,57277
"Palmer village, Illinois",124,119,5,238,17,57303
"Palmyra village, Illinois",245,225,20,536,17,57329
"Paloma CDP, Illinois",85,85,0,126,17,57342
"Palos Heights city, Illinois",5530,5331,199,11965,17,57381
"Palos Hills city, Illinois",9141,8696,445,18278,17,57394
"Palos Park village, Illinois",2255,2135,120,4836,17,57407
"Pana city, Illinois",2343,2220,123,5167,17,57472
"Panama village, Illinois",152,139,13,317,17,57498
"Panola village, Illinois",10,10,0,25,17,57524
"Papineau village, Illinois",63,56,7,122,17,57576
"Paris city, Illinois",3987,3859,128,8331,17,57628
"Park City city, Illinois",4393,3974,419,7702,17,57654
"Parkersburg village, Illinois",118,112,6,240,17,57693
"Park Forest village, Illinois",10379,9506,873,21042,17,57732
"Park Ridge city, Illinois",20429,19722,707,39368,17,57875
"Patoka village, Illinois",329,309,20,667,17,58057
"Pawnee village, Illinois",1349,1306,43,2626,17,58174
"Paw Paw village, Illinois",463,439,24,981,17,58226
"Paxton city, Illinois",1997,1967,30,4225,17,58239
"Payson village, Illinois",626,622,4,1276,17,58265
"Pearl village, Illinois",34,34,0,93,17,58343
"Pearl City village, Illinois",347,343,4,720,17,58369
"Pecatonica village, Illinois",1190,1148,42,2141,17,58408
"Pekin city, Illinois",15267,14256,1011,32075,17,58447
"Penfield CDP, Illinois",52,52,0,198,17,58577
"Peoria city, Illinois",54659,50267,4392,113054,17,59000
"Peoria Heights village, Illinois",3272,3100,172,5890,17,59026
"Peotone village, Illinois",2371,2232,139,4283,17,59052
"Percy village, Illinois",420,413,7,1076,17,59104
"Perry village, Illinois",124,124,0,282,17,59156
"Peru city, Illinois",5268,5104,164,9831,17,59234
"Pesotum village, Illinois",310,284,26,529,17,59273
"Petersburg city, Illinois",1307,1262,45,2426,17,59312
"Phillipstown village, Illinois",22,22,0,48,17,59520
"Philo village, Illinois",745,738,7,1389,17,59533
"Phoenix village, Illinois",654,520,134,1278,17,59572
"Pierron village, Illinois",233,227,6,463,17,59709
"Pinckneyville city, Illinois",1501,1474,27,5104,17,59884
"Pingree Grove village, Illinois",5437,5244,193,10213,17,59988
"Piper City village, Illinois",392,331,61,744,17,60079
"Pistakee Highlands CDP, Illinois",2124,2048,76,3292,17,60144
"Pittsburg village, Illinois",228,218,10,634,17,60209
"Pittsfield city, Illinois",1753,1608,145,4152,17,60222
"Plainfield village, Illinois",24589,23667,922,44941,17,60287
"Plainville village, Illinois",108,98,10,269,17,60339
"Plano city, Illinois",6953,6344,609,11113,17,60352
"Plattville village, Illinois",102,92,10,196,17,60391
"Pleasant Hill village, Illinois",383,358,25,908,17,60534
"Pleasant Plains village, Illinois",438,418,20,747,17,60599
"Plum Valley CDP, Illinois",205,198,7,405,17,60826
"Plymouth village, Illinois",237,198,39,489,17,60833
"Pocahontas village, Illinois",387,378,9,804,17,60872
"Polo city, Illinois",1192,1152,40,2520,17,60937
"Pontiac city, Illinois",5164,4946,218,11451,17,61015
"Pontoon Beach village, Illinois",2954,2785,169,6039,17,61067
"Pontoosuc village, Illinois",49,38,11,104,17,61080
"Poplar Grove village, Illinois",2269,2134,135,4727,17,61145
"Port Barrington village, Illinois",902,871,31,1557,17,61216
"Port Byron village, Illinois",911,880,31,1904,17,61223
"Posen village, Illinois",2924,2683,241,5442,17,61314
"Potomac village, Illinois",341,320,21,821,17,61366
"Prairie City village, Illinois",140,137,3,349,17,61548
"Prairie du Rocher village, Illinois",294,275,19,494,17,61639
"Prairie Grove village, Illinois",1078,1040,38,1967,17,61678
"Prairietown CDP, Illinois",226,207,19,335,17,61743
"Preemption CDP, Illinois",62,62,0,152,17,61782
"Prestbury CDP, Illinois",668,668,0,2100,17,61821
"Preston Heights CDP, Illinois",1252,1148,104,2586,17,61860
"Princeton city, Illinois",3634,3408,226,7749,17,61899
"Princeville village, Illinois",907,885,22,1957,17,61925
"Prophetstown city, Illinois",687,629,58,1696,17,61977
"Prospect Heights city, Illinois",8914,8461,453,15861,17,62016
"Pulaski village, Illinois",81,80,1,255,17,62211
"Quincy city, Illinois",20599,19608,991,39441,17,62367
"Radom village, Illinois",71,71,0,130,17,62523
"Raleigh village, Illinois",109,96,13,242,17,62588
"Ramsey village, Illinois",287,277,10,921,17,62627
"Rankin village, Illinois",213,179,34,490,17,62744
"Ransom village, Illinois",174,172,2,319,17,62757
"Rantoul village, Illinois",5328,5048,280,12544,17,62783
"Rapids City village, Illinois",455,433,22,984,17,62822
"Raritan village, Illinois",60,56,4,136,17,62848
"Raymond village, Illinois",517,494,23,1021,17,62965
"Red Bud city, Illinois",1895,1866,29,3798,17,63043
"Reddick village, Illinois",93,83,10,200,17,63056
"Redmon village, Illinois",91,88,3,150,17,63069
"Rentchler CDP, Illinois",0,0,0,0,17,63355
"Rest Haven CDP, Illinois",333,305,28,499,17,63382
"Reynolds village, Illinois",343,337,6,596,17,63420
"Richfield CDP, Illinois",0,0,0,0,17,63537
"Richmond village, Illinois",1250,1107,143,2266,17,63641
"Richton Park village, Illinois",6637,5820,817,12721,17,63706
"Richview village, Illinois",115,101,14,228,17,63719
"Ridge Farm village, Illinois",348,313,35,927,17,63862
"Ridgefield CDP, Illinois",287,287,0,380,17,63875
"Ridgewood CDP, Illinois",1888,1763,125,3242,17,64005
"Ridgway village, Illinois",380,376,4,742,17,64018
"Ridott village, Illinois",67,59,8,136,17,64044
"Riggston CDP, Illinois",4,4,0,18,17,64083
"Riley CDP, Illinois",0,0,0,0,17,64094
"Ringwood village, Illinois",420,414,6,779,17,64135
"Rio village, Illinois",106,101,5,195,17,64148
"Ripley village, Illinois",17,15,2,43,17,64174
"Ritchie CDP, Illinois",63,53,10,154,17,64239
"Riverdale village, Illinois",4750,3974,776,10528,17,64278
"River Forest village, Illinois",5750,5426,324,11568,17,64304
"River Grove village, Illinois",5256,5020,236,10532,17,64343
"Riverside village, Illinois",4647,4504,143,9225,17,64421
"Riverton village, Illinois",1996,1943,53,3525,17,64486
"Riverwoods village, Illinois",1788,1766,22,4007,17,64538
"Roanoke village, Illinois",1019,1003,16,2011,17,64590
"Robbins village, Illinois",1991,1699,292,4804,17,64616
"Roberts village, Illinois",222,199,23,494,17,64655
"Robinson city, Illinois",2995,2842,153,7089,17,64707
"Rochelle city, Illinois",5287,4712,575,9417,17,64746
"Rochester village, Illinois",1598,1535,63,3752,17,64759
"Rockbridge village, Illinois",49,49,0,135,17,64811
"Rock City village, Illinois",180,172,8,338,17,64837
"Rockdale village, Illinois",1373,1261,112,2446,17,64902
"Rock Falls city, Illinois",4531,4330,201,8904,17,64928
"Rockford city, Illinois",69481,63217,6264,148173,17,65000
"Rock Island city, Illinois",18301,16958,1343,37264,17,65078
"Rock Island Arsenal CDP, Illinois",188,143,45,375,17,65104
"Rockport CDP, Illinois",63,63,0,87,17,65130
"Rockton village, Illinois",4818,4617,201,8241,17,65156
"Rockwood village, Illinois",10,10,0,22,17,65221
"Rolling Meadows city, Illinois",14107,13397,710,24054,17,65338
"Rome CDP, Illinois",884,884,0,1605,17,65403
"Romeoville village, Illinois",22895,21578,1317,40132,17,65442
"Roodhouse city, Illinois",721,650,71,1636,17,65481
"Roscoe village, Illinois",5754,5601,153,11134,17,65611
"Rose Hill village, Illinois",17,17,0,40,17,65754
"Roselle village, Illinois",13336,12363,973,22846,17,65806
"Rosemont village, Illinois",2230,2134,96,3864,17,65819
"Roseville village, Illinois",375,358,17,925,17,65845
"Rosewood Heights CDP, Illinois",2002,1902,100,3920,17,65884
"Rosiclare city, Illinois",320,291,29,975,17,65897
"Rossville village, Illinois",506,496,10,1198,17,65962
"Round Lake village, Illinois",10332,9798,534,18677,17,66027
"Round Lake Beach village, Illinois",14978,13982,996,27229,17,66040
"Round Lake Heights village, Illinois",1472,1404,68,2687,17,66053
"Round Lake Park village, Illinois",3449,3105,344,7778,17,66066
"Roxana village, Illinois",762,739,23,1570,17,66131
"Royal village, Illinois",183,178,5,339,17,66157
"Royal Lakes village, Illinois",36,25,11,273,17,66196
"Royalton village, Illinois",476,476,0,1067,17,66209
"Ruma village, Illinois",238,229,9,519,17,66287
"Rushville city, Illinois",1394,1277,117,2610,17,66339
"Russellville village, Illinois",42,41,1,74,17,66404
"Rutland village, Illinois",100,98,2,205,17,66443
"Sadorus village, Illinois",177,174,3,334,17,66534
"Sailor Springs village, Illinois",55,47,8,101,17,66599
"St. Anne village, Illinois",487,442,45,1030,17,66638
"St. Augustine village, Illinois",59,56,3,125,17,66677
"St. Charles city, Illinois",18763,18038,725,32776,17,66703
"St. David village, Illinois",241,239,2,540,17,66768
"St. Elmo city, Illinois",645,596,49,1404,17,66794
"Ste. Marie village, Illinois",142,137,5,289,17,66800
"St. Francisville city, Illinois",340,282,58,669,17,66833
"St. Jacob village, Illinois",768,754,14,1597,17,66859
"St. Johns village, Illinois",84,81,3,172,17,66924
"St. Joseph village, Illinois",2001,1986,15,3931,17,66950
"St. Libory village, Illinois",388,371,17,637,17,66989
"St. Peter village, Illinois",121,121,0,289,17,67132
"St. Rose village, Illinois",317,317,0,529,17,67158
"Salem city, Illinois",3624,3462,162,7228,17,67236
"Sammons Point village, Illinois",98,91,7,184,17,67372
"Sandoval village, Illinois",385,351,34,982,17,67444
"Sandwich city, Illinois",3657,3461,196,7139,17,67548
"San Jose village, Illinois",353,311,42,614,17,67613
"Sauget village, Illinois",97,71,26,270,17,67756
"Sauk Village village, Illinois",4579,3851,728,9862,17,67769
"Saunemin village, Illinois",193,182,11,426,17,67795
"Savanna city, Illinois",1239,1164,75,2783,17,67821
"Savoy village, Illinois",4259,4201,58,8682,17,67860
"Sawyerville village, Illinois",88,83,5,199,17,67873
"Saybrook village, Illinois",287,278,9,734,17,67912
"Scales Mound village, Illinois",207,201,6,434,17,67925
"Schaumburg village, Illinois",42773,41102,1671,77571,17,68003
"Schiller Park village, Illinois",6268,6006,262,11600,17,68081
"Schram City village, Illinois",310,273,37,637,17,68120
"Sciota village, Illinois",40,40,0,74,17,68198
"Scott AFB CDP, Illinois",1073,1054,19,4023,17,68328
"Scottville village, Illinois",47,28,19,81,17,68406
"Seaton village, Illinois",129,114,15,274,17,68458
"Seatonville village, Illinois",202,187,15,432,17,68471
"Secor village, Illinois",148,124,24,254,17,68510
"Seneca village, Illinois",1213,1167,46,2565,17,68640
"Serena CDP, Illinois",75,57,18,206,17,68679
"Sesser city, Illinois",852,771,81,1909,17,68705
"Seymour CDP, Illinois",167,167,0,283,17,68809
"Shabbona village, Illinois",359,339,20,788,17,68822
"Shannon village, Illinois",360,344,16,697,17,68991
"Shawneetown city, Illinois",499,468,31,1183,17,69082
"Sheffield village, Illinois",424,402,22,801,17,69147
"Shelbyville city, Illinois",2289,2203,86,4156,17,69186
"Sheldon village, Illinois",749,629,120,1320,17,69212
"Sheridan village, Illinois",612,573,39,2694,17,69277
"Sherman village, Illinois",2234,2168,66,4120,17,69342
"Sherrard village, Illinois",422,398,24,766,17,69368
"Shiloh village, Illinois",7025,6891,134,13892,17,69524
"Shipman town, Illinois",251,227,24,668,17,69563
"Shirley CDP, Illinois",16,16,0,62,17,69628
"Shorewood village, Illinois",8884,8445,439,18109,17,69758
"Shumway village, Illinois",108,106,2,187,17,69797
"Sibley village, Illinois",89,83,6,222,17,69810
"Sidell village, Illinois",179,169,10,490,17,69836
"Sidney village, Illinois",529,498,31,980,17,69875
"Sigel town, Illinois",234,225,9,469,17,69914
"Silvis city, Illinois",4025,3750,275,7936,17,69979
"Simpson village, Illinois",30,28,2,52,17,70005
"Sims village, Illinois",83,79,4,183,17,70031
"Skokie village, Illinois",33476,31680,1796,67076,17,70122
"Sleepy Hollow village, Illinois",1855,1819,36,3205,17,70161
"Smithboro village, Illinois",106,86,20,229,17,70213
"Smithfield village, Illinois",77,67,10,159,17,70226
"Smithton village, Illinois",2124,2041,83,3909,17,70252
"Smithville CDP, Illinois",121,121,0,213,17,70278
"Solon Mills CDP, Illinois",134,98,36,404,17,70356
"Somonauk village, Illinois",883,853,30,1797,17,70460
"Sorento village, Illinois",209,198,11,498,17,70525
"South Barrington village, Illinois",2334,2292,42,5001,17,70564
"South Beloit city, Illinois",4205,3998,207,7943,17,70590
"South Chicago Heights village, Illinois",1771,1696,75,3986,17,70629
"South Elgin village, Illinois",13981,13502,479,23841,17,70720
"Southern View village, Illinois",987,898,89,1784,17,70759
"South Holland village, Illinois",10322,8868,1454,21287,17,70850
"South Jacksonville village, Illinois",1467,1314,153,3286,17,70889
"South Pekin village, Illinois",478,439,39,1003,17,71175
"South Roxana village, Illinois",1081,992,89,2121,17,71240
"South Wilmington village, Illinois",297,284,13,624,17,71370
"Sparland village, Illinois",169,157,12,360,17,71422
"Sparta city, Illinois",1971,1848,123,4107,17,71448
"Spaulding village, Illinois",556,532,24,965,17,71474
"Spillertown village, Illinois",166,159,7,315,17,71526
"Spring Bay village, Illinois",219,206,13,484,17,71604
"Springerton village, Illinois",46,46,0,83,17,71643
"Springfield city, Illinois",55960,52243,3717,114214,17,72000
"Spring Grove village, Illinois",3092,2816,276,5694,17,72052
"Spring Valley city, Illinois",2668,2464,204,5518,17,72156
"Standard village, Illinois",143,136,7,300,17,72221
"Standard City village, Illinois",71,67,4,194,17,72234
"Stanford village, Illinois",303,281,22,531,17,72260
"Staunton city, Illinois",2313,2273,40,4577,17,72403
"Steeleville village, Illinois",846,794,52,1757,17,72468
"Steger village, Illinois",4595,4390,205,9518,17,72520
"Sterling city, Illinois",7544,7159,385,14852,17,72546
"Steward village, Illinois",185,178,7,262,17,72624
"Stewardson village, Illinois",369,358,11,808,17,72650
"Stickney village, Illinois",3243,3094,149,7031,17,72676
"Stillman Valley village, Illinois",568,554,14,1177,17,72702
"Stockton village, Illinois",860,822,38,1610,17,72780
"Stonefort village, Illinois",156,146,10,396,17,72884
"Stone Park village, Illinois",2313,2149,164,4566,17,72923
"Stonington village, Illinois",374,355,19,728,17,72949
"Stoy village, Illinois",76,73,3,162,17,73027
"Strasburg village, Illinois",248,240,8,535,17,73040
"Strawn village, Illinois",42,42,0,77,17,73131
"Streamwood village, Illinois",21988,21226,762,39556,17,73157
"Streator city, Illinois",6120,5566,554,12279,17,73170
"Stronghurst village, Illinois",478,447,31,1053,17,73261
"Sublette village, Illinois",203,196,7,359,17,73287
"Sugar Grove village, Illinois",4581,4409,172,9251,17,73391
"Sullivan city, Illinois",2098,1980,118,4408,17,73495
"Summerfield village, Illinois",252,230,22,408,17,73547
"Summit village, Illinois",5186,4818,368,11036,17,73638
"Sumner city, Illinois",349,294,55,2411,17,73703
"Sunnyland CDP, Illinois",185,164,21,512,17,73872
"Sun River Terrace village, Illinois",198,198,0,613,17,73943
"Swansea village, Illinois",7863,7447,416,14888,17,74119
"Swedona CDP, Illinois",12,12,0,32,17,74145
"Sycamore city, Illinois",9882,9568,314,18171,17,74223
"Symerton village, Illinois",38,34,4,73,17,74275
"Table Grove village, Illinois",151,137,14,303,17,74301
"Tallula village, Illinois",326,275,51,599,17,74379
"Tamaroa village, Illinois",316,304,12,594,17,74444
"Tamms village, Illinois",162,158,4,535,17,74457
"Tampico village, Illinois",440,416,24,745,17,74470
"Taylor Ridge CDP, Illinois",47,47,0,131,17,74548
"Taylor Springs village, Illinois",182,175,7,663,17,74561
"Taylorville city, Illinois",5067,4797,270,11318,17,74574
"Tennessee village, Illinois",79,72,7,119,17,74665
"Teutopolis village, Illinois",1092,1073,19,1811,17,74743
"Thawville village, Illinois",81,79,2,206,17,74847
"Thayer village, Illinois",318,302,16,553,17,74860
"Thebes village, Illinois",131,118,13,407,17,74873
"The Galena Territory CDP, Illinois",622,616,6,1606,17,74970
"Third Lake village, Illinois",650,626,24,1214,17,75081
"Thomasboro village, Illinois",543,521,22,1023,17,75107
"Thompsonville village, Illinois",276,240,36,544,17,75159
"Thomson village, Illinois",253,241,12,1284,17,75172
"Thornton village, Illinois",1180,1113,67,2169,17,75185
"Tilden village, Illinois",352,316,36,824,17,75263
"Tilton village, Illinois",1345,1268,77,2694,17,75276
"Timberlane village, Illinois",985,856,129,1458,17,75360
"Time village, Illinois",5,5,0,17,17,75419
"Tinley Park village, Illinois",30994,29215,1779,55571,17,75484
"Tiskilwa village, Illinois",355,343,12,746,17,75549
"Toledo village, Illinois",648,639,9,1181,17,75601
"Tolono village, Illinois",2236,1978,258,3567,17,75614
"Toluca city, Illinois",533,503,30,1246,17,75653
"Tonica village, Illinois",380,374,6,698,17,75718
"Topeka village, Illinois",21,16,5,33,17,75757
"Toulon city, Illinois",542,526,16,1368,17,75783
"Tovey village, Illinois",335,333,2,630,17,75809
"Towanda village, Illinois",247,245,2,426,17,75822
"Tower Hill village, Illinois",184,176,8,427,17,75848
"Tower Lakes village, Illinois",671,645,26,1282,17,75874
"Tremont village, Illinois",1161,1153,8,2237,17,75965
"Trenton city, Illinois",1265,1220,45,2684,17,75991
"Trilla CDP, Illinois",38,38,0,128,17,76017
"Triumph CDP, Illinois",85,85,0,85,17,76082
"Trivoli CDP, Illinois",277,277,0,434,17,76108
"Trout Valley village, Illinois",358,351,7,593,17,76160
"Troy city, Illinois",5557,5391,166,10920,17,76199
"Troy Grove village, Illinois",145,143,2,269,17,76225
"Tuscola city, Illinois",2640,2585,55,4707,17,76407
"Twin Grove CDP, Illinois",738,732,6,1412,17,76511
"Ullin village, Illinois",262,253,9,538,17,76615
"Union village, Illinois",349,347,2,568,17,76706
"Union Hill village, Illinois",35,35,0,60,17,76771
"Unity CDP, Illinois",35,29,6,54,17,76875
"University Park village, Illinois",3723,3340,383,7328,17,76935
"Urbana city, Illinois",20270,19111,1159,38741,17,77005
"Ursa village, Illinois",279,258,21,558,17,77044
"Valier village, Illinois",229,219,10,712,17,77148
"Valley City village, Illinois",16,16,0,38,17,77187
"Valmeyer village, Illinois",740,723,17,1196,17,77265
"Vandalia city, Illinois",2363,2289,74,6058,17,77317
"Varna village, Illinois",206,189,17,438,17,77395
"Venedy village, Illinois",75,66,9,133,17,77408
"Venetian Village CDP, Illinois",1434,1388,46,2723,17,77460
"Venice city, Illinois",892,727,165,1762,17,77473
"Vergennes village, Illinois",135,120,15,295,17,77525
"Vermilion village, Illinois",71,67,4,197,17,77551
"Vermont village, Illinois",319,305,14,646,17,77642
"Vernon village, Illinois",41,39,2,89,17,77681
"Vernon Hills village, Illinois",14540,14007,533,26750,17,77694
"Verona village, Illinois",144,132,12,259,17,77707
"Versailles village, Illinois",159,155,4,369,17,77720
"Victoria village, Illinois",146,138,8,250,17,77811
"Vienna city, Illinois",828,808,20,2319,17,77863
"Villa Grove city, Illinois",1327,1220,107,2418,17,77941
"Villa Park village, Illinois",13133,12590,543,22753,17,77993
"Viola village, Illinois",542,503,39,1033,17,78123
"Virden city, Illinois",1536,1430,106,3208,17,78149
"Virgil village, Illinois",173,172,1,308,17,78175
"Virginia city, Illinois",725,698,27,1490,17,78201
"Volo village, Illinois",3598,3511,87,6368,17,78227
"Wadsworth village, Illinois",1895,1652,243,3448,17,78370
"Waggoner village, Illinois",100,89,11,162,17,78383
"Walnut village, Illinois",765,719,46,1348,17,78526
"Walnut Hill village, Illinois",31,29,2,118,17,78604
"Walshville village, Illinois",78,64,14,151,17,78656
"Waltonville village, Illinois",200,194,6,371,17,78708
"Wamac city, Illinois",376,332,44,896,17,78721
"Wapella village, Illinois",298,295,3,520,17,78773
"Warren village, Illinois",722,675,47,1548,17,78851
"Warrensburg village, Illinois",592,567,25,1203,17,78916
"Warrenville city, Illinois",8494,8199,295,13945,17,78929
"Warsaw city, Illinois",751,649,102,1538,17,78942
"Washburn village, Illinois",548,539,9,1127,17,79007
"Washington city, Illinois",7575,7452,123,15988,17,79033
"Washington Park village, Illinois",963,810,153,2661,17,79085
"Wataga village, Illinois",438,427,11,765,17,79124
"Waterloo city, Illinois",5767,5594,173,11012,17,79150
"Waterman village, Illinois",825,804,21,1510,17,79163
"Watseka city, Illinois",2002,1923,79,4361,17,79228
"Watson village, Illinois",383,361,22,631,17,79241
"Wauconda village, Illinois",7869,7702,167,14040,17,79267
"Waukegan city, Illinois",46346,43869,2477,89435,17,79293
"Waverly city, Illinois",640,623,17,1497,17,79358
"Wayne village, Illinois",1389,1349,40,2225,17,79397
"Wayne City village, Illinois",399,380,19,973,17,79436
"Waynesville village, Illinois",261,239,22,467,17,79449
"Wedron CDP, Illinois",86,86,0,145,17,79618
"Weldon village, Illinois",140,133,7,298,17,79683
"Wellington village, Illinois",94,91,3,227,17,79735
"Wenona city, Illinois",506,484,22,1047,17,79813
"Wenonah village, Illinois",14,12,2,27,17,79826
"West Brooklyn village, Illinois",57,56,1,153,17,80008
"Westchester village, Illinois",9350,8847,503,16694,17,80047
"West Chicago city, Illinois",14634,13106,1528,25632,17,80060
"West City village, Illinois",272,253,19,640,17,80073
"West Dundee village, Illinois",4806,4598,208,7845,17,80125
"Western Springs village, Illinois",6134,5978,156,13557,17,80242
"Westervelt CDP, Illinois",9,9,0,28,17,80255
"Westfield village, Illinois",237,222,15,503,17,80281
"West Frankfort city, Illinois",2997,2613,384,7168,17,80333
"Westlake Village CDP, Illinois",818,771,47,1446,17,80570
"West Liberty CDP, Illinois",33,33,0,69,17,80580
"Westmont village, Illinois",12932,12494,438,24271,17,80645
"West Peoria city, Illinois",2075,1966,109,4248,17,80736
"West Point village, Illinois",90,90,0,239,17,80762
"West Salem village, Illinois",317,281,36,769,17,80853
"West Union CDP, Illinois",102,102,0,197,17,80879
"Westville village, Illinois",1525,1464,61,3470,17,80931
"West York CDP, Illinois",91,91,0,133,17,80957
"Wheaton city, Illinois",27975,26993,982,53673,17,81048
"Wheeler village, Illinois",53,49,4,123,17,81074
"Wheeling village, Illinois",23178,21979,1199,38823,17,81087
"Whiteash CDP, Illinois",108,108,0,189,17,81165
"White City village, Illinois",136,131,5,226,17,81191
"White Hall city, Illinois",867,838,29,2176,17,81256
"White Heath CDP, Illinois",115,115,0,171,17,81295
"Williamsfield village, Illinois",290,288,2,554,17,81802
"Williamson village, Illinois",71,71,0,154,17,81815
"Williamsville village, Illinois",811,794,17,1468,17,81854
"Willisville village, Illinois",248,214,34,484,17,81867
"Willowbrook village, Illinois",4912,4720,192,9177,17,81919
"Willowbrook CDP, Illinois",1353,1310,43,2539,17,81938
"Willow Hill village, Illinois",82,70,12,256,17,82010
"Willow Lake CDP, Illinois",437,437,0,834,17,82029
"Willow Springs village, Illinois",3235,3082,153,5862,17,82049
"Wilmette village, Illinois",12730,12184,546,27801,17,82075
"Wilmington village, Illinois",62,62,0,124,17,82088
"Wilmington city, Illinois",3012,2885,127,5525,17,82101
"Wilsonville village, Illinois",247,239,8,519,17,82218
"Wilton Center CDP, Illinois",72,72,0,158,17,82257
"Winchester city, Illinois",741,707,34,1541,17,82270
"Windsor village, Illinois",447,435,12,789,17,82309
"Windsor city, Illinois",500,481,19,1116,17,82322
"Winfield village, Illinois",5449,5202,247,9947,17,82400
"Winnebago village, Illinois",1611,1562,49,3003,17,82491
"Winnetka village, Illinois",5189,4999,190,12607,17,82530
"Winslow village, Illinois",185,185,0,322,17,82543
"Winthrop Harbor village, Illinois",3746,3312,434,6693,17,82686
"Witt city, Illinois",411,371,40,935,17,82725
"Wonder Lake village, Illinois",2035,1882,153,3833,17,82855
"Wood Dale city, Illinois",8081,7712,369,13903,17,82985
"Woodhull village, Illinois",400,397,3,771,17,83063
"Woodland village, Illinois",114,106,8,310,17,83102
"Woodlawn village, Illinois",314,277,37,635,17,83206
"Woodridge village, Illinois",19608,18849,759,34027,17,83245
"Wood River city, Illinois",5429,5096,333,10313,17,83271
"Woodson village, Illinois",264,259,5,527,17,83336
"Woodstock city, Illinois",14699,13994,705,26084,17,83349
"Worden village, Illinois",491,460,31,875,17,83505
"Worth village, Illinois",5726,5106,620,10859,17,83518
"Wyanet village, Illinois",571,532,39,1035,17,83622
"Wyoming city, Illinois",748,715,33,1583,17,83687
"Xenia village, Illinois",156,140,16,323,17,83739
"Yale village, Illinois",38,38,0,84,17,83765
"Yates City village, Illinois",376,372,4,707,17,83817
"Yorkville city, Illinois",11290,10817,473,21273,17,84038
"Zeigler city, Illinois",699,639,60,1503,17,84155
"Zion city, Illinois",12742,11926,816,24570,17,84220
"Aberdeen CDP, Indiana",972,956,16,1756,18,00140
"Abington CDP, Indiana",64,64,0,255,18,00154
"Adams CDP, Indiana",44,44,0,190,18,00352
"Adams Lake CDP, Indiana",97,97,0,270,18,00532
"Advance town, Indiana",232,229,3,412,18,00640
"Akron town, Indiana",540,481,59,1062,18,00748
"Alamo town, Indiana",25,23,2,56,18,00784
"Albany town, Indiana",1236,1189,47,2854,18,00802
"Albion town, Indiana",1294,1278,16,2835,18,00820
"Alexandria city, Indiana",2586,2380,206,5144,18,00910
"Alford CDP, Indiana",47,47,0,187,18,00946
"Alfordsville town, Indiana",11,11,0,39,18,00964
"Alton town, Indiana",6,6,0,13,18,01270
"Altona town, Indiana",177,173,4,421,18,01288
"Ambia town, Indiana",93,83,10,230,18,01342
"Amboy town, Indiana",169,161,8,379,18,01360
"Americus CDP, Indiana",179,179,0,286,18,01396
"Amity CDP, Indiana",169,169,0,337,18,01432
"Amo town, Indiana",197,192,5,422,18,01450
"Anderson city, Indiana",25603,23802,1801,55011,18,01468
"Andersonville CDP, Indiana",100,100,0,271,18,01594
"Andrews town, Indiana",481,475,6,1113,18,01612
"Angola city, Indiana",4856,4566,290,9317,18,01666
"Anoka CDP, Indiana",110,99,11,294,18,01738
"Antioch CDP, Indiana",79,72,7,161,18,01810
"Arcadia town, Indiana",815,777,38,1517,18,01954
"Arcola CDP, Indiana",155,146,9,237,18,01990
"Ardmore CDP, Indiana",867,838,29,1671,18,02026
"Argos town, Indiana",866,793,73,1762,18,02044
"Arlington CDP, Indiana",218,182,36,469,18,02116
"Arthur CDP, Indiana",105,105,0,198,18,02296
"Ashley town, Indiana",596,588,8,1135,18,02458
"Atlanta town, Indiana",350,313,37,773,18,02602
"Attica city, Indiana",1607,1490,117,3066,18,02620
"Auburn city, Indiana",7138,6745,393,13316,18,02674
"Aurora city, Indiana",1869,1792,77,3301,18,02782
"Austin city, Indiana",1772,1704,68,3596,18,02800
"Avilla town, Indiana",1385,1349,36,2702,18,02872
"Avoca CDP, Indiana",289,289,0,406,18,02890
"Avon town, Indiana",12650,12172,478,21783,18,02908
"Azalia CDP, Indiana",35,35,0,140,18,03052
"Bainbridge town, Indiana",267,264,3,592,18,03142
"Barbee CDP, Indiana",459,442,17,1104,18,03358
"Bargersville town, Indiana",4807,4441,366,9520,18,03394
"Bass Lake CDP, Indiana",391,348,43,1018,18,03610
"Batesville city, Indiana",3777,3637,140,7052,18,03664
"Battle Ground town, Indiana",1110,1057,53,2073,18,03718
"Bear Lake CDP, Indiana",63,39,24,116,18,03898
"Beaver Dam CDP, Indiana",54,54,0,109,18,04032
"Bedford city, Indiana",6359,6160,199,13802,18,04114
"Beech Grove city, Indiana",7953,7529,424,15181,18,04204
"Belleville CDP, Indiana",245,245,0,564,18,04456
"Bennetts Switch CDP, Indiana",133,133,0,458,18,04726
"Benton CDP, Indiana",391,381,10,582,18,04780
"Berne city, Indiana",1830,1750,80,3926,18,04888
"Bethany town, Indiana",21,21,0,37,18,04978
"Bethel Village CDP, Indiana",317,317,0,400,18,05050
"Beverly Shores town, Indiana",172,168,4,578,18,05158
"Bicknell city, Indiana",1531,1499,32,2818,18,05176
"Big Lake CDP, Indiana",232,232,0,442,18,05230
"Billtown CDP, Indiana",71,61,10,146,18,05284
"Bippus CDP, Indiana",55,55,0,98,18,05338
"Birdseye town, Indiana",192,185,7,340,18,05374
"Blairsville CDP, Indiana",35,35,0,130,18,05644
"Blanford CDP, Indiana",88,70,18,156,18,05662
"Blocher CDP, Indiana",9,9,0,68,18,05680
"Bloomfield town, Indiana",1009,917,92,2337,18,05716
"Bloomingdale town, Indiana",157,147,10,402,18,05788
"Blooming Grove CDP, Indiana",99,99,0,282,18,05806
"Bloomington city, Indiana",41604,38910,2694,79006,18,05860
"Blountsville town, Indiana",41,32,9,109,18,05896
"Blue Ridge CDP, Indiana",61,61,0,137,18,06022
"Bluffton city, Indiana",5501,5280,221,10461,18,06220
"Boggstown CDP, Indiana",117,117,0,560,18,06292
"Boone Grove CDP, Indiana",15,15,0,29,18,06598
"Boonville city, Indiana",2938,2865,73,6670,18,06616
"Borden town, Indiana",436,428,8,957,18,06634
"Boston town, Indiana",113,104,9,227,18,06652
"Boswell town, Indiana",278,270,8,696,18,06706
"Bourbon town, Indiana",854,831,23,1747,18,06760
"Bowling Green CDP, Indiana",178,178,0,357,18,06832
"Boxley CDP, Indiana",52,26,26,101,18,06904
"Brazil city, Indiana",3275,3068,207,8114,18,07174
"Bremen town, Indiana",2215,2215,0,4667,18,07318
"Bretzville CDP, Indiana",132,132,0,215,18,07426
"Bridgeton CDP, Indiana",35,35,0,48,18,07570
"Bright CDP, Indiana",3195,3133,62,5858,18,07624
"Brimfield CDP, Indiana",83,83,0,238,18,07678
"Bringhurst CDP, Indiana",38,38,0,65,18,07714
"Bristol town, Indiana",927,924,3,1862,18,07750
"Brook town, Indiana",498,469,29,960,18,07966
"Brooklyn town, Indiana",1044,1030,14,2248,18,08038
"Brooksburg town, Indiana",39,39,0,59,18,08092
"Brookston town, Indiana",917,905,12,1641,18,08146
"Brookville town, Indiana",1269,1262,7,2619,18,08182
"Brownsburg town, Indiana",15869,15680,189,29379,18,08416
"Browns Crossing CDP, Indiana",346,346,0,683,18,08434
"Brownstown town, Indiana",1179,1157,22,3015,18,08470
"Brownsville CDP, Indiana",54,54,0,173,18,08524
"Bruceville town, Indiana",271,264,7,474,18,08578
"Bryant town, Indiana",83,69,14,258,18,08704
"Buck Creek CDP, Indiana",57,57,0,90,18,08812
"Buckskin CDP, Indiana",28,28,0,59,18,08848
"Buffalo CDP, Indiana",553,553,0,776,18,08992
"Bunker Hill town, Indiana",431,380,51,848,18,09136
"Burket town, Indiana",136,136,0,200,18,09226
"Burlington town, Indiana",326,314,12,633,18,09244
"Burnett CDP, Indiana",40,31,9,200,18,09298
"Burnettsville town, Indiana",154,153,1,359,18,09316
"Burney CDP, Indiana",31,20,11,31,18,09334
"Burns City CDP, Indiana",45,45,0,80,18,09352
"Burns Harbor town, Indiana",1255,1246,9,2409,18,09370
"Burrows CDP, Indiana",37,37,0,97,18,09460
"Butler city, Indiana",1137,1091,46,2746,18,09532
"Butlerville CDP, Indiana",82,81,1,180,18,09622
"Cadiz town, Indiana",114,110,4,181,18,09712
"Cambridge City town, Indiana",808,754,54,1476,18,09874
"Camden town, Indiana",305,302,3,627,18,09910
"Campbellsburg town, Indiana",234,220,14,666,18,10000
"Canaan CDP, Indiana",25,25,0,130,18,10036
"Cannelburg town, Indiana",61,55,6,174,18,10090
"Cannelton city, Indiana",524,446,78,1481,18,10108
"Canton CDP, Indiana",23,23,0,133,18,10144
"Carbon town, Indiana",155,142,13,328,18,10198
"Carlisle town, Indiana",269,245,24,500,18,10270
"Carmel city, Indiana",54472,53071,1401,99453,18,10342
"Carrollton CDP, Indiana",250,250,0,420,18,10558
"Cartersburg CDP, Indiana",0,0,0,0,18,10594
"Carthage town, Indiana",314,270,44,754,18,10612
"Cass CDP, Indiana",10,10,0,31,18,10774
"Cassville CDP, Indiana",101,101,0,291,18,10828
"Cates CDP, Indiana",8,8,0,130,18,10900
"Cayuga town, Indiana",366,357,9,1158,18,10954
"Cedar Grove town, Indiana",114,108,6,206,18,11044
"Cedar Lake town, Indiana",7488,7064,424,14215,18,11062
"Celestine CDP, Indiana",297,297,0,433,18,11134
"Centenary CDP, Indiana",0,0,0,42,18,11188
"Center CDP, Indiana",135,135,0,268,18,11404
"Center Point town, Indiana",176,173,3,377,18,11746
"Centerton CDP, Indiana",46,46,0,180,18,11782
"Centerville town, Indiana",1236,1172,64,2760,18,11836
"Chain-O-Lakes CDP, Indiana",154,154,0,611,18,11926
"Chalmers town, Indiana",246,244,2,475,18,11944
"Chandler town, Indiana",2051,1851,200,3726,18,12034
"Charlestown city, Indiana",3956,3881,75,7986,18,12124
"Charlottesville CDP, Indiana",185,185,0,378,18,12196
"Chesterfield town, Indiana",1157,1067,90,2588,18,12376
"Chesterton town, Indiana",7415,6807,608,14191,18,12412
"Chili CDP, Indiana",38,38,0,59,18,12502
"Chrisney town, Indiana",217,202,15,443,18,12574
"Churubusco town, Indiana",1029,998,31,1829,18,12610
"Cicero town, Indiana",2697,2673,24,5356,18,12628
"Clarksburg CDP, Indiana",0,0,0,19,18,12880
"Clarks Hill town, Indiana",341,323,18,698,18,12898
"Clarksville town, Indiana",12009,11484,525,22087,18,12934
"Clay City town, Indiana",602,588,14,1135,18,13276
"Claypool town, Indiana",187,177,10,349,18,13312
"Clayton town, Indiana",616,595,21,1027,18,13366
"Clear Lake town, Indiana",168,164,4,396,18,13438
"Clermont town, Indiana",919,891,28,1624,18,13492
"Clifford town, Indiana",149,144,5,251,18,13582
"Clinton city, Indiana",2345,2038,307,4821,18,13780
"Cloverdale town, Indiana",1082,1011,71,2201,18,13852
"Cloverland CDP, Indiana",194,190,4,255,18,13888
"Coal City CDP, Indiana",22,22,0,70,18,13978
"Coalmont CDP, Indiana",149,149,0,274,18,14032
"Coatesville town, Indiana",275,264,11,504,18,14050
"Coesse CDP, Indiana",97,97,0,142,18,14104
"Colburn CDP, Indiana",34,34,0,72,18,14176
"Colfax town, Indiana",460,435,25,958,18,14284
"Columbia City city, Indiana",4903,4705,198,9478,18,14716
"Columbus city, Indiana",26487,25418,1069,50896,18,14734
"Commiskey CDP, Indiana",56,56,0,88,18,14788
"Connersville city, Indiana",6071,5720,351,13395,18,14932
"Converse town, Indiana",443,439,4,967,18,14986
"Cordry Sweetwater Lakes CDP, Indiana",750,736,14,1328,18,15115
"Cortland CDP, Indiana",15,15,0,97,18,15202
"Corunna town, Indiana",93,91,2,137,18,15220
"Cory CDP, Indiana",86,86,0,163,18,15238
"Corydon town, Indiana",1417,1394,23,3153,18,15256
"Country Club Heights town, Indiana",90,88,2,176,18,15364
"Country Squire Lakes CDP, Indiana",1713,1463,250,3021,18,15409
"Covington city, Indiana",1383,1341,42,3039,18,15490
"Cowan CDP, Indiana",37,37,0,84,18,15526
"Craigville CDP, Indiana",126,126,0,183,18,15616
"Crandall town, Indiana",92,88,4,235,18,15634
"Crane town, Indiana",103,99,4,275,18,15652
"Crawfordsville city, Indiana",8164,7728,436,16335,18,15742
"Cree Lake CDP, Indiana",95,78,17,252,18,15778
"Cromwell town, Indiana",254,223,31,543,18,15994
"Cross Plains CDP, Indiana",37,37,0,89,18,16030
"Crothersville town, Indiana",656,644,12,1796,18,16084
"Crown Point city, Indiana",16122,15432,690,33735,18,16138
"Crows Nest town, Indiana",29,29,0,93,18,16156
"Culver town, Indiana",494,460,34,1230,18,16300
"Cumberland town, Indiana",3698,3584,114,5991,18,16336
"Cutler CDP, Indiana",0,0,0,59,18,16480
"Cynthiana town, Indiana",257,251,6,702,18,16534
"Dale town, Indiana",555,541,14,1427,18,16624
"Daleville town, Indiana",730,670,60,1426,18,16642
"Dana town, Indiana",377,360,17,678,18,16732
"Danville town, Indiana",5815,5725,90,10842,18,16804
"Darlington town, Indiana",364,352,12,805,18,16840
"Darmstadt town, Indiana",674,657,17,1261,18,16858
"Dayton town, Indiana",584,569,15,1099,18,17002
"Decatur city, Indiana",4435,4307,128,9718,18,17074
"Decker town, Indiana",99,99,0,170,18,17110
"Deer Creek CDP, Indiana",57,57,0,165,18,17245
"Delaware CDP, Indiana",177,177,0,346,18,17506
"Delphi city, Indiana",1126,1070,56,2985,18,17614
"De Motte town, Indiana",1634,1616,18,4182,18,17722
"Denver town, Indiana",285,281,4,579,18,17776
"Depauw CDP, Indiana",56,39,17,126,18,17794
"Deputy CDP, Indiana",8,8,0,19,18,17812
"Dillsboro town, Indiana",861,834,27,1737,18,18190
"Donaldson CDP, Indiana",0,0,0,0,18,18388
"Dover Hill CDP, Indiana",41,41,0,50,18,18550
"Dresser CDP, Indiana",19,19,0,53,18,18658
"Dublin town, Indiana",453,434,19,961,18,18766
"Dubois CDP, Indiana",285,285,0,407,18,18784
"Dugger town, Indiana",403,385,18,788,18,18892
"Dune Acres town, Indiana",165,156,9,293,18,18982
"Duneland Beach CDP, Indiana",72,72,0,161,18,19000
"Dunkirk city, Indiana",787,750,37,1792,18,19054
"Dunlap CDP, Indiana",3420,3322,98,6799,18,19072
"Dunreith town, Indiana",101,88,13,204,18,19162
"Dupont town, Indiana",112,109,3,238,18,19180
"Dyer town, Indiana",8586,8280,306,16407,18,19270
"Earl Park town, Indiana",198,196,2,317,18,19450
"East Chicago city, Indiana",11532,10786,746,26363,18,19486
"East Enterprise CDP, Indiana",56,56,0,125,18,19576
"East Germantown town, Indiana",128,128,0,232,18,19756
"East Oolitic CDP, Indiana",58,58,0,140,18,19936
"Eaton town, Indiana",873,831,42,1687,18,20080
"Eckerty CDP, Indiana",7,7,0,56,18,20134
"Economy town, Indiana",70,66,4,131,18,20152
"Eden CDP, Indiana",93,80,13,123,18,20188
"Edgewood town, Indiana",979,960,19,1969,18,20332
"Edinburgh town, Indiana",2436,2238,198,4144,18,20404
"Edwardsport town, Indiana",133,127,6,281,18,20458
"Elberfeld town, Indiana",469,436,33,868,18,20638
"Elizabeth town, Indiana",66,65,1,125,18,20674
"Elizabethtown town, Indiana",173,165,8,310,18,20692
"Elizaville CDP, Indiana",18,18,0,36,18,20710
"Elkhart city, Indiana",25936,24912,1024,53785,18,20728
"Ellettsville town, Indiana",3694,3630,64,6653,18,20800
"Elnora town, Indiana",254,247,7,528,18,20998
"Elrod CDP, Indiana",11,11,0,11,18,21034
"Elwood city, Indiana",4370,4087,283,8339,18,21070
"Eminence CDP, Indiana",49,49,0,164,18,21106
"Emison CDP, Indiana",5,5,0,34,18,21124
"Enchanted Hills CDP, Indiana",619,583,36,1076,18,21178
"English town, Indiana",299,290,9,1101,18,21214
"Etna Green town, Indiana",304,297,7,527,18,21502
"Eugene CDP, Indiana",52,52,0,160,18,21538
"Evansville city, Indiana",60531,57095,3436,116906,18,22000
"Everton CDP, Indiana",275,275,0,591,18,22072
"Fairbanks CDP, Indiana",249,182,67,329,18,22180
"Fairland town, Indiana",289,285,4,639,18,22396
"Fairmount town, Indiana",1088,1009,79,2582,18,22432
"Fair Oaks CDP, Indiana",108,108,0,317,18,22468
"Fairview CDP, Indiana",25,25,0,83,18,22540
"Fairview Park town, Indiana",657,646,11,1393,18,22576
"Farmersburg town, Indiana",534,525,9,1224,18,22738
"Farmland town, Indiana",591,563,28,1298,18,22792
"Ferdinand town, Indiana",1151,1138,13,2428,18,22990
"Fillmore town, Indiana",376,365,11,767,18,23188
"Fishers city, Indiana",54380,53021,1359,99041,18,23278
"Fishersburg CDP, Indiana",98,98,0,136,18,23296
"Fish Lake CDP, Indiana",492,466,26,782,18,23386
"Flat Rock CDP, Indiana",121,121,0,253,18,23566
"Flora town, Indiana",1157,1116,41,2128,18,23692
"Florence CDP, Indiana",60,60,0,81,18,23728
"Floyds Knobs CDP, Indiana",2470,2381,89,4575,18,23800
"Folsomville CDP, Indiana",97,97,0,195,18,23836
"Fontanet CDP, Indiana",109,77,32,148,18,23854
"Forest CDP, Indiana",66,66,0,268,18,23926
"Fort Branch town, Indiana",2098,2046,52,3561,18,24250
"Fortville town, Indiana",2940,2787,153,5206,18,24286
"Fort Wayne city, Indiana",137447,129489,7958,264514,18,25000
"Foster CDP, Indiana",88,88,0,141,18,25054
"Fountain City town, Indiana",395,383,12,773,18,25090
"Fountaintown CDP, Indiana",51,41,10,137,18,25162
"Fowler town, Indiana",1074,1048,26,2207,18,25180
"Fowlerton town, Indiana",81,81,0,219,18,25198
"Foxcliff Estates CDP, Indiana",684,684,0,1518,18,25212
"Francesville town, Indiana",412,390,22,939,18,25288
"Francisco town, Indiana",255,251,4,600,18,25306
"Frankfort city, Indiana",7732,7395,337,15976,18,25324
"Franklin city, Indiana",13212,12589,623,26073,18,25450
"Frankton town, Indiana",911,887,24,1849,18,25702
"Fredericksburg CDP, Indiana",0,0,0,37,18,25720
"Freelandville CDP, Indiana",251,242,9,734,18,25810
"Freetown CDP, Indiana",128,116,12,248,18,25864
"Fremont town, Indiana",1156,1014,142,2170,18,25882
"French Lick town, Indiana",870,861,9,1752,18,25972
"Fulton town, Indiana",89,84,5,248,18,26152
"Galena CDP, Indiana",755,718,37,1526,18,26206
"Galveston town, Indiana",748,702,46,1349,18,26242
"Garrett city, Indiana",3367,3210,157,6434,18,26386
"Gary city, Indiana",26651,23041,3610,69136,18,27000
"Gas City city, Indiana",2893,2580,313,6099,18,27054
"Gaston town, Indiana",357,328,29,705,18,27072
"Geneva town, Indiana",589,563,26,1282,18,27216
"Geneva CDP, Indiana",186,148,38,299,18,27252
"Gentryville town, Indiana",100,94,6,311,18,27270
"Georgetown town, Indiana",1692,1671,21,3749,18,27324
"Gilmer Park CDP, Indiana",382,382,0,700,18,27720
"Glenwood town, Indiana",270,263,7,403,18,28062
"Glezen CDP, Indiana",132,132,0,233,18,28116
"Goldsmith CDP, Indiana",84,84,0,219,18,28296
"Goodland town, Indiana",540,526,14,991,18,28332
"Goshen city, Indiana",16169,15394,775,34704,18,28386
"Gosport town, Indiana",451,426,25,1057,18,28440
"Grabill town, Indiana",740,719,21,1268,18,28494
"Grammer CDP, Indiana",176,176,0,266,18,28620
"Grandview town, Indiana",399,385,14,734,18,28692
"Grandview Lake CDP, Indiana",229,229,0,350,18,28728
"Granger CDP, Indiana",14547,13809,738,30019,18,28800
"Grantsburg CDP, Indiana",42,42,0,156,18,28908
"Grayford CDP, Indiana",45,45,0,124,18,29070
"Graysville CDP, Indiana",19,19,0,19,18,29106
"Greencastle city, Indiana",4508,4457,51,9865,18,29358
"Greendale city, Indiana",1959,1959,0,3967,18,29448
"Greenfield city, Indiana",12600,12207,393,23669,18,29520
"Green Hill CDP, Indiana",77,77,0,216,18,29592
"Greensboro town, Indiana",53,52,1,175,18,29682
"Greensburg city, Indiana",6011,5804,207,11431,18,29718
"Greens Fork town, Indiana",296,285,11,534,18,29754
"Greentown town, Indiana",992,973,19,2035,18,29772
"Greenville town, Indiana",727,716,11,1484,18,29844
"Greenwood city, Indiana",33524,32449,1075,63579,18,29898
"Griffin town, Indiana",40,38,2,113,18,30024
"Griffith town, Indiana",9390,8976,414,16182,18,30042
"Grissom AFB CDP, Indiana",1237,1193,44,2619,18,30060
"Groveland CDP, Indiana",87,87,0,197,18,30114
"Groverton CDP, Indiana",9,9,0,196,18,30150
"Gwynneville CDP, Indiana",186,177,9,354,18,30294
"Hagerstown town, Indiana",921,894,27,1932,18,30402
"Hamburg CDP, Indiana",14,14,0,23,18,30564
"Hamilton town, Indiana",845,811,34,1693,18,30594
"Hamlet town, Indiana",369,361,8,773,18,30708
"Hammond city, Indiana",37383,35011,2372,77390,18,31000
"Hanna CDP, Indiana",190,190,0,535,18,31180
"Hanover town, Indiana",1660,1603,57,3665,18,31216
"Hardinsburg town, Indiana",47,47,0,179,18,31396
"Harlan CDP, Indiana",967,891,76,1613,18,31432
"Harmony town, Indiana",334,334,0,737,18,31486
"Harrison Lake CDP, Indiana",116,116,0,254,18,32098
"Harrodsburg CDP, Indiana",193,193,0,371,18,32170
"Hartford City city, Indiana",2155,1976,179,5789,18,32242
"Hartsville town, Indiana",116,111,5,289,18,32332
"Hashtown CDP, Indiana",20,20,0,61,18,32422
"Hatfield CDP, Indiana",178,178,0,617,18,32494
"Haubstadt town, Indiana",892,880,12,1891,18,32512
"Hayden CDP, Indiana",445,445,0,875,18,32584
"Haysville CDP, Indiana",202,202,0,345,18,32638
"Hazleton town, Indiana",115,110,5,229,18,32728
"Hartz Lake CDP, Indiana",94,94,0,260,18,32768
"Hebron town, Indiana",1713,1641,72,3573,18,32818
"Hedrick CDP, Indiana",59,59,0,107,18,32854
"Helmer CDP, Indiana",26,26,0,33,18,32926
"Helmsburg CDP, Indiana",97,97,0,296,18,32944
"Heltonville CDP, Indiana",22,22,0,110,18,32980
"Hemlock CDP, Indiana",15,15,0,46,18,32998
"Henryville CDP, Indiana",979,967,12,1837,18,33142
"Herbst CDP, Indiana",297,231,66,377,18,33178
"Heritage Lake CDP, Indiana",1665,1590,75,2770,18,33187
"Hessen Cassel CDP, Indiana",150,150,0,233,18,33214
"Hidden Valley CDP, Indiana",2932,2904,28,5560,18,33392
"Highland town, Indiana",12851,12204,647,23794,18,33466
"Highland CDP, Indiana",2694,2646,48,5590,18,33484
"Hillisburg CDP, Indiana",23,23,0,84,18,33826
"Hillsboro town, Indiana",323,322,1,653,18,33862
"Hillsdale CDP, Indiana",54,54,0,139,18,33952
"Hoagland CDP, Indiana",440,426,14,878,18,34096
"Hobart city, Indiana",15074,14061,1013,29573,18,34114
"Hobbs CDP, Indiana",59,48,11,92,18,34168
"Hoffman Lake CDP, Indiana",99,99,0,223,18,34186
"Holiday Woods CDP, Indiana",69,54,15,124,18,34284
"Holland town, Indiana",346,344,2,612,18,34294
"Holton town, Indiana",306,289,17,652,18,34366
"Homecroft town, Indiana",464,462,2,737,18,34420
"Homer CDP, Indiana",212,212,0,321,18,34456
"Hope town, Indiana",1083,1059,24,1902,18,34744
"Hortonville CDP, Indiana",129,117,12,188,18,34816
"Howe CDP, Indiana",412,412,0,803,18,34978
"Hudson town, Indiana",269,247,22,585,18,35086
"Hudson Lake CDP, Indiana",535,517,18,1370,18,35104
"Huntertown town, Indiana",4709,4664,45,9090,18,35266
"Huntingburg city, Indiana",3253,3161,92,6480,18,35284
"Huntington city, Indiana",8452,8010,442,17017,18,35302
"Huron CDP, Indiana",8,8,0,145,18,35392
"Hymera town, Indiana",433,387,46,952,18,35500
"Idaville CDP, Indiana",165,165,0,332,18,35536
"Independence CDP, Indiana",24,24,0,24,18,35626
"Indianapolis city (balance), Indiana",462923,437016,25907,882006,18,36003
"Indian Village town, Indiana",57,54,3,133,18,36306
"Ingalls town, Indiana",1111,1061,50,2404,18,36342
"Ireland CDP, Indiana",63,63,0,77,18,36468
"Jalapa CDP, Indiana",40,40,0,40,18,37674
"Jamestown town, Indiana",610,587,23,1062,18,37692
"Jasonville city, Indiana",925,830,95,1979,18,37764
"Jasper city, Indiana",8448,8279,169,16488,18,37782
"Jefferson CDP, Indiana",55,55,0,168,18,37908
"Jeffersonville city, Indiana",26494,25537,957,49771,18,38358
"Jerome CDP, Indiana",14,14,0,29,18,38484
"Jimmerson Lake CDP, Indiana",622,572,50,1183,18,38547
"Johnson CDP, Indiana",64,64,0,337,18,38664
"Jonesboro city, Indiana",800,753,47,1541,18,38862
"Jonesville town, Indiana",98,98,0,196,18,38916
"Judah CDP, Indiana",190,190,0,297,18,39042
"Judson CDP, Indiana",16,16,0,31,18,39078
"Judyville CDP, Indiana",124,124,0,124,18,39096
"Kempton town, Indiana",107,105,2,280,18,39366
"Kendallville city, Indiana",4681,4407,274,10176,18,39402
"Kennard town, Indiana",236,230,6,528,18,39438
"Kent CDP, Indiana",0,0,0,0,18,39510
"Kentland town, Indiana",902,722,180,1810,18,39546
"Kewanna town, Indiana",301,286,15,587,18,39618
"Keystone CDP, Indiana",53,38,15,100,18,39654
"Kimmell CDP, Indiana",100,88,12,453,18,39744
"Kingman town, Indiana",223,218,5,559,18,39798
"Kingsbury town, Indiana",112,105,7,227,18,39816
"Kingsford Heights town, Indiana",601,588,13,1391,18,39852
"Kirklin town, Indiana",406,404,2,865,18,39942
"Knightstown town, Indiana",1074,998,76,2175,18,40266
"Knightsville town, Indiana",301,285,16,640,18,40302
"Knox city, Indiana",1371,1334,37,3847,18,40374
"Kokomo city, Indiana",27507,25830,1677,59534,18,40392
"Koontz Lake CDP, Indiana",591,543,48,1364,18,40464
"Kouts town, Indiana",1241,1228,13,2219,18,40518
"Kramer CDP, Indiana",39,39,0,56,18,40536
"Laconia town, Indiana",17,17,0,63,18,40644
"La Crosse town, Indiana",246,245,1,568,18,40662
"Ladoga town, Indiana",525,519,6,1149,18,40698
"Lafayette city, Indiana",37672,36020,1652,70828,18,40788
"La Fontaine town, Indiana",435,429,6,897,18,40842
"Lagrange town, Indiana",1394,1310,84,2783,18,40860
"Lagro town, Indiana",186,169,17,365,18,40896
"Lake Bruce CDP, Indiana",133,80,53,251,18,41004
"Lake Cicott CDP, Indiana",34,34,0,70,18,41022
"Lake Dalecarlia CDP, Indiana",869,837,32,1448,18,41058
"Lake Eliza CDP, Indiana",321,321,0,722,18,41112
"Lake Everett CDP, Indiana",66,66,0,152,18,41130
"Lake Holiday CDP, Indiana",798,760,38,1290,18,41211
"Lake Holiday Hideaway CDP, Indiana",44,44,0,325,18,41215
"Lake of the Woods CDP, Indiana",334,294,40,590,18,41400
"Lake Santee CDP, Indiana",443,443,0,754,18,41444
"Lakeshore Resort CDP, Indiana",0,0,0,0,18,41463
"Lakes of the Four Seasons CDP, Indiana",4043,3932,111,7589,18,41530
"Lake Station city, Indiana",6257,5116,1141,13352,18,41535
"Laketon CDP, Indiana",167,167,0,294,18,41562
"Lake View CDP, Indiana",0,0,0,72,18,41580
"Lake Village CDP, Indiana",345,306,39,579,18,41652
"Lakeville town, Indiana",322,312,10,690,18,41670
"Lakewood CDP, Indiana",364,364,0,748,18,41706
"Lamb CDP, Indiana",125,125,0,202,18,41796
"Landess CDP, Indiana",66,66,0,94,18,41994
"Lanesville town, Indiana",461,459,2,948,18,42048
"Laotto CDP, Indiana",78,78,0,159,18,42138
"La Paz town, Indiana",324,318,6,536,18,42192
"Lapel town, Indiana",1432,1386,46,2517,18,42228
"La Porte city, Indiana",11366,10746,620,22409,18,42246
"Larwill town, Indiana",164,151,13,405,18,42282
"Laud CDP, Indiana",68,68,0,97,18,42318
"Laurel town, Indiana",236,208,28,588,18,42372
"Lawrence city, Indiana",27339,25867,1472,49218,18,42426
"Lawrenceburg city, Indiana",2067,2067,0,5140,18,42462
"Lawrenceport CDP, Indiana",0,0,0,26,18,42516
"Leavenworth town, Indiana",127,95,32,328,18,42606
"Lebanon city, Indiana",9343,9088,255,17277,18,42624
"Leesburg town, Indiana",422,413,9,942,18,42678
"Leiters Ford CDP, Indiana",94,94,0,272,18,42822
"Leo-Cedarville town, Indiana",1911,1857,54,3649,18,42861
"Leopold CDP, Indiana",22,22,0,22,18,42876
"Letts CDP, Indiana",35,35,0,88,18,42984
"Lewis CDP, Indiana",312,312,0,596,18,43020
"Lewisville town, Indiana",190,166,24,367,18,43074
"Liberty town, Indiana",1144,1105,39,2085,18,43434
"Liberty Center CDP, Indiana",81,81,0,166,18,43542
"Liberty Mills CDP, Indiana",137,137,0,231,18,43596
"Libertyville CDP, Indiana",120,75,45,182,18,43632
"Ligonier city, Indiana",2301,2208,93,4397,18,43686
"Lincoln CDP, Indiana",50,50,0,189,18,43776
"Linden town, Indiana",268,260,8,563,18,44082
"Linn Grove CDP, Indiana",45,45,0,117,18,44154
"Linnsburg CDP, Indiana",19,19,0,27,18,44172
"Linton city, Indiana",2464,2217,247,5149,18,44190
"Little York town, Indiana",88,86,2,221,18,44370
"Livonia town, Indiana",45,45,0,83,18,44424
"Lizton town, Indiana",374,374,0,680,18,44442
"Logansport city, Indiana",8541,8265,276,18166,18,44658
"London CDP, Indiana",26,26,0,52,18,44712
"Long Beach town, Indiana",574,559,15,1184,18,44784
"Loogootee city, Indiana",1179,1115,64,2567,18,44910
"Losantville town, Indiana",161,135,26,243,18,45000
"Lowell town, Indiana",5370,5084,286,10723,18,45144
"Lucerne CDP, Indiana",71,71,0,120,18,45234
"Lyford CDP, Indiana",139,139,0,346,18,45396
"Lynn town, Indiana",565,514,51,1120,18,45468
"Lynnville town, Indiana",583,541,42,1021,18,45486
"Lyons town, Indiana",409,394,15,802,18,45504
"McCordsville town, Indiana",4862,4732,130,9098,18,45648
"Mace CDP, Indiana",60,60,0,155,18,45720
"Mackey town, Indiana",52,52,0,104,18,45774
"Macy town, Indiana",78,72,6,200,18,45864
"Madison city, Indiana",5829,5634,195,12301,18,45990
"Malden CDP, Indiana",176,176,0,299,18,46296
"Manilla CDP, Indiana",235,205,30,382,18,46422
"Maples CDP, Indiana",80,80,0,80,18,46566
"Marengo town, Indiana",378,366,12,797,18,46746
"Mariah Hill CDP, Indiana",63,63,0,123,18,46764
"Marietta CDP, Indiana",115,115,0,151,18,46782
"Marion city, Indiana",12430,11257,1173,27528,18,46908
"Marion CDP, Indiana",161,161,0,207,18,47045
"Markle town, Indiana",606,589,17,1305,18,47160
"Markleville town, Indiana",335,313,22,611,18,47178
"Marshall town, Indiana",199,195,4,331,18,47322
"Marshfield CDP, Indiana",35,35,0,60,18,47340
"Martinsburg CDP, Indiana",90,90,0,134,18,47430
"Martinsville city, Indiana",5682,5420,262,11916,18,47448
"Matthews town, Indiana",208,206,2,435,18,47592
"Mauckport town, Indiana",19,14,5,57,18,47628
"Maxwell CDP, Indiana",76,76,0,216,18,47736
"Mays CDP, Indiana",42,42,0,119,18,47826
"Mecca town, Indiana",256,238,18,644,18,48132
"Medaryville town, Indiana",257,247,10,780,18,48186
"Medora town, Indiana",346,343,3,950,18,48240
"Mellott town, Indiana",67,64,3,150,18,48294
"Melody Hill CDP, Indiana",1776,1735,41,3448,18,48330
"Memphis CDP, Indiana",575,575,0,866,18,48384
"Mentone town, Indiana",484,461,23,867,18,48402
"Meridian Hills town, Indiana",787,758,29,1745,18,48456
"Merom town, Indiana",64,59,5,178,18,48474
"Merriam CDP, Indiana",168,137,31,315,18,48510
"Merrillville town, Indiana",17969,16488,1481,36214,18,48528
"Metamora CDP, Indiana",109,82,27,405,18,48563
"Metz CDP, Indiana",25,25,0,48,18,48618
"Mexico CDP, Indiana",390,386,4,1128,18,48636
"Miami CDP, Indiana",108,108,0,315,18,48672
"Michiana Shores town, Indiana",186,181,5,420,18,48744
"Michigan City city, Indiana",13996,13001,995,31983,18,48798
"Michigantown town, Indiana",248,247,1,566,18,48816
"Middlebury CDP, Indiana",51,51,0,146,18,48906
"Middlebury town, Indiana",2052,1932,120,3677,18,48924
"Middletown town, Indiana",1011,957,54,2201,18,49014
"Midland CDP, Indiana",84,74,10,137,18,49086
"Mier CDP, Indiana",0,0,0,0,18,49212
"Milan town, Indiana",886,853,33,1981,18,49266
"Milford CDP, Indiana",50,50,0,67,18,49302
"Milford town, Indiana",814,806,8,1762,18,49320
"Millersburg town, Indiana",323,307,16,675,18,49536
"Millgrove CDP, Indiana",40,33,7,57,18,49626
"Millhousen town, Indiana",133,124,9,267,18,49662
"Milltown town, Indiana",471,428,43,883,18,49716
"Millville CDP, Indiana",37,37,0,193,18,49734
"Milroy CDP, Indiana",352,349,3,672,18,49806
"Milton town, Indiana",185,183,2,323,18,49860
"Mineral Springs CDP, Indiana",493,442,51,806,18,49892
"Mishawaka city, Indiana",27595,25685,1910,50899,18,49932
"Mitchell city, Indiana",1590,1498,92,3947,18,49950
"Modoc town, Indiana",106,96,10,223,18,50058
"Mongo CDP, Indiana",186,186,0,335,18,50094
"Monon town, Indiana",847,763,84,1764,18,50148
"Monroe town, Indiana",358,357,1,640,18,50202
"Monroe City town, Indiana",391,391,0,867,18,50526
"Monroeville town, Indiana",552,530,22,1144,18,50562
"Monrovia town, Indiana",872,853,19,1574,18,50580
"Monterey town, Indiana",196,191,5,334,18,50616
"Montezuma town, Indiana",339,335,4,900,18,50652
"Montgomery town, Indiana",558,556,2,1063,18,50688
"Monticello city, Indiana",2442,2296,146,5488,18,50760
"Montmorenci CDP, Indiana",142,124,18,482,18,50778
"Montpelier city, Indiana",821,779,42,1470,18,50796
"Mooreland town, Indiana",188,185,3,377,18,50940
"Moores Hill town, Indiana",264,250,14,717,18,50958
"Mooresville town, Indiana",4787,4705,82,9525,18,50976
"Morgantown town, Indiana",589,477,112,1293,18,51102
"Morocco town, Indiana",525,482,43,1107,18,51138
"Morris CDP, Indiana",392,392,0,639,18,51174
"Morristown town, Indiana",479,471,8,1083,18,51192
"Mount Auburn town, Indiana",48,47,1,93,18,51318
"Mount Ayr town, Indiana",36,35,1,85,18,51336
"Mount Carmel town, Indiana",22,22,0,31,18,51354
"Mount Etna town, Indiana",84,83,1,179,18,51408
"Mount Summit town, Indiana",164,158,6,430,18,51714
"Mount Vernon city, Indiana",3288,3108,180,6480,18,51732
"Mulberry town, Indiana",528,475,53,1282,18,51840
"Muncie city, Indiana",32657,29979,2678,65167,18,51876
"Munster town, Indiana",12202,11730,472,23731,18,51912
"Napoleon town, Indiana",102,100,2,266,18,52002
"Nappanee city, Indiana",4366,4090,276,7276,18,52020
"Nashville town, Indiana",687,657,30,1528,18,52038
"Needham CDP, Indiana",7,7,0,16,18,52146
"Needmore CDP, Indiana",129,129,0,287,18,52200
"New Albany city, Indiana",18774,17863,911,37598,18,52326
"New Amsterdam town, Indiana",95,93,2,100,18,52398
"Newbern CDP, Indiana",94,94,0,159,18,52506
"Newberry town, Indiana",56,47,9,140,18,52524
"Newburgh town, Indiana",1831,1703,128,3350,18,52650
"New Carlisle town, Indiana",1034,1020,14,2162,18,52704
"New Castle city, Indiana",8041,7597,444,17413,18,52740
"New Chicago town, Indiana",1048,951,97,2111,18,52776
"New Goshen CDP, Indiana",376,337,39,583,18,52956
"New Harmony town, Indiana",422,404,18,825,18,52974
"New Haven city, Indiana",7920,7570,350,15552,18,52992
"New Lebanon CDP, Indiana",80,80,0,132,18,53118
"New Lisbon CDP, Indiana",35,35,0,57,18,53154
"New London CDP, Indiana",56,48,8,124,18,53190
"New Marion CDP, Indiana",0,0,0,33,18,53226
"New Market town, Indiana",265,257,8,568,18,53262
"New Middletown town, Indiana",43,36,7,77,18,53298
"New Palestine town, Indiana",1581,1502,79,2831,18,53352
"New Paris CDP, Indiana",933,922,11,1600,18,53370
"New Pekin town, Indiana",557,532,25,1224,18,53388
"New Point town, Indiana",162,156,6,325,18,53478
"Newport town, Indiana",131,127,4,299,18,53496
"New Richmond town, Indiana",175,167,8,407,18,53532
"New Ross town, Indiana",237,225,12,471,18,53550
"New Salisbury CDP, Indiana",260,247,13,492,18,53586
"Newtonville CDP, Indiana",110,110,0,153,18,53676
"Newtown town, Indiana",126,111,15,252,18,53694
"New Trenton CDP, Indiana",161,161,0,258,18,53712
"New Washington CDP, Indiana",250,250,0,463,18,53820
"New Whiteland town, Indiana",2821,2788,33,5591,18,53874
"Nineveh CDP, Indiana",227,227,0,446,18,53982
"Noblesville city, Indiana",39463,38117,1346,70442,18,54180
"North Crows Nest town, Indiana",45,43,2,71,18,54612
"North Grove CDP, Indiana",0,0,0,32,18,54792
"North Judson town, Indiana",894,847,47,2100,18,54900
"North Liberty town, Indiana",808,774,34,1726,18,54918
"North Manchester town, Indiana",2376,2320,56,5017,18,54954
"North Salem town, Indiana",291,284,7,542,18,55080
"North Terre Haute CDP, Indiana",2298,2182,116,4449,18,55098
"North Vernon city, Indiana",3012,2833,179,6935,18,55116
"North Webster town, Indiana",488,479,9,962,18,55134
"Norway CDP, Indiana",65,50,15,266,18,55350
"Notre Dame CDP, Indiana",2982,2960,22,6479,18,55386
"Nyona Lake CDP, Indiana",66,66,0,190,18,55512
"Oakland City city, Indiana",1228,1140,88,2421,18,55710
"Oaktown town, Indiana",327,327,0,755,18,55800
"Oakville CDP, Indiana",91,60,31,222,18,55818
"Odon town, Indiana",650,650,0,1447,18,56052
"Ogden Dunes town, Indiana",633,618,15,1219,18,56088
"Oldenburg town, Indiana",335,333,2,723,18,56286
"Ontario CDP, Indiana",172,172,0,428,18,56646
"Onward town, Indiana",76,73,3,150,18,56664
"Oolitic town, Indiana",702,672,30,1494,18,56682
"Ora CDP, Indiana",40,40,0,147,18,56700
"Orestes town, Indiana",181,159,22,389,18,56952
"Orland town, Indiana",258,247,11,446,18,57006
"Orleans town, Indiana",1061,1021,40,2228,18,57024
"Osceola town, Indiana",1359,1337,22,2589,18,57114
"Osgood town, Indiana",883,836,47,1672,18,57132
"Ossian town, Indiana",1693,1671,22,3339,18,57168
"Oswego CDP, Indiana",256,256,0,325,18,57186
"Otisco CDP, Indiana",21,21,0,111,18,57222
"Otterbein town, Indiana",595,580,15,1195,18,57258
"Otter Lake CDP, Indiana",161,161,0,391,18,57330
"Otwell CDP, Indiana",192,192,0,368,18,57384
"Owensburg CDP, Indiana",84,84,0,232,18,57510
"Owensville town, Indiana",561,533,28,1135,18,57528
"Oxford town, Indiana",646,608,38,1561,18,57546
"Painted Hills CDP, Indiana",751,574,177,996,18,57632
"Palestine CDP, Indiana",435,409,26,946,18,57672
"Palmyra town, Indiana",474,474,0,1323,18,57726
"Paoli town, Indiana",1376,1320,56,3286,18,57780
"Paragon town, Indiana",297,242,55,541,18,57870
"Paris Crossing CDP, Indiana",15,15,0,21,18,57924
"Parker City town, Indiana",501,476,25,1187,18,57978
"Parkers Settlement CDP, Indiana",319,296,23,547,18,58050
"Patoka town, Indiana",448,441,7,911,18,58320
"Patricksburg CDP, Indiana",107,81,26,178,18,58374
"Patriot town, Indiana",120,114,6,200,18,58392
"Paxton CDP, Indiana",176,176,0,324,18,58500
"Pence CDP, Indiana",0,0,0,163,18,58644
"Pendleton town, Indiana",2778,2688,90,4937,18,58662
"Penntown CDP, Indiana",0,0,0,76,18,58770
"Pennville town, Indiana",330,325,5,683,18,58788
"Peppertown CDP, Indiana",15,15,0,41,18,58878
"Perkinsville CDP, Indiana",76,76,0,102,18,58932
"Perrysville town, Indiana",281,254,27,556,18,59238
"Peru city, Indiana",5033,4713,320,10862,18,59328
"Petersburg city, Indiana",908,889,19,2126,18,59364
"Petersville CDP, Indiana",93,93,0,188,18,59400
"Petroleum CDP, Indiana",32,32,0,85,18,59418
"Philadelphia CDP, Indiana",327,327,0,610,18,59490
"Pierceton town, Indiana",718,700,18,1344,18,59598
"Pierceville CDP, Indiana",48,48,0,130,18,59616
"Pine Village town, Indiana",122,122,0,271,18,60084
"Pittsboro town, Indiana",2171,2122,49,3814,18,60192
"Pittsburg CDP, Indiana",71,71,0,157,18,60210
"Plainfield town, Indiana",18060,17449,611,35078,18,60246
"Plainville town, Indiana",215,194,21,442,18,60264
"Pleasant Lake CDP, Indiana",244,235,9,810,18,60534
"Pleasant Mills CDP, Indiana",106,106,0,139,18,60552
"Pleasant View CDP, Indiana",318,301,17,651,18,60678
"Pleasant View Village CDP, Indiana",485,477,8,913,18,60696
"Pleasantville CDP, Indiana",31,31,0,76,18,60732
"Plymouth city, Indiana",4949,4724,225,10369,18,60822
"Point Isabel CDP, Indiana",0,0,0,74,18,60894
"Poland CDP, Indiana",77,77,0,126,18,60912
"Poneto town, Indiana",90,86,4,166,18,61020
"Portage city, Indiana",19411,18128,1283,37737,18,61092
"Porter town, Indiana",2682,2541,141,5204,18,61164
"Portland city, Indiana",3045,2860,185,6432,18,61236
"Poseyville town, Indiana",556,529,27,1156,18,61416
"Pottawattamie Park town, Indiana",189,185,4,317,18,61470
"Prairie Creek CDP, Indiana",65,65,0,258,18,61686
"Prairieton CDP, Indiana",371,371,0,520,18,61758
"Preble CDP, Indiana",14,14,0,65,18,61866
"Prince's Lakes town, Indiana",739,725,14,1276,18,62028
"Princeton city, Indiana",4219,4103,116,8344,18,62046
"Prospect CDP, Indiana",195,195,0,425,18,62154
"Pulaski CDP, Indiana",16,16,0,43,18,62280
"Putnamville CDP, Indiana",192,191,1,2180,18,62406
"Raglesville CDP, Indiana",38,38,0,97,18,62712
"Ragsdale CDP, Indiana",9,9,0,42,18,62730
"Rainsville CDP, Indiana",7,7,0,25,18,62856
"Ramsey CDP, Indiana",275,275,0,539,18,62892
"Raub CDP, Indiana",84,84,0,168,18,63072
"Reddington CDP, Indiana",184,170,14,345,18,63432
"Redkey town, Indiana",542,516,26,1547,18,63450
"Remington town, Indiana",732,723,9,1486,18,63756
"Rensselaer city, Indiana",2792,2716,76,5330,18,63792
"Reo CDP, Indiana",182,175,7,424,18,63810
"Reynolds town, Indiana",265,265,0,614,18,63918
"Richland town, Indiana",337,324,13,542,18,64206
"Richmond city, Indiana",16570,15579,991,35642,18,64260
"Ridgeville town, Indiana",292,281,11,573,18,64422
"Riley town, Indiana",240,194,46,511,18,64512
"Rising Sun city, Indiana",1102,1087,15,2420,18,64674
"River Forest town, Indiana",9,9,0,15,18,64728
"Riverwood CDP, Indiana",0,0,0,0,18,64944
"Roachdale town, Indiana",351,344,7,786,18,64980
"Roann town, Indiana",203,196,7,404,18,64998
"Roanoke town, Indiana",1030,1004,26,1852,18,65016
"Rob Roy CDP, Indiana",44,44,0,70,18,65178
"Rochester city, Indiana",2926,2735,191,6236,18,65214
"Rockfield CDP, Indiana",94,94,0,152,18,65358
"Rockford CDP, Indiana",506,506,0,703,18,65376
"Rockport city, Indiana",974,922,52,2183,18,65484
"Rockville town, Indiana",1103,1007,96,2537,18,65520
"Rocky Ripple town, Indiana",355,334,21,614,18,65556
"Roll CDP, Indiana",0,0,0,23,18,65592
"Rolling Prairie CDP, Indiana",85,85,0,160,18,65736
"Rome City town, Indiana",655,626,29,1341,18,65808
"Romney CDP, Indiana",259,230,29,477,18,65826
"Rosedale town, Indiana",309,291,18,605,18,65934
"Roseland town, Indiana",507,473,34,794,18,65988
"Roselawn CDP, Indiana",1309,1192,117,3007,18,66006
"Rossville town, Indiana",870,826,44,1749,18,66150
"Royal Center town, Indiana",380,364,16,816,18,66222
"Royerton CDP, Indiana",67,67,0,174,18,66312
"Rushville city, Indiana",3038,2747,291,6412,18,66438
"Russellville town, Indiana",197,197,0,391,18,66510
"Russiaville town, Indiana",626,610,16,1349,18,66546
"St. Anthony CDP, Indiana",158,158,0,229,18,66744
"St. Bernice CDP, Indiana",187,187,0,601,18,66762
"St. Joe town, Indiana",200,179,21,429,18,66834
"St. John town, Indiana",10711,10334,377,20727,18,66852
"St. Leon town, Indiana",464,462,2,1079,18,66978
"St. Mary of the Woods CDP, Indiana",207,207,0,784,18,67050
"St. Meinrad CDP, Indiana",354,301,53,786,18,67176
"St. Omer CDP, Indiana",36,36,0,93,18,67194
"St. Paul town, Indiana",396,381,15,934,18,67212
"St. Wendel CDP, Indiana",455,455,0,893,18,67284
"Salamonia town, Indiana",115,94,21,171,18,67302
"Salem city, Indiana",3046,2987,59,6330,18,67464
"Saline City CDP, Indiana",12,12,0,12,18,67518
"Salt Creek Commons CDP, Indiana",846,823,23,1854,18,67608
"Saltillo town, Indiana",105,101,4,154,18,67626
"Sandborn town, Indiana",192,190,2,314,18,67698
"Sandusky CDP, Indiana",20,20,0,20,18,67896
"San Pierre CDP, Indiana",234,234,0,436,18,68004
"Santa Claus town, Indiana",1426,1415,11,2746,18,68022
"Saratoga town, Indiana",122,115,7,312,18,68058
"Sardinia CDP, Indiana",90,78,12,100,18,68076
"Saugany Lake CDP, Indiana",77,77,0,142,18,68103
"Schaefer Lake CDP, Indiana",78,78,0,209,18,68202
"Schererville town, Indiana",15878,15159,719,29573,18,68220
"Schneider town, Indiana",102,91,11,187,18,68238
"Schnellville CDP, Indiana",135,135,0,274,18,68256
"Scipio CDP, Indiana",145,118,27,295,18,68328
"Scircleville CDP, Indiana",77,77,0,84,18,68364
"Scotland CDP, Indiana",33,23,10,78,18,68382
"Scott CDP, Indiana",95,95,0,161,18,68418
"Scottsburg city, Indiana",3197,2953,244,7313,18,68526
"Seelyville town, Indiana",464,449,15,907,18,68652
"Sellersburg town, Indiana",5123,4760,363,9948,18,68670
"Selma town, Indiana",459,417,42,859,18,68706
"Servia CDP, Indiana",193,193,0,396,18,68742
"Seymour city, Indiana",10523,10297,226,21373,18,68832
"Shadeland town, Indiana",1002,981,21,2092,18,68868
"Shamrock Lakes town, Indiana",201,154,47,343,18,68976
"Sharpsville town, Indiana",361,349,12,703,18,69048
"Shelburn town, Indiana",658,646,12,1278,18,69192
"Shelby CDP, Indiana",0,0,0,308,18,69246
"Shelbyville city, Indiana",9718,9445,273,19678,18,69318
"Shepardsville CDP, Indiana",60,46,14,116,18,69336
"Sheridan town, Indiana",1950,1801,149,3464,18,69354
"Shipshewana town, Indiana",471,437,34,873,18,69480
"Shipshewana Lake CDP, Indiana",176,176,0,259,18,69489
"Shirley town, Indiana",477,448,29,1027,18,69516
"Shoals town, Indiana",276,276,0,655,18,69552
"Shorewood Forest CDP, Indiana",1582,1560,22,3215,18,69642
"Sidney town, Indiana",40,39,1,76,18,69678
"Silver Lake town, Indiana",440,406,34,963,18,69768
"Simonton Lake CDP, Indiana",2320,2237,83,4527,18,69840
"Sims CDP, Indiana",29,29,0,88,18,69894
"Smithville-Sanders CDP, Indiana",1634,1565,69,3099,18,70330
"Snow Lake CDP, Indiana",240,240,0,435,18,70470
"Solsberry CDP, Indiana",164,164,0,222,18,70506
"Somerset CDP, Indiana",107,107,0,285,18,70524
"Somerville town, Indiana",100,97,3,254,18,70542
"South Bend city, Indiana",49334,46624,2710,103084,18,71000
"South Center CDP, Indiana",78,78,0,130,18,71072
"South Haven CDP, Indiana",3705,3561,144,7237,18,71288
"South Milford CDP, Indiana",86,86,0,198,18,71396
"Southport city, Indiana",1006,960,46,2088,18,71486
"South Whitley town, Indiana",685,633,52,1273,18,71612
"Spartanburg CDP, Indiana",32,32,0,43,18,71774
"Speedway town, Indiana",7073,6707,366,13646,18,71828
"Spencer town, Indiana",1057,994,63,2240,18,71972
"Spencerville CDP, Indiana",193,159,34,296,18,71990
"Spiceland town, Indiana",514,499,15,1027,18,72008
"Spring Grove town, Indiana",186,176,10,427,18,72206
"Spring Hill town, Indiana",30,30,0,72,18,72232
"Spring Lake town, Indiana",103,98,5,224,18,72296
"Springport town, Indiana",71,71,0,179,18,72332
"Spurgeon town, Indiana",86,76,10,161,18,72440
"Stanford CDP, Indiana",221,221,0,391,18,72584
"Star City CDP, Indiana",101,90,11,226,18,72638
"State Line City town, Indiana",77,77,0,140,18,72764
"Staunton town, Indiana",107,102,5,262,18,72782
"Stendal CDP, Indiana",63,63,0,134,18,72980
"Stewartsville CDP, Indiana",97,97,0,153,18,73160
"Stilesville town, Indiana",136,136,0,252,18,73178
"Stillwell CDP, Indiana",12,12,0,12,18,73214
"Stinesville town, Indiana",194,175,19,350,18,73232
"Stockwell CDP, Indiana",164,164,0,266,18,73340
"Stone Bluff CDP, Indiana",94,94,0,156,18,73376
"Straughn town, Indiana",128,123,5,214,18,73664
"Stroh CDP, Indiana",96,96,0,262,18,73790
"Sullivan city, Indiana",2148,2049,99,4243,18,74006
"Sulphur Springs town, Indiana",199,188,11,454,18,74060
"Sumava Resorts CDP, Indiana",70,70,0,103,18,74078
"Summitville town, Indiana",500,479,21,1117,18,74132
"Sunman town, Indiana",702,685,17,1465,18,74168
"Swayzee town, Indiana",421,402,19,921,18,74510
"Sweetser town, Indiana",539,512,27,1107,18,74546
"Switz City town, Indiana",161,159,2,284,18,74582
"Syracuse town, Indiana",1962,1895,67,3081,18,74744
"Tab CDP, Indiana",0,0,0,0,18,74780
"Talma CDP, Indiana",35,35,0,163,18,74870
"Taswell CDP, Indiana",28,28,0,57,18,74978
"Taylorsville CDP, Indiana",341,318,23,667,18,75104
"Tecumseh CDP, Indiana",481,473,8,799,18,75176
"Teegarden CDP, Indiana",0,0,0,0,18,75194
"Tell City city, Indiana",3811,3557,254,7470,18,75248
"Templeton CDP, Indiana",0,0,0,0,18,75284
"Tennyson town, Indiana",76,67,9,169,18,75302
"Terre Haute city, Indiana",26573,24588,1985,58599,18,75428
"Thayer CDP, Indiana",324,213,111,647,18,75518
"Thorntown town, Indiana",589,582,7,1119,18,75626
"Tippecanoe CDP, Indiana",168,168,0,349,18,75860
"Tipton city, Indiana",2698,2560,138,5255,18,75986
"Toad Hop CDP, Indiana",97,97,0,122,18,76022
"Tocsin CDP, Indiana",161,161,0,358,18,76076
"Topeka town, Indiana",488,457,31,1132,18,76184
"Town of Pines town, Indiana",310,299,11,651,18,76256
"Trafalgar town, Indiana",524,493,31,1099,18,76310
"Trail Creek town, Indiana",887,854,33,2018,18,76328
"Tri-Lakes CDP, Indiana",596,596,0,1258,18,76526
"Troy town, Indiana",203,199,4,579,18,76634
"Tunnelton CDP, Indiana",17,17,0,64,18,76742
"Twelve Mile CDP, Indiana",101,91,10,301,18,76886
"Tyner CDP, Indiana",118,118,0,274,18,77030
"Ulen town, Indiana",54,53,1,134,18,77066
"Underwood CDP, Indiana",329,317,12,1074,18,77084
"Union City city, Indiana",1437,1294,143,3511,18,77768
"Uniondale town, Indiana",111,105,6,223,18,77786
"Union Mills CDP, Indiana",109,109,0,117,18,77804
"Universal town, Indiana",113,106,7,260,18,77912
"Upland town, Indiana",1941,1893,48,3963,18,77966
"Urbana CDP, Indiana",32,5,27,116,18,78056
"Utica town, Indiana",466,448,18,932,18,78110
"Vallonia CDP, Indiana",263,246,17,354,18,78290
"Valparaiso city, Indiana",17179,16657,522,33991,18,78326
"Van Bibber Lake CDP, Indiana",194,194,0,429,18,78380
"Van Buren town, Indiana",432,388,44,935,18,78470
"Veedersburg town, Indiana",912,830,82,1948,18,78740
"Velpen CDP, Indiana",0,0,0,0,18,78758
"Vera Cruz town, Indiana",34,34,0,64,18,78776
"Vernon town, Indiana",136,133,3,248,18,78902
"Versailles town, Indiana",762,731,31,1672,18,78974
"Vevay town, Indiana",844,811,33,1889,18,79010
"Vicksburg CDP, Indiana",58,58,0,134,18,79028
"Vincennes city, Indiana",8542,8086,456,16715,18,79208
"Vistula CDP, Indiana",27,27,0,45,18,79226
"Wabash city, Indiana",4892,4687,205,10417,18,79370
"Wadesville CDP, Indiana",283,283,0,517,18,79442
"Wakarusa town, Indiana",1310,1166,144,2488,18,79478
"Waldron CDP, Indiana",432,432,0,819,18,79568
"Walesboro CDP, Indiana",170,152,18,314,18,79604
"Walkerton town, Indiana",959,921,38,2022,18,79694
"Wallace town, Indiana",86,85,1,149,18,79730
"Wall Lake CDP, Indiana",81,81,0,280,18,79784
"Walton town, Indiana",427,396,31,770,18,79964
"Wanatah town, Indiana",687,644,43,1136,18,80018
"Warren town, Indiana",688,671,17,1291,18,80108
"Warren Park town, Indiana",640,619,21,1475,18,80234
"Warrington CDP, Indiana",0,0,0,46,18,80288
"Warsaw city, Indiana",8765,8484,281,16473,18,80306
"Washington city, Indiana",5708,5533,175,12076,18,80504
"Waterloo town, Indiana",1226,1146,80,2136,18,81278
"Waveland town, Indiana",196,183,13,389,18,81458
"Waverly CDP, Indiana",457,457,0,826,18,81494
"Wawaka CDP, Indiana",73,65,8,82,18,81530
"Waynesville CDP, Indiana",76,76,0,123,18,82034
"Waynetown town, Indiana",393,361,32,778,18,82052
"Webster CDP, Indiana",52,52,0,157,18,82142
"Wellsboro CDP, Indiana",398,398,0,511,18,82250
"West Baden Springs town, Indiana",222,205,17,479,18,82376
"West College Corner town, Indiana",299,299,0,479,18,82556
"Westfield city, Indiana",26149,25634,515,48262,18,82700
"West Harrison town, Indiana",156,147,9,322,18,82790
"West Lafayette city, Indiana",20497,19825,672,44861,18,82862
"West Lebanon town, Indiana",414,362,52,773,18,82934
"West Middleton CDP, Indiana",103,103,0,160,18,83042
"Westphalia CDP, Indiana",49,49,0,71,18,83204
"West Point CDP, Indiana",192,192,0,246,18,83222
"Westport town, Indiana",736,679,57,1613,18,83276
"West Terre Haute town, Indiana",938,864,74,2064,18,83384
"Westville town, Indiana",1299,1184,115,5885,18,83420
"Westwood CDP, Indiana",235,235,0,515,18,83456
"Wheatfield town, Indiana",382,368,14,853,18,83528
"Wheatland town, Indiana",215,212,3,402,18,83564
"Wheeler CDP, Indiana",81,81,0,155,18,83600
"Whiteland town, Indiana",2597,2458,139,4278,18,83816
"Whitestown town, Indiana",5917,5844,73,10253,18,84014
"Whitewater town, Indiana",25,25,0,54,18,84086
"Whiting city, Indiana",2046,1864,182,4574,18,84122
"Wildwood CDP, Indiana",63,63,0,142,18,84234
"Wilkinson town, Indiana",255,253,2,436,18,84302
"Williams CDP, Indiana",68,68,0,115,18,84338
"Williamsburg CDP, Indiana",173,173,0,432,18,84356
"Williams Creek town, Indiana",206,201,5,450,18,84374
"Williamsport town, Indiana",921,910,11,1847,18,84410
"Willow Branch CDP, Indiana",40,40,0,123,18,84482
"Winamac town, Indiana",1295,1275,20,2543,18,84734
"Winchester city, Indiana",2186,2053,133,4654,18,84752
"Windfall City town, Indiana",368,366,2,740,18,84806
"Windsor CDP, Indiana",0,0,0,27,18,84842
"Winfield town, Indiana",3704,3516,188,7219,18,84878
"Wingate town, Indiana",149,143,6,301,18,84914
"Winona Lake town, Indiana",2911,2844,67,5077,18,84950
"Winslow town, Indiana",295,279,16,729,18,84968
"Wolcott town, Indiana",538,521,17,1085,18,85058
"Wolcottville town, Indiana",655,615,40,1140,18,85076
"Wolflake CDP, Indiana",62,62,0,268,18,85130
"Woodburn city, Indiana",558,530,28,1228,18,85184
"Woodlawn Heights town, Indiana",52,52,0,113,18,85400
"Wooster CDP, Indiana",105,105,0,175,18,85562
"Worthington town, Indiana",807,749,58,1710,18,85598
"Wyatt CDP, Indiana",84,84,0,177,18,85724
"Wynnedale town, Indiana",115,115,0,218,18,85742
"Yeoman town, Indiana",112,112,0,173,18,85886
"Yorktown town, Indiana",5919,5858,61,11560,18,86084
"Young America CDP, Indiana",192,161,31,300,18,86156
"Zanesville town, Indiana",235,233,2,530,18,86318
"Zionsville town, Indiana",15725,15091,634,30832,18,86372
"Ackley city, Iowa",804,781,23,1699,19,00190
"Ackworth city, Iowa",52,52,0,106,19,00235
"Adair city, Iowa",443,414,29,828,19,00370
"Adel city, Iowa",3224,3099,125,6090,19,00505
"Afton city, Iowa",536,508,28,1105,19,00595
"Agency city, Iowa",214,208,6,463,19,00640
"Ainsworth city, Iowa",418,416,2,781,19,00730
"Akron city, Iowa",788,781,7,1580,19,00775
"Albert City city, Iowa",348,330,18,666,19,00865
"Albia city, Iowa",1809,1758,51,3705,19,00910
"Albion city, Iowa",382,362,20,593,19,00955
"Alburnett city, Iowa",450,444,6,828,19,01000
"Alden city, Iowa",436,407,29,830,19,01045
"Alexander city, Iowa",84,84,0,180,19,01090
"Algona city, Iowa",2682,2534,148,5443,19,01135
"Alleman city, Iowa",226,224,2,379,19,01180
"Allerton city, Iowa",243,233,10,421,19,01270
"Allison city, Iowa",500,497,3,980,19,01315
"Alta city, Iowa",1189,1006,183,2207,19,01495
"Alta Vista city, Iowa",115,114,1,181,19,01540
"Alton city, Iowa",795,777,18,1283,19,01585
"Altoona city, Iowa",10971,10240,731,20017,19,01630
"Alvord city, Iowa",117,115,2,230,19,01675
"Amana CDP, Iowa",376,376,0,556,19,01720
"Ames city, Iowa",39235,36464,2771,66265,19,01855
"Anamosa city, Iowa",2246,2133,113,5493,19,01990
"Anderson CDP, Iowa",33,23,10,43,19,02035
"Andover city, Iowa",41,41,0,121,19,02080
"Andrew city, Iowa",236,217,19,403,19,02125
"Anita city, Iowa",541,534,7,974,19,02260
"Ankeny city, Iowa",39184,38179,1005,68392,19,02305
"Anthon city, Iowa",282,265,17,527,19,02350
"Aplington city, Iowa",454,449,5,907,19,02395
"Arcadia city, Iowa",597,585,12,894,19,02485
"Archer city, Iowa",62,61,1,156,19,02530
"Aredale city, Iowa",25,24,1,54,19,02620
"Argo CDP, Iowa",12,12,0,12,19,02665
"Argyle CDP, Iowa",13,13,0,42,19,02710
"Arion city, Iowa",24,24,0,107,19,02755
"Arispe city, Iowa",32,31,1,78,19,02800
"Arlington city, Iowa",204,202,2,445,19,02845
"Armstrong city, Iowa",333,310,23,755,19,02935
"Arnolds Park city, Iowa",504,502,2,989,19,03025
"Arthur city, Iowa",176,171,5,255,19,03115
"Asbury city, Iowa",3019,2894,125,5890,19,03160
"Ashton city, Iowa",315,310,5,541,19,03295
"Aspinwall city, Iowa",12,12,0,29,19,03340
"Atalissa city, Iowa",232,219,13,355,19,03385
"Athelstan CDP, Iowa",0,0,0,3,19,03430
"Atkins city, Iowa",1302,1267,35,2296,19,03475
"Atlantic city, Iowa",3442,3396,46,6770,19,03520
"Auburn city, Iowa",94,91,3,157,19,03610
"Audubon city, Iowa",1025,1025,0,2089,19,03655
"Augusta CDP, Iowa",27,27,0,57,19,03700
"Aurelia city, Iowa",505,492,13,941,19,03745
"Aurora city, Iowa",106,99,7,197,19,03835
"Avoca city, Iowa",698,682,16,1375,19,03970
"Ayrshire city, Iowa",81,81,0,150,19,04105
"Badger city, Iowa",300,287,13,519,19,04195
"Bagley city, Iowa",97,84,13,230,19,04240
"Baldwin city, Iowa",56,56,0,133,19,04330
"Balltown city, Iowa",28,28,0,58,19,04375
"Bancroft city, Iowa",299,290,9,620,19,04420
"Bankston city, Iowa",1,1,0,2,19,04510
"Barnes City city, Iowa",54,52,2,113,19,04555
"Barnum city, Iowa",139,134,5,304,19,04645
"Bartlett CDP, Iowa",12,12,0,12,19,04735
"Bassett city, Iowa",14,14,0,50,19,04780
"Batavia city, Iowa",300,267,33,631,19,04825
"Battle Creek city, Iowa",416,412,4,830,19,04870
"Baxter city, Iowa",538,538,0,1036,19,04915
"Bayard city, Iowa",195,185,10,372,19,04960
"Beacon city, Iowa",277,270,7,495,19,05050
"Beaconsfield city, Iowa",0,0,0,2,19,05095
"Beaman city, Iowa",91,91,0,122,19,05140
"Beaver city, Iowa",21,21,0,57,19,05185
"Beaverdale CDP, Iowa",327,313,14,714,19,05200
"Bedford city, Iowa",757,712,45,1416,19,05365
"Belle Plaine city, Iowa",1258,1230,28,2421,19,05590
"Bellevue city, Iowa",1006,996,10,2132,19,05635
"Belmond city, Iowa",899,866,33,2512,19,05680
"Bennett city, Iowa",234,229,5,416,19,05770
"Bentley CDP, Iowa",176,114,62,182,19,05870
"Benton city, Iowa",10,10,0,22,19,05905
"Berkley city, Iowa",0,0,0,3,19,06040
"Bernard city, Iowa",98,98,0,124,19,06085
"Bertram city, Iowa",129,129,0,251,19,06175
"Bettendorf city, Iowa",20200,19713,487,38997,19,06355
"Bevington city, Iowa",4,4,0,15,19,06490
"Big Rock CDP, Iowa",5,5,0,12,19,06535
"Birmingham city, Iowa",282,281,1,523,19,06625
"Blairsburg city, Iowa",85,84,1,162,19,06760
"Blairstown city, Iowa",439,423,16,705,19,06805
"Blakesburg city, Iowa",93,89,4,238,19,06850
"Blanchard city, Iowa",9,9,0,34,19,06895
"Blencoe city, Iowa",121,110,11,270,19,06940
"Blockton city, Iowa",76,75,1,123,19,06985
"Bloomfield city, Iowa",1225,1203,22,2687,19,07030
"Blue Grass city, Iowa",891,836,55,1873,19,07075
"Bode city, Iowa",199,199,0,390,19,07210
"Bolan CDP, Iowa",0,0,0,8,19,07255
"Bonaparte city, Iowa",186,165,21,423,19,07345
"Bondurant city, Iowa",4303,4272,31,7617,19,07390
"Boone city, Iowa",6991,6936,55,12482,19,07480
"Bouton city, Iowa",70,70,0,169,19,07660
"Boxholm city, Iowa",53,45,8,138,19,07750
"Boyden city, Iowa",409,409,0,719,19,07840
"Braddyville city, Iowa",98,98,0,161,19,07930
"Bradford CDP, Iowa",126,126,0,242,19,08020
"Bradgate city, Iowa",77,76,1,141,19,08065
"Brandon city, Iowa",206,193,13,348,19,08155
"Brayton city, Iowa",71,70,1,104,19,08200
"Breda city, Iowa",290,282,8,439,19,08290
"Bridgewater city, Iowa",47,46,1,112,19,08425
"Brighton city, Iowa",325,280,45,711,19,08470
"Bristow city, Iowa",96,95,1,170,19,08560
"Britt city, Iowa",925,893,32,1921,19,08605
"Bronson city, Iowa",185,172,13,296,19,08650
"Brooklyn city, Iowa",879,832,47,1600,19,08695
"Brunsville city, Iowa",70,69,1,168,19,08875
"Buckeye city, Iowa",42,41,1,84,19,09100
"Buck Grove city, Iowa",23,20,3,37,19,09145
"Buffalo city, Iowa",525,522,3,995,19,09235
"Buffalo Center city, Iowa",430,391,39,925,19,09280
"Burchinal CDP, Iowa",16,12,4,21,19,09415
"Burlington city, Iowa",11522,11061,461,23976,19,09550
"Burr Oak CDP, Iowa",98,98,0,234,19,09640
"Burt city, Iowa",217,213,4,517,19,09685
"Bussey city, Iowa",203,192,11,418,19,09730
"Calamus city, Iowa",200,196,4,408,19,09820
"California Junction CDP, Iowa",46,46,0,78,19,09910
"Callender city, Iowa",174,173,1,396,19,09955
"Calmar city, Iowa",419,418,1,831,19,10045
"Calumet city, Iowa",60,58,2,166,19,10090
"Camanche city, Iowa",2352,2268,84,4546,19,10135
"Cambridge city, Iowa",483,460,23,885,19,10225
"Cantril city, Iowa",107,107,0,270,19,10450
"Carbon city, Iowa",14,14,0,59,19,10585
"Carlisle city, Iowa",2265,2141,124,4116,19,10765
"Carpenter city, Iowa",57,56,1,79,19,11035
"Carroll city, Iowa",5160,5017,143,10270,19,11080
"Carson city, Iowa",381,365,16,762,19,11170
"Carter Lake city, Iowa",1820,1713,107,3780,19,11215
"Cascade city, Iowa",1144,1139,5,2312,19,11305
"Casey city, Iowa",192,173,19,375,19,11395
"Castalia city, Iowa",73,73,0,140,19,11485
"Castana city, Iowa",120,115,5,177,19,11530
"Cedar Falls city, Iowa",23814,23093,721,40686,19,11755
"Cedar Rapids city, Iowa",76180,73237,2943,136929,19,12000
"Center Junction CDP, Iowa",40,40,0,135,19,12225
"Center Point city, Iowa",1438,1394,44,2573,19,12270
"Centerville city, Iowa",2192,1999,193,5393,19,12315
"Central City city, Iowa",670,637,33,1166,19,12495
"Centralia city, Iowa",71,70,1,124,19,12630
"Chapin CDP, Iowa",68,68,0,137,19,12675
"Chariton city, Iowa",2061,1930,131,4203,19,12720
"Charles City city, Iowa",3722,3591,131,7364,19,12765
"Charlotte city, Iowa",216,205,11,419,19,12855
"Charter Oak city, Iowa",202,198,4,468,19,12900
"Chatsworth city, Iowa",37,37,0,77,19,12945
"Chelsea city, Iowa",144,132,12,318,19,12990
"Cherokee city, Iowa",2617,2519,98,5154,19,13080
"Chester city, Iowa",69,67,2,153,19,13125
"Chillicothe city, Iowa",36,30,6,67,19,13215
"Churdan city, Iowa",231,209,22,515,19,13350
"Cincinnati city, Iowa",111,102,9,226,19,13395
"Clare city, Iowa",80,69,11,163,19,13485
"Clarence city, Iowa",529,523,6,1136,19,13530
"Clarinda city, Iowa",2327,2070,257,5371,19,13575
"Clarion city, Iowa",1423,1407,16,2799,19,13620
"Clarksville city, Iowa",672,644,28,1311,19,13755
"Clayton city, Iowa",36,32,4,65,19,13845
"Clearfield city, Iowa",172,156,16,442,19,13980
"Clear Lake city, Iowa",3892,3779,113,7642,19,14025
"Cleghorn city, Iowa",156,139,17,284,19,14115
"Clemons city, Iowa",78,75,3,153,19,14160
"Clermont city, Iowa",280,266,14,490,19,14250
"Climbing Hill CDP, Iowa",25,25,0,71,19,14385
"Clinton city, Iowa",11450,10855,595,24524,19,14430
"Clio city, Iowa",19,19,0,40,19,14475
"Clive city, Iowa",10409,10119,290,18576,19,14520
"Clutier city, Iowa",132,121,11,272,19,14655
"Coalville CDP, Iowa",228,206,22,580,19,14835
"Coburg city, Iowa",16,16,0,45,19,14880
"Coggon city, Iowa",472,466,6,791,19,14925
"Coin city, Iowa",90,78,12,240,19,14970
"Colesburg city, Iowa",299,282,17,586,19,15015
"Colfax city, Iowa",1140,1073,67,2186,19,15060
"College Springs city, Iowa",119,117,2,217,19,15105
"Collins city, Iowa",266,252,14,483,19,15195
"Colo city, Iowa",459,438,21,838,19,15240
"Columbus City city, Iowa",150,143,7,274,19,15375
"Columbus Junction city, Iowa",969,919,50,2029,19,15420
"Colwell city, Iowa",35,35,0,62,19,15465
"Conesville city, Iowa",272,255,17,467,19,15645
"Conrad city, Iowa",502,495,7,1234,19,15825
"Conroy CDP, Iowa",76,76,0,119,19,15870
"Conway city, Iowa",3,3,0,31,19,15960
"Coon Rapids city, Iowa",654,642,12,1324,19,16050
"Coppock city, Iowa",8,8,0,23,19,16140
"Coralville city, Iowa",13066,12792,274,22494,19,16230
"Corley CDP, Iowa",6,6,0,6,19,16320
"Corning city, Iowa",709,677,32,1592,19,16500
"Correctionville city, Iowa",282,274,8,810,19,16545
"Corwith city, Iowa",98,98,0,226,19,16590
"Corydon city, Iowa",729,712,17,1688,19,16635
"Cotter city, Iowa",8,8,0,21,19,16725
"Coulter city, Iowa",104,95,9,206,19,16815
"Council Bluffs city, Iowa",32018,30688,1330,62670,19,16860
"Craig city, Iowa",41,41,0,66,19,16950
"Crawfordsville city, Iowa",175,172,3,367,19,17130
"Crescent city, Iowa",379,379,0,651,19,17175
"Cresco city, Iowa",2010,2010,0,3899,19,17220
"Creston city, Iowa",3653,3487,166,7519,19,17265
"Cromwell city, Iowa",29,29,0,75,19,17490
"Crystal Lake city, Iowa",140,136,4,261,19,17670
"Cumberland city, Iowa",118,116,2,266,19,17760
"Cumming city, Iowa",354,349,5,594,19,17850
"Curlew city, Iowa",16,16,0,43,19,17895
"Cushing city, Iowa",134,134,0,228,19,17940
"Cylinder city, Iowa",52,52,0,87,19,17985
"Dakota City city, Iowa",558,515,43,966,19,18075
"Dallas Center city, Iowa",850,841,9,1770,19,18255
"Dana city, Iowa",17,17,0,27,19,18345
"Danbury city, Iowa",137,137,0,299,19,18390
"Danville city, Iowa",523,521,2,948,19,18435
"Davenport city, Iowa",53518,50824,2694,101448,19,19000
"Davis City city, Iowa",109,101,8,216,19,19090
"Dawson city, Iowa",77,77,0,119,19,19135
"Dayton city, Iowa",447,426,21,824,19,19180
"Decatur City city, Iowa",73,71,2,146,19,19360
"Decorah city, Iowa",4175,4037,138,7611,19,19405
"Dedham city, Iowa",135,133,2,228,19,19450
"Deep River city, Iowa",163,162,1,327,19,19495
"Defiance city, Iowa",104,102,2,194,19,19585
"Delaware city, Iowa",79,79,0,141,19,19630
"Delhi city, Iowa",281,279,2,494,19,19675
"Delmar city, Iowa",256,252,4,450,19,19720
"Deloit city, Iowa",97,93,4,288,19,19765
"Delphos CDP, Iowa",10,10,0,31,19,19810
"Delta city, Iowa",132,126,6,311,19,19855
"Denison city, Iowa",4053,3802,251,8316,19,19945
"Denmark CDP, Iowa",340,340,0,648,19,19990
"Denver city, Iowa",983,958,25,1921,19,20035
"Derby city, Iowa",44,44,0,110,19,20125
"Des Moines city, Iowa",118641,111598,7043,213164,19,21000
"De Soto city, Iowa",498,479,19,925,19,21045
"DeWitt city, Iowa",2647,2557,90,5508,19,21180
"Dexter city, Iowa",384,361,23,670,19,21225
"Diagonal city, Iowa",186,186,0,463,19,21270
"Diamondhead Lake CDP, Iowa",181,181,0,252,19,21320
"Dickens city, Iowa",75,72,3,148,19,21360
"Dike city, Iowa",648,632,16,1240,19,21405
"Dixon city, Iowa",149,141,8,227,19,21540
"Dolliver city, Iowa",45,45,0,89,19,21675
"Donahue city, Iowa",212,203,9,366,19,21720
"Donnellson city, Iowa",406,399,7,920,19,21810
"Doon city, Iowa",283,275,8,575,19,21900
"Douds CDP, Iowa",68,68,0,112,19,22035
"Dougherty city, Iowa",21,19,2,65,19,22080
"Dow City city, Iowa",267,265,2,411,19,22215
"Downey CDP, Iowa",52,52,0,81,19,22260
"Dows city, Iowa",271,268,3,535,19,22305
"Drakesville city, Iowa",72,64,8,163,19,22350
"Dubuque city, Iowa",32010,30404,1606,59315,19,22395
"Dumont city, Iowa",329,308,21,784,19,22620
"Duncan CDP, Iowa",28,28,0,80,19,22710
"Duncombe city, Iowa",199,189,10,362,19,22755
"Dundee city, Iowa",108,105,3,225,19,22800
"Dunkerton city, Iowa",458,452,6,860,19,22845
"Dunlap city, Iowa",793,747,46,1418,19,22890
"Durango city, Iowa",6,6,0,16,19,22935
"Durant city, Iowa",1072,1055,17,1902,19,22980
"Dyersville city, Iowa",2393,2319,74,4318,19,23115
"Dysart city, Iowa",805,764,41,1542,19,23160
"Eagle Grove city, Iowa",1514,1462,52,3589,19,23250
"Earlham city, Iowa",834,826,8,1367,19,23340
"Earling city, Iowa",176,162,14,403,19,23385
"Earlville city, Iowa",476,467,9,871,19,23430
"Early city, Iowa",490,443,47,787,19,23475
"East Amana CDP, Iowa",31,31,0,35,19,23520
"East Peru city, Iowa",91,89,2,183,19,23790
"Eddyville city, Iowa",544,514,30,1187,19,23970
"Edgewood city, Iowa",322,310,12,654,19,24060
"Elberon city, Iowa",79,78,1,139,19,24375
"Eldon city, Iowa",346,314,32,718,19,24420
"Eldora city, Iowa",1278,1239,39,2645,19,24465
"Eldridge city, Iowa",3418,3360,58,6693,19,24600
"Elgin city, Iowa",349,342,7,739,19,24645
"Elkader city, Iowa",624,618,6,1326,19,24690
"Elkhart city, Iowa",291,289,2,553,19,24735
"Elk Horn city, Iowa",242,232,10,544,19,24780
"Elkport city, Iowa",2,2,0,17,19,24825
"Elk Run Heights city, Iowa",446,445,1,886,19,24870
"Elliott city, Iowa",267,266,1,487,19,24915
"Ellston city, Iowa",12,12,0,36,19,25005
"Ellsworth city, Iowa",265,243,22,553,19,25050
"Elma city, Iowa",292,285,7,591,19,25095
"Ely city, Iowa",1213,1178,35,2045,19,25365
"Emerson city, Iowa",248,231,17,508,19,25500
"Emmetsburg city, Iowa",1966,1885,81,3671,19,25590
"Epworth city, Iowa",1040,1020,20,1982,19,25725
"Essex city, Iowa",437,415,22,907,19,25815
"Estherville city, Iowa",3065,2996,69,5881,19,25860
"Evansdale city, Iowa",2704,2491,213,4561,19,25995
"Everly city, Iowa",326,317,9,618,19,26175
"Exira city, Iowa",388,380,8,847,19,26265
"Exline city, Iowa",37,37,0,128,19,26310
"Fairbank city, Iowa",789,759,30,1490,19,26355
"Fairfax city, Iowa",1622,1575,47,2814,19,26400
"Fairfield city, Iowa",4723,4414,309,9474,19,26445
"Fairport CDP, Iowa",53,53,0,228,19,26580
"Farley city, Iowa",1023,974,49,1833,19,26760
"Farmersburg city, Iowa",211,205,6,395,19,26850
"Farmington city, Iowa",230,224,6,506,19,26895
"Farnhamville city, Iowa",189,187,2,448,19,26940
"Farragut city, Iowa",208,208,0,396,19,26985
"Fayette city, Iowa",708,637,71,1179,19,27165
"Fenton city, Iowa",132,124,8,248,19,27210
"Ferguson city, Iowa",28,19,9,102,19,27255
"Fertile city, Iowa",171,171,0,298,19,27390
"Floris city, Iowa",112,107,5,157,19,27975
"Floyd city, Iowa",172,162,10,295,19,28020
"Fonda city, Iowa",345,327,18,624,19,28245
"Fontanelle city, Iowa",285,275,10,608,19,28290
"Forest City city, Iowa",2292,2237,55,4254,19,28380
"Fort Atkinson city, Iowa",192,189,3,321,19,28425
"Fort Dodge city, Iowa",11954,11570,384,24850,19,28515
"Fort Madison city, Iowa",4837,4564,273,10293,19,28605
"Fostoria city, Iowa",115,115,0,174,19,28650
"Franklin city, Iowa",53,52,1,127,19,28740
"Fraser city, Iowa",72,69,3,123,19,28920
"Fredericksburg city, Iowa",517,512,5,1133,19,28965
"Frederika city, Iowa",181,175,6,301,19,29010
"Fredonia city, Iowa",145,143,2,230,19,29055
"Fremont city, Iowa",450,433,17,810,19,29190
"Fruitland city, Iowa",601,595,6,1127,19,29280
"Frytown CDP, Iowa",35,35,0,35,19,29325
"Galt city, Iowa",22,22,0,50,19,29550
"Galva city, Iowa",211,211,0,444,19,29595
"Garber city, Iowa",54,50,4,172,19,29685
"Garden City CDP, Iowa",61,57,4,127,19,29730
"Garden Grove city, Iowa",97,85,12,208,19,29775
"Garnavillo city, Iowa",369,367,2,790,19,29910
"Garner city, Iowa",1524,1497,27,3065,19,29955
"Garrison city, Iowa",153,149,4,328,19,30000
"Garwin city, Iowa",358,354,4,614,19,30045
"Geneva city, Iowa",91,88,3,162,19,30135
"George city, Iowa",541,516,25,1149,19,30225
"Gibson city, Iowa",23,18,5,43,19,30540
"Gilbert city, Iowa",682,667,15,1185,19,30630
"Gilbertville city, Iowa",432,420,12,770,19,30675
"Gillett Grove city, Iowa",17,17,0,39,19,30810
"Gilman city, Iowa",326,302,24,584,19,30900
"Gilmore City city, Iowa",284,281,3,609,19,30945
"Gladbrook city, Iowa",454,441,13,969,19,31035
"Glenwood city, Iowa",2398,2228,170,5128,19,31350
"Glidden city, Iowa",553,548,5,964,19,31395
"Goldfield city, Iowa",341,336,5,665,19,31530
"Goodell city, Iowa",97,97,0,160,19,31575
"Goose Lake city, Iowa",130,124,6,294,19,31665
"Gowrie city, Iowa",416,395,21,854,19,31710
"Graettinger city, Iowa",578,570,8,1010,19,31800
"Graf city, Iowa",24,23,1,39,19,31845
"Grafton city, Iowa",147,145,2,215,19,31890
"Grand Junction city, Iowa",313,291,22,606,19,31980
"Grand Mound city, Iowa",235,226,9,501,19,32025
"Grand River city, Iowa",78,69,9,184,19,32070
"Grandview city, Iowa",168,168,0,434,19,32115
"Granger city, Iowa",989,949,40,1950,19,32160
"Grant city, Iowa",23,23,0,64,19,32295
"Granville city, Iowa",141,140,1,287,19,32475
"Gravity city, Iowa",93,93,0,168,19,32520
"Gray city, Iowa",30,30,0,75,19,32565
"Greeley city, Iowa",165,152,13,272,19,32610
"Greene city, Iowa",641,609,32,1267,19,32745
"Greenfield city, Iowa",827,803,24,1778,19,32790
"Green Mountain CDP, Iowa",95,95,0,190,19,32925
"Greenville city, Iowa",36,36,0,71,19,32970
"Grimes city, Iowa",8801,8235,566,15402,19,33060
"Grinnell city, Iowa",4754,4566,188,9511,19,33105
"Griswold city, Iowa",549,538,11,1056,19,33150
"Grundy Center city, Iowa",1338,1302,36,2792,19,33195
"Gruver city, Iowa",26,26,0,47,19,33240
"Guernsey city, Iowa",36,36,0,61,19,33285
"Guthrie Center city, Iowa",827,812,15,1605,19,33420
"Guttenberg city, Iowa",887,857,30,1667,19,33465
"Halbur city, Iowa",203,201,2,338,19,33645
"Hamburg city, Iowa",521,507,14,1087,19,33780
"Hamilton city, Iowa",32,32,0,82,19,33870
"Hampton city, Iowa",1886,1858,28,4328,19,33960
"Hancock city, Iowa",147,143,4,276,19,34005
"Hanlontown city, Iowa",133,119,14,230,19,34185
"Hansell city, Iowa",53,53,0,101,19,34365
"Harcourt city, Iowa",102,102,0,197,19,34410
"Hardy city, Iowa",7,7,0,17,19,34455
"Harlan city, Iowa",2449,2365,84,4897,19,34500
"Harper city, Iowa",63,56,7,124,19,34545
"Harpers Ferry city, Iowa",103,102,1,236,19,34590
"Harris city, Iowa",130,130,0,193,19,34635
"Hartford city, Iowa",349,330,19,657,19,34680
"Hartley city, Iowa",717,694,23,1536,19,34725
"Hartwick city, Iowa",51,51,0,108,19,34770
"Harvey city, Iowa",80,80,0,172,19,34860
"Hastings city, Iowa",53,53,0,127,19,34995
"Havelock city, Iowa",97,93,4,180,19,35130
"Haverhill city, Iowa",98,92,6,169,19,35220
"Hawarden city, Iowa",1208,1156,52,2673,19,35265
"Hawkeye city, Iowa",279,274,5,511,19,35310
"Hayesville city, Iowa",28,27,1,68,19,35445
"Hayfield CDP, Iowa",9,9,0,20,19,35490
"Hazleton city, Iowa",315,295,20,669,19,35580
"Hedrick city, Iowa",333,302,31,813,19,35670
"Henderson city, Iowa",71,69,2,224,19,35715
"Hepburn city, Iowa",4,4,0,15,19,35760
"Hiawatha city, Iowa",3913,3631,282,7179,19,35940
"High Amana CDP, Iowa",81,81,0,92,19,36030
"Hills city, Iowa",539,535,4,889,19,36345
"Hillsboro city, Iowa",56,50,6,144,19,36390
"Hinton city, Iowa",554,553,1,936,19,36480
"Holiday Lake CDP, Iowa",196,196,0,371,19,36660
"Holland city, Iowa",155,132,23,263,19,36705
"Holstein city, Iowa",838,827,11,1560,19,36840
"Holy Cross city, Iowa",167,165,2,288,19,36885
"Homestead CDP, Iowa",28,28,0,126,19,36975
"Hopkinton city, Iowa",347,341,6,657,19,37155
"Hornick city, Iowa",149,149,0,294,19,37200
"Hospers city, Iowa",424,407,17,941,19,37290
"Houghton city, Iowa",37,35,2,77,19,37335
"Hubbard city, Iowa",427,422,5,830,19,37425
"Hudson city, Iowa",1326,1267,59,2557,19,37470
"Hull city, Iowa",1372,1325,47,2340,19,37515
"Humboldt city, Iowa",2270,2254,16,4774,19,37560
"Humeston city, Iowa",223,218,5,510,19,37605
"Hutchins CDP, Iowa",0,0,0,0,19,37875
"Huxley city, Iowa",2309,2277,32,4331,19,37920
"Ida Grove city, Iowa",1066,1024,42,1969,19,38010
"Imogene city, Iowa",11,11,0,51,19,38055
"Independence city, Iowa",3178,3130,48,6106,19,38100
"Indianola city, Iowa",8124,7805,319,15845,19,38280
"Inwood city, Iowa",459,425,34,879,19,38415
"Ionia city, Iowa",168,165,3,294,19,38460
"Iowa City city, Iowa",44099,41979,2120,74878,19,38595
"Iowa Falls city, Iowa",2561,2405,156,5095,19,38640
"Ireton city, Iowa",293,288,5,550,19,38820
"Irvington CDP, Iowa",33,33,0,54,19,38955
"Irwin city, Iowa",198,196,2,338,19,39000
"Jackson Junction city, Iowa",19,19,0,37,19,39135
"Jacksonville CDP, Iowa",4,4,0,4,19,39180
"Jamaica city, Iowa",82,78,4,195,19,39225
"Janesville city, Iowa",578,569,9,1063,19,39405
"Jefferson city, Iowa",2009,1966,43,4190,19,39450
"Jesup city, Iowa",1332,1269,63,2502,19,39585
"Jewell Junction city, Iowa",724,719,5,1284,19,39675
"Johnston city, Iowa",12492,12244,248,23856,19,39765
"Joice city, Iowa",114,111,3,247,19,39855
"Jolley city, Iowa",11,10,1,28,19,39900
"Kalona city, Iowa",1487,1474,13,2637,19,40170
"Kamrar city, Iowa",84,84,0,160,19,40215
"Kanawha city, Iowa",486,477,9,912,19,40260
"Kellerton city, Iowa",134,129,5,247,19,40350
"Kelley city, Iowa",290,286,4,401,19,40395
"Kellogg city, Iowa",300,259,41,635,19,40440
"Kensett city, Iowa",127,127,0,275,19,40665
"Kent CDP, Iowa",0,0,0,0,19,40710
"Kent Estates CDP, Iowa",973,956,17,2044,19,40733
"Keokuk city, Iowa",4536,4173,363,9868,19,40845
"Keomah Village city, Iowa",40,39,1,116,19,40890
"Keosauqua city, Iowa",341,325,16,921,19,40935
"Keota city, Iowa",486,483,3,883,19,40980
"Keswick city, Iowa",116,116,0,279,19,41070
"Keystone city, Iowa",318,314,4,739,19,41115
"Kimballton city, Iowa",109,105,4,289,19,41295
"Kingsley city, Iowa",723,723,0,1382,19,41385
"Kingston CDP, Iowa",25,25,0,35,19,41430
"Kinross city, Iowa",34,31,3,104,19,41475
"Kirkman city, Iowa",41,37,4,58,19,41520
"Kirkville city, Iowa",135,131,4,262,19,41565
"Kiron city, Iowa",96,93,3,277,19,41610
"Klemme city, Iowa",359,349,10,694,19,41655
"Knierim city, Iowa",46,46,0,75,19,41790
"Knoxville city, Iowa",3529,3417,112,7523,19,42015
"Lacona city, Iowa",184,168,16,361,19,42285
"Ladora city, Iowa",140,134,6,256,19,42330
"Lake City city, Iowa",804,788,16,1745,19,42465
"Lake Mills city, Iowa",1060,1030,30,1965,19,42555
"Lake Panorama CDP, Iowa",408,408,0,866,19,42575
"Lake Park city, Iowa",673,670,3,1223,19,42600
"Lakeside city, Iowa",376,352,24,666,19,42645
"Lake View city, Iowa",453,446,7,920,19,42690
"Lakota city, Iowa",126,123,3,288,19,42825
"Lambs Grove city, Iowa",170,155,15,280,19,42870
"Lamoni city, Iowa",1172,1084,88,2284,19,42960
"Lamont city, Iowa",220,217,3,510,19,43005
"La Motte city, Iowa",151,147,4,267,19,43050
"Lanesboro city, Iowa",36,33,3,62,19,43140
"Lansing city, Iowa",486,462,24,1053,19,43275
"La Porte City city, Iowa",1159,1138,21,2347,19,43365
"Larchwood city, Iowa",592,589,3,993,19,43410
"Larrabee city, Iowa",83,83,0,132,19,43500
"Latimer city, Iowa",354,343,11,694,19,43590
"Laurel city, Iowa",110,109,1,198,19,43680
"Laurens city, Iowa",616,551,65,1223,19,43725
"Lawler city, Iowa",212,201,11,377,19,43815
"Lawton city, Iowa",563,553,10,1021,19,43905
"Leando CDP, Iowa",9,9,0,23,19,43950
"Le Claire city, Iowa",1932,1918,14,4679,19,44085
"Ledyard city, Iowa",46,46,0,79,19,44130
"Le Grand city, Iowa",414,404,10,790,19,44220
"Lehigh city, Iowa",215,205,10,423,19,44265
"Leighton city, Iowa",112,112,0,179,19,44310
"Leland city, Iowa",116,108,8,238,19,44355
"Le Mars city, Iowa",5670,5516,154,10549,19,44400
"Lenox city, Iowa",790,769,21,1488,19,44490
"Leon city, Iowa",798,787,11,1707,19,44535
"Le Roy city, Iowa",9,9,0,12,19,44580
"Lester city, Iowa",172,172,0,303,19,44670
"Letts city, Iowa",196,180,16,364,19,44715
"Lewis city, Iowa",155,142,13,455,19,44805
"Libertyville city, Iowa",207,204,3,325,19,44985
"Lidderdale city, Iowa",87,83,4,171,19,45030
"Lime Springs city, Iowa",232,227,5,443,19,45165
"Lincoln city, Iowa",55,55,0,118,19,45255
"Linden city, Iowa",83,76,7,175,19,45390
"Lineville city, Iowa",161,160,1,260,19,45435
"Linn Grove city, Iowa",51,48,3,142,19,45480
"Lisbon city, Iowa",1020,990,30,1874,19,45615
"Liscomb city, Iowa",178,170,8,324,19,45660
"Little Cedar CDP, Iowa",39,39,0,39,19,45705
"Little Rock city, Iowa",233,231,2,430,19,45795
"Little Sioux city, Iowa",51,51,0,179,19,45840
"Livermore city, Iowa",278,253,25,457,19,45975
"Lockridge city, Iowa",286,272,14,456,19,46065
"Logan city, Iowa",741,729,12,1437,19,46155
"Lohrville city, Iowa",163,163,0,334,19,46245
"Lone Rock city, Iowa",58,58,0,114,19,46290
"Lone Tree city, Iowa",748,739,9,1261,19,46335
"Long Grove city, Iowa",317,312,5,675,19,46425
"Lorimor city, Iowa",137,120,17,359,19,46515
"Lost Nation city, Iowa",166,162,4,407,19,46605
"Loveland CDP, Iowa",35,26,9,43,19,46785
"Lovilia city, Iowa",311,297,14,542,19,46830
"Lowden city, Iowa",363,339,24,749,19,46920
"Lowell CDP, Iowa",44,44,0,103,19,46965
"Low Moor city, Iowa",137,124,13,248,19,47010
"Luana city, Iowa",135,135,0,242,19,47055
"Lucas city, Iowa",45,44,1,107,19,47100
"Luther city, Iowa",92,89,3,171,19,47280
"Lu Verne city, Iowa",140,138,2,297,19,47370
"Luxemburg city, Iowa",102,100,2,222,19,47460
"Luzerne city, Iowa",72,70,2,133,19,47505
"Lynnville city, Iowa",303,299,4,497,19,47595
"Lytton city, Iowa",176,166,10,303,19,47730
"McCallsburg city, Iowa",305,275,30,484,19,47775
"McCausland city, Iowa",167,157,10,352,19,47820
"McClelland city, Iowa",70,67,3,159,19,47865
"Macedonia city, Iowa",109,107,2,224,19,47955
"McGregor city, Iowa",321,321,0,686,19,48000
"McIntire city, Iowa",45,41,4,94,19,48045
"Macksburg city, Iowa",47,44,3,81,19,48180
"Madrid city, Iowa",1406,1390,16,2784,19,48450
"Magnolia city, Iowa",75,74,1,144,19,48495
"Maharishi Vedic City city, Iowa",101,101,0,275,19,48500
"Malcom city, Iowa",144,143,1,246,19,48540
"Mallard city, Iowa",126,105,21,251,19,48585
"Maloy city, Iowa",38,38,0,54,19,48675
"Malvern city, Iowa",703,673,30,1264,19,48720
"Manchester city, Iowa",2820,2741,79,5112,19,48810
"Manilla city, Iowa",403,401,2,733,19,48855
"Manly city, Iowa",834,793,41,1415,19,48900
"Manning city, Iowa",802,798,4,1444,19,48945
"Manson city, Iowa",879,838,41,1718,19,48990
"Mapleton city, Iowa",406,396,10,923,19,49170
"Maquoketa city, Iowa",2893,2679,214,6123,19,49215
"Marathon city, Iowa",121,97,24,204,19,49260
"Marble Rock city, Iowa",166,158,8,271,19,49305
"Marcus city, Iowa",712,695,17,1200,19,49350
"Marengo city, Iowa",1485,1443,42,2812,19,49395
"Marion city, Iowa",22518,21680,838,41401,19,49485
"Marne city, Iowa",50,47,3,98,19,49575
"Marquette city, Iowa",282,263,19,467,19,49620
"Marshalltown city, Iowa",13787,12853,934,27511,19,49755
"Martelle city, Iowa",250,222,28,411,19,49845
"Martensdale city, Iowa",302,283,19,579,19,49890
"Martinsburg city, Iowa",55,53,2,110,19,49935
"Marysville city, Iowa",31,25,6,67,19,50070
"Mason City city, Iowa",14738,14244,494,27271,19,50160
"Masonville city, Iowa",42,41,1,74,19,50205
"Massena city, Iowa",187,177,10,390,19,50250
"Matlock city, Iowa",93,91,2,147,19,50385
"Maurice city, Iowa",143,141,2,246,19,50430
"Maxwell city, Iowa",405,386,19,776,19,50520
"Maynard city, Iowa",283,283,0,484,19,50610
"Maysville city, Iowa",76,60,16,171,19,50655
"Mechanicsville city, Iowa",502,481,21,924,19,50700
"Mediapolis city, Iowa",1118,1082,36,2214,19,50790
"Melbourne city, Iowa",445,426,19,788,19,50880
"Melcher-Dallas city, Iowa",591,552,39,1278,19,50935
"Melrose city, Iowa",43,26,17,152,19,50970
"Melvin city, Iowa",160,153,7,322,19,51060
"Menlo city, Iowa",266,240,26,407,19,51105
"Meriden city, Iowa",56,56,0,109,19,51150
"Merrill city, Iowa",509,495,14,960,19,51375
"Meservey city, Iowa",105,104,1,281,19,51420
"Meyer CDP, Iowa",0,0,0,0,19,51510
"Middle Amana CDP, Iowa",272,272,0,578,19,51600
"Middletown city, Iowa",167,167,0,383,19,51735
"Miles city, Iowa",199,196,3,398,19,52050
"Milford city, Iowa",1727,1668,59,3295,19,52095
"Miller CDP, Iowa",25,25,0,52,19,52140
"Millersburg city, Iowa",68,68,0,155,19,52230
"Millerton city, Iowa",22,22,0,33,19,52275
"Milo city, Iowa",456,456,0,789,19,52455
"Milton city, Iowa",202,191,11,496,19,52500
"Minburn city, Iowa",210,208,2,377,19,52545
"Minden city, Iowa",374,370,4,728,19,52590
"Mineola CDP, Iowa",0,0,0,26,19,52635
"Mingo city, Iowa",182,173,9,346,19,52815
"Missouri Valley city, Iowa",1272,1214,58,2692,19,52860
"Mitchell city, Iowa",48,47,1,93,19,52905
"Mitchellville city, Iowa",1019,1009,10,2506,19,52950
"Modale city, Iowa",100,90,10,234,19,52995
"Mona CDP, Iowa",12,12,0,26,19,53085
"Mondamin city, Iowa",233,218,15,389,19,53175
"Monmouth city, Iowa",70,69,1,142,19,53265
"Monona city, Iowa",855,844,11,1571,19,53310
"Monroe city, Iowa",1073,1060,13,1889,19,53355
"Montezuma city, Iowa",710,638,72,1335,19,53490
"Monticello city, Iowa",2278,2231,47,4034,19,53625
"Montour city, Iowa",125,122,3,193,19,53670
"Montpelier CDP, Iowa",82,82,0,172,19,53715
"Montrose city, Iowa",347,338,9,706,19,53760
"Mooar CDP, Iowa",154,154,0,268,19,53805
"Moorhead city, Iowa",110,107,3,242,19,53850
"Moorland city, Iowa",103,95,8,186,19,53895
"Moravia city, Iowa",276,234,42,592,19,53985
"Morley city, Iowa",35,35,0,49,19,54030
"Morning Sun city, Iowa",403,397,6,783,19,54120
"Morrison city, Iowa",55,49,6,122,19,54165
"Moscow CDP, Iowa",220,220,0,274,19,54345
"Moulton city, Iowa",255,248,7,613,19,54390
"Mount Auburn city, Iowa",78,72,6,154,19,54435
"Mount Ayr city, Iowa",847,835,12,1838,19,54480
"Mount Pleasant city, Iowa",4446,4324,122,9214,19,54705
"Mount Sterling CDP, Iowa",0,0,0,0,19,54750
"Mount Union CDP, Iowa",50,50,0,122,19,54795
"Mount Vernon city, Iowa",2171,2065,106,4529,19,54840
"Moville city, Iowa",936,918,18,1640,19,54930
"Murray city, Iowa",350,339,11,681,19,55065
"Muscatine city, Iowa",11934,11425,509,23671,19,55110
"Mystic city, Iowa",147,137,10,335,19,55200
"Nashua city, Iowa",848,838,10,1472,19,55335
"Nemaha city, Iowa",37,35,2,101,19,55515
"Neola city, Iowa",507,504,3,1125,19,55560
"Nevada city, Iowa",3654,3590,64,6933,19,55695
"New Albin city, Iowa",276,276,0,478,19,55785
"Newell city, Iowa",433,411,22,892,19,55965
"Newhall city, Iowa",549,523,26,1076,19,56055
"New Hampton city, Iowa",1823,1758,65,3473,19,56100
"New Hartford city, Iowa",385,360,25,758,19,56145
"New Haven CDP, Iowa",15,15,0,58,19,56190
"New Liberty city, Iowa",95,92,3,168,19,56280
"New London city, Iowa",1323,1290,33,2471,19,56325
"New Market city, Iowa",209,202,7,370,19,56370
"New Providence city, Iowa",105,99,6,224,19,56415
"New Sharon city, Iowa",653,636,17,1183,19,56460
"Newton city, Iowa",7692,7224,468,15692,19,56505
"New Vienna city, Iowa",265,260,5,412,19,56550
"New Virginia city, Iowa",234,229,5,519,19,56595
"Nichols city, Iowa",198,196,2,344,19,56685
"Nodaway city, Iowa",24,22,2,64,19,56865
"Nora Springs city, Iowa",666,666,0,1464,19,56910
"Northboro city, Iowa",59,59,0,99,19,57045
"North Buena Vista city, Iowa",44,40,4,106,19,57135
"North English city, Iowa",392,387,5,826,19,57225
"North Liberty city, Iowa",11833,11601,232,20393,19,57360
"North Washington city, Iowa",77,77,0,144,19,57495
"Northwood city, Iowa",1152,1088,64,2142,19,57630
"Norwalk city, Iowa",7297,7074,223,13057,19,57675
"Norway city, Iowa",331,329,2,516,19,57720
"Numa city, Iowa",17,17,0,53,19,57945
"Oak Hills CDP, Iowa",47,47,0,116,19,58048
"Oakland city, Iowa",794,784,10,1678,19,58080
"Oakland Acres city, Iowa",102,101,1,194,19,58170
"Oakville city, Iowa",90,82,8,202,19,58395
"Ocheyedan city, Iowa",310,310,0,577,19,58530
"Odebolt city, Iowa",393,378,15,873,19,58575
"Oelwein city, Iowa",2505,2338,167,5934,19,58620
"Ogden city, Iowa",986,949,37,1878,19,58665
"Okoboji city, Iowa",427,418,9,784,19,58710
"Olds city, Iowa",91,91,0,150,19,58890
"Olin city, Iowa",498,428,70,875,19,58980
"Ollie city, Iowa",64,57,7,160,19,59070
"Onawa city, Iowa",1369,1328,41,2876,19,59115
"Onslow city, Iowa",129,127,2,319,19,59250
"Orange City city, Iowa",3496,3307,189,6278,19,59475
"Orchard city, Iowa",36,36,0,99,19,59520
"Orient city, Iowa",235,208,27,417,19,59565
"Orleans city, Iowa",275,252,23,690,19,59655
"Osage city, Iowa",1968,1945,23,3590,19,59745
"Osceola city, Iowa",2812,2650,162,5455,19,59835
"Oskaloosa city, Iowa",5964,5705,259,11492,19,59925
"Ossian city, Iowa",487,477,10,847,19,59970
"Osterdock city, Iowa",58,35,23,151,19,60015
"Otho city, Iowa",206,199,7,421,19,60105
"Oto city, Iowa",39,30,9,80,19,60240
"Otranto CDP, Iowa",0,0,0,23,19,60285
"Ottosen city, Iowa",9,8,1,25,19,60420
"Ottumwa city, Iowa",12704,12129,575,25359,19,60465
"Owasa city, Iowa",12,12,0,22,19,60555
"Oxford city, Iowa",432,419,13,702,19,60645
"Oxford Junction city, Iowa",187,183,4,540,19,60690
"Oyens city, Iowa",81,80,1,121,19,60780
"Pacific Junction city, Iowa",86,77,9,167,19,60825
"Packwood city, Iowa",185,166,19,455,19,60915
"Palmer city, Iowa",61,60,1,127,19,61050
"Palo city, Iowa",689,667,22,1162,19,61230
"Panama city, Iowa",135,135,0,247,19,61275
"Panora city, Iowa",636,586,50,1490,19,61320
"Panorama Park city, Iowa",75,75,0,136,19,61365
"Parkersburg city, Iowa",845,806,39,1738,19,61590
"Park View CDP, Iowa",1518,1471,47,2835,19,61725
"Parnell city, Iowa",147,145,2,241,19,61770
"Paton city, Iowa",150,150,0,228,19,61815
"Patterson city, Iowa",184,182,2,305,19,61860
"Paullina city, Iowa",481,463,18,873,19,61905
"Pella city, Iowa",5665,5570,95,10556,19,62040
"Peosta city, Iowa",1062,1044,18,1852,19,62130
"Percival CDP, Iowa",39,39,0,104,19,62175
"Perry city, Iowa",4367,3954,413,7875,19,62355
"Persia city, Iowa",153,149,4,322,19,62445
"Peterson city, Iowa",200,194,6,382,19,62625
"Pierson city, Iowa",148,139,9,325,19,62760
"Pilot Mound city, Iowa",65,61,4,160,19,62850
"Pisgah city, Iowa",121,115,6,248,19,63075
"Plainfield city, Iowa",230,208,22,381,19,63210
"Plainview CDP, Iowa",10,10,0,10,19,63300
"Plano city, Iowa",57,28,29,84,19,63345
"Pleasant Hill city, Iowa",4909,4459,450,10456,19,63525
"Pleasanton city, Iowa",24,24,0,62,19,63570
"Pleasant Plain city, Iowa",38,38,0,79,19,63615
"Pleasantville city, Iowa",945,924,21,1840,19,63750
"Plover city, Iowa",40,35,5,86,19,63840
"Plymouth city, Iowa",207,206,1,374,19,63885
"Pocahontas city, Iowa",853,807,46,1614,19,63975
"Polk City city, Iowa",3328,3202,126,5604,19,64020
"Pomeroy city, Iowa",210,208,2,527,19,64065
"Popejoy city, Iowa",27,27,0,106,19,64110
"Portland CDP, Iowa",15,15,0,28,19,64155
"Portsmouth city, Iowa",108,108,0,175,19,64200
"Postville city, Iowa",1136,1058,78,2653,19,64290
"Prairieburg city, Iowa",94,87,7,180,19,64425
"Prairie City city, Iowa",968,912,56,1762,19,64470
"Prescott city, Iowa",144,143,1,303,19,64560
"Preston city, Iowa",499,498,1,1005,19,64605
"Primghar city, Iowa",399,374,25,870,19,64650
"Princeton city, Iowa",506,477,29,882,19,64740
"Promise City city, Iowa",29,29,0,80,19,64875
"Protivin city, Iowa",184,178,6,365,19,65010
"Pulaski city, Iowa",198,174,24,353,19,65055
"Quasqueton city, Iowa",361,350,11,731,19,65235
"Quimby city, Iowa",190,177,13,329,19,65280
"Radcliffe city, Iowa",277,271,6,564,19,65370
"Rake city, Iowa",70,70,0,187,19,65415
"Ralston city, Iowa",35,31,4,71,19,65505
"Randalia city, Iowa",33,29,4,65,19,65550
"Randall city, Iowa",81,74,7,157,19,65595
"Randolph city, Iowa",95,90,5,266,19,65640
"Rathbun city, Iowa",21,21,0,38,19,65730
"Raymond city, Iowa",397,376,21,810,19,65820
"Readlyn city, Iowa",394,389,5,758,19,65910
"Reasnor city, Iowa",90,79,11,183,19,65955
"Redding city, Iowa",21,21,0,64,19,66000
"Redfield city, Iowa",411,401,10,810,19,66045
"Red Oak city, Iowa",2583,2390,193,5563,19,66135
"Reinbeck city, Iowa",892,868,24,1784,19,66315
"Rembrandt city, Iowa",104,97,7,179,19,66360
"Remsen city, Iowa",1209,1181,28,2095,19,66405
"Renwick city, Iowa",167,166,1,264,19,66450
"Rhodes city, Iowa",139,129,10,292,19,66540
"Riceville city, Iowa",416,407,9,962,19,66585
"Richland city, Iowa",246,233,13,497,19,66720
"Rickardsville city, Iowa",125,124,1,258,19,66810
"Ricketts city, Iowa",24,17,7,59,19,66855
"Ridgeway city, Iowa",168,158,10,253,19,67035
"Rinard city, Iowa",23,23,0,52,19,67125
"Ringsted city, Iowa",236,231,5,430,19,67170
"Rippey city, Iowa",99,98,1,188,19,67215
"Riverdale city, Iowa",291,276,15,491,19,67350
"Riverside city, Iowa",685,657,28,1090,19,67440
"River Sioux CDP, Iowa",5,5,0,5,19,67530
"Riverton city, Iowa",112,105,7,265,19,67575
"Robins city, Iowa",1688,1574,114,3356,19,67800
"Rochester CDP, Iowa",30,14,16,48,19,67890
"Rock Falls city, Iowa",78,73,5,130,19,68025
"Rockford city, Iowa",442,422,20,895,19,68070
"Rock Rapids city, Iowa",1210,1160,50,2631,19,68160
"Rock Valley city, Iowa",2384,2364,20,4045,19,68205
"Rockwell city, Iowa",435,430,5,1004,19,68250
"Rockwell City city, Iowa",726,704,22,2389,19,68295
"Rodman city, Iowa",13,13,0,16,19,68340
"Rodney city, Iowa",16,15,1,62,19,68385
"Roland city, Iowa",880,874,6,1472,19,68475
"Rolfe city, Iowa",288,224,64,665,19,68520
"Rome city, Iowa",47,47,0,72,19,68565
"Rose Hill city, Iowa",127,123,4,264,19,68700
"Roseville CDP, Iowa",6,6,0,12,19,68800
"Rossie city, Iowa",30,30,0,77,19,68925
"Rowan city, Iowa",59,54,5,140,19,69015
"Rowley city, Iowa",223,202,21,353,19,69060
"Royal city, Iowa",282,272,10,510,19,69105
"Rudd city, Iowa",301,287,14,493,19,69195
"Runnells city, Iowa",221,208,13,388,19,69240
"Russell city, Iowa",225,225,0,532,19,69285
"Ruthven city, Iowa",343,331,12,746,19,69330
"Rutland city, Iowa",78,77,1,127,19,69375
"Ryan city, Iowa",174,173,1,368,19,69465
"Sabula city, Iowa",240,229,11,548,19,69510
"Sac City city, Iowa",1014,995,19,1825,19,69645
"Sageville city, Iowa",39,39,0,76,19,69690
"St. Ansgar city, Iowa",583,560,23,1140,19,69735
"St. Anthony city, Iowa",44,44,0,88,19,69780
"St. Benedict CDP, Iowa",36,27,9,44,19,69825
"St. Charles city, Iowa",544,539,5,903,19,69915
"St. Donatus city, Iowa",74,74,0,128,19,69960
"St. Joseph CDP, Iowa",18,18,0,67,19,70005
"St. Lucas city, Iowa",75,75,0,146,19,70050
"St. Marys city, Iowa",74,74,0,131,19,70095
"St. Olaf city, Iowa",67,63,4,107,19,70140
"St. Paul city, Iowa",41,41,0,65,19,70185
"Salem city, Iowa",145,142,3,338,19,70230
"Salix city, Iowa",254,253,1,446,19,70320
"Sanborn city, Iowa",642,631,11,1536,19,70410
"Sandusky CDP, Iowa",130,130,0,364,19,70545
"Sandyville city, Iowa",17,16,1,46,19,70590
"Saylorville CDP, Iowa",1570,1406,164,2837,19,70995
"Scarville city, Iowa",33,32,1,57,19,71040
"Schaller city, Iowa",427,421,6,844,19,71085
"Schleswig city, Iowa",507,484,23,933,19,71130
"Scranton city, Iowa",280,273,7,522,19,71310
"Searsboro city, Iowa",67,67,0,152,19,71355
"Sergeant Bluff city, Iowa",2883,2763,120,5007,19,71625
"Sexton CDP, Iowa",0,0,0,0,19,71715
"Seymour city, Iowa",245,239,6,558,19,71760
"Shambaugh city, Iowa",82,82,0,159,19,71895
"Shannon City city, Iowa",54,48,6,89,19,71940
"Sharpsburg city, Iowa",34,33,1,72,19,72075
"Sheffield city, Iowa",618,602,16,1209,19,72210
"Shelby city, Iowa",420,396,24,698,19,72300
"Sheldahl city, Iowa",197,169,28,382,19,72345
"Sheldon city, Iowa",2871,2827,44,5417,19,72390
"Shell Rock city, Iowa",745,725,20,1542,19,72435
"Shellsburg city, Iowa",373,367,6,834,19,72480
"Shenandoah city, Iowa",2272,2138,134,4930,19,72525
"Sherrill city, Iowa",127,122,5,233,19,72660
"Shueyville city, Iowa",454,449,5,813,19,72840
"Sibley city, Iowa",1380,1276,104,2830,19,72975
"Sidney city, Iowa",434,430,4,948,19,73065
"Sigourney city, Iowa",819,807,12,1835,19,73110
"Silver City city, Iowa",219,210,9,400,19,73155
"Sioux Center city, Iowa",4643,4593,50,8227,19,73290
"Sioux City city, Iowa",44828,42699,2129,85469,19,73335
"Sioux Rapids city, Iowa",400,392,8,812,19,73425
"Slater city, Iowa",918,900,18,1546,19,73515
"Sloan city, Iowa",513,464,49,1051,19,73605
"Smithland city, Iowa",88,86,2,157,19,73650
"Soldier city, Iowa",89,88,1,166,19,73785
"Solon city, Iowa",1692,1672,20,3020,19,73875
"Somers city, Iowa",57,56,1,134,19,73920
"South Amana CDP, Iowa",68,68,0,151,19,73965
"South English city, Iowa",142,138,4,252,19,74055
"Spencer city, Iowa",6081,5763,318,11351,19,74280
"Sperry CDP, Iowa",91,91,0,101,19,74325
"Spillville city, Iowa",171,168,3,350,19,74370
"Spirit Lake city, Iowa",3007,2971,36,5409,19,74415
"Spragueville city, Iowa",39,39,0,116,19,74460
"Springbrook city, Iowa",59,59,0,128,19,74505
"Spring Hill city, Iowa",47,46,1,71,19,74685
"Springville city, Iowa",638,629,9,1160,19,74775
"Stacyville city, Iowa",238,238,0,488,19,74820
"Stanhope city, Iowa",271,267,4,516,19,74910
"Stanley city, Iowa",53,37,16,81,19,74955
"Stanton city, Iowa",299,299,0,674,19,75000
"Stanwood city, Iowa",284,278,6,568,19,75045
"State Center city, Iowa",928,871,57,1654,19,75135
"Steamboat Rock city, Iowa",118,115,3,235,19,75180
"Stockport city, Iowa",121,88,33,262,19,75405
"Stockton city, Iowa",100,84,16,148,19,75450
"Stone City CDP, Iowa",55,55,0,106,19,75540
"Storm Lake city, Iowa",5858,5620,238,11194,19,75630
"Story City city, Iowa",1666,1599,67,3352,19,75675
"Stout city, Iowa",152,146,6,271,19,75720
"Stratford city, Iowa",347,333,14,822,19,75810
"Strawberry Point city, Iowa",745,706,39,1427,19,75855
"Struble city, Iowa",51,51,0,84,19,75945
"Stuart city, Iowa",854,826,28,1726,19,75990
"Sully city, Iowa",569,545,24,1022,19,76035
"Sumner city, Iowa",1043,1011,32,2145,19,76260
"Sun Valley Lake CDP, Iowa",64,64,0,131,19,76415
"Superior city, Iowa",61,57,4,143,19,76440
"Sutherland city, Iowa",256,245,11,518,19,76485
"Swaledale city, Iowa",55,53,2,120,19,76620
"Swan city, Iowa",31,31,0,59,19,76665
"Swea City city, Iowa",319,307,12,690,19,76755
"Swedesburg CDP, Iowa",26,26,0,108,19,76800
"Swisher city, Iowa",593,584,9,1126,19,76890
"Tabor city, Iowa",471,465,6,997,19,76935
"Tama city, Iowa",1391,1284,107,3073,19,77115
"Templeton city, Iowa",195,191,4,335,19,77340
"Tennant city, Iowa",27,27,0,59,19,77430
"Terril city, Iowa",183,182,1,302,19,77520
"Thayer city, Iowa",17,16,1,43,19,77565
"Thompson city, Iowa",231,221,10,466,19,77745
"Thor city, Iowa",84,75,9,193,19,77790
"Thornburg city, Iowa",30,24,6,59,19,77835
"Thornton city, Iowa",248,243,5,466,19,77880
"Thurman city, Iowa",82,79,3,172,19,77970
"Tiffin city, Iowa",2562,2470,92,4845,19,78060
"Tingley city, Iowa",60,60,0,112,19,78195
"Tipton city, Iowa",1616,1575,41,3130,19,78285
"Titonka city, Iowa",236,233,3,439,19,78330
"Toeterville CDP, Iowa",15,15,0,21,19,78465
"Toledo city, Iowa",933,835,98,2047,19,78510
"Toronto city, Iowa",33,27,6,76,19,78600
"Traer city, Iowa",739,714,25,1441,19,78735
"Trenton CDP, Iowa",30,30,0,70,19,78780
"Treynor city, Iowa",578,557,21,1071,19,78825
"Tripoli city, Iowa",644,629,15,1207,19,78915
"Truesdale city, Iowa",58,58,0,141,19,79095
"Truro city, Iowa",286,284,2,581,19,79140
"Turin city, Iowa",88,88,0,120,19,79185
"Twin Lakes CDP, Iowa",237,209,28,475,19,79335
"Udell city, Iowa",14,14,0,24,19,79410
"Underwood city, Iowa",543,535,8,983,19,79500
"Union city, Iowa",227,218,9,421,19,79545
"Unionville city, Iowa",54,53,1,115,19,79680
"University Heights city, Iowa",748,736,12,1353,19,79770
"University Park city, Iowa",290,280,10,566,19,79815
"Urbana city, Iowa",886,865,21,1565,19,79905
"Urbandale city, Iowa",24738,24207,531,45591,19,79950
"Ute city, Iowa",170,168,2,331,19,79995
"Vail city, Iowa",212,207,5,512,19,80130
"Valeria city, Iowa",22,19,3,42,19,80175
"Van Horne city, Iowa",406,373,33,750,19,80400
"Van Meter city, Iowa",793,786,7,1468,19,80445
"Van Wert city, Iowa",61,59,2,110,19,80490
"Varina city, Iowa",17,17,0,32,19,80535
"Ventura city, Iowa",355,351,4,638,19,80580
"Victor city, Iowa",423,415,8,946,19,80805
"Villisca city, Iowa",472,463,9,1071,19,80985
"Vincent city, Iowa",78,77,1,119,19,81075
"Vining city, Iowa",38,36,2,81,19,81120
"Vinton city, Iowa",2357,2304,53,4953,19,81210
"Volga city, Iowa",110,110,0,244,19,81345
"Wadena city, Iowa",79,76,3,211,19,81570
"Wahpeton city, Iowa",174,174,0,403,19,81615
"Walcott city, Iowa",939,914,25,1854,19,81705
"Walford city, Iowa",909,888,21,1434,19,81840
"Walker city, Iowa",383,368,15,737,19,81885
"Wallingford city, Iowa",82,81,1,167,19,81975
"Wall Lake city, Iowa",307,294,13,691,19,82020
"Walnut city, Iowa",359,350,9,990,19,82065
"Wapello city, Iowa",1039,996,43,1861,19,82200
"Washburn CDP, Iowa",291,286,5,594,19,82290
"Washington city, Iowa",3560,3446,114,7329,19,82335
"Washta city, Iowa",91,79,12,155,19,82380
"Waterloo city, Iowa",34477,32035,2442,67256,19,82425
"Waterville city, Iowa",71,71,0,157,19,82470
"Watkins CDP, Iowa",33,33,0,63,19,82515
"Waucoma city, Iowa",196,193,3,313,19,82650
"Waukee city, Iowa",14567,14115,452,25045,19,82695
"Waukon city, Iowa",1848,1754,94,3818,19,82740
"Waverly city, Iowa",5565,5415,150,10399,19,82875
"Wayland city, Iowa",624,610,14,1148,19,82965
"Webb city, Iowa",63,63,0,128,19,83010
"Webster city, Iowa",65,62,3,145,19,83055
"Webster City city, Iowa",3697,3536,161,7787,19,83145
"Weldon city, Iowa",40,35,5,94,19,83190
"Wellman city, Iowa",796,785,11,1474,19,83280
"Wellsburg city, Iowa",338,321,17,730,19,83325
"Welton city, Iowa",83,81,2,155,19,83370
"Wesley city, Iowa",209,198,11,355,19,83415
"West Amana CDP, Iowa",43,43,0,74,19,83505
"West Bend city, Iowa",421,404,17,936,19,83550
"West Branch city, Iowa",1466,1458,8,2503,19,83595
"West Burlington city, Iowa",1491,1469,22,3184,19,83685
"West Chester city, Iowa",88,73,15,171,19,83775
"West Des Moines city, Iowa",41383,40223,1160,68744,19,83910
"Westfield city, Iowa",72,69,3,134,19,84090
"Westgate city, Iowa",82,68,14,207,19,84180
"West Liberty city, Iowa",2146,2055,91,3821,19,84315
"West Okoboji city, Iowa",143,141,2,357,19,84450
"Weston CDP, Iowa",57,57,0,91,19,84495
"Westphalia city, Iowa",91,91,0,144,19,84540
"West Point city, Iowa",378,374,4,913,19,84585
"Westside city, Iowa",153,153,0,296,19,84630
"West Union city, Iowa",1158,1136,22,2468,19,84765
"Westwood city, Iowa",52,52,0,84,19,84835
"Wever CDP, Iowa",44,36,8,178,19,84855
"What Cheer city, Iowa",294,265,29,724,19,84900
"Wheatland city, Iowa",389,378,11,866,19,84945
"Whiting city, Iowa",382,371,11,894,19,85215
"Whittemore city, Iowa",305,305,0,537,19,85260
"Whitten city, Iowa",69,68,1,133,19,85305
"Willey city, Iowa",68,67,1,124,19,85710
"Williams city, Iowa",215,203,12,357,19,85800
"Williamsburg city, Iowa",2009,1901,108,3332,19,85845
"Williamson city, Iowa",58,54,4,139,19,85935
"Wilton city, Iowa",1709,1709,0,2939,19,86070
"Windsor Heights city, Iowa",2656,2602,54,5200,19,86250
"Winfield city, Iowa",481,457,24,1063,19,86385
"Winterset city, Iowa",2824,2792,32,5366,19,86520
"Winthrop city, Iowa",529,521,8,1035,19,86565
"Wiota city, Iowa",34,34,0,84,19,86610
"Woden city, Iowa",86,82,4,178,19,86700
"Woodbine city, Iowa",612,600,12,1286,19,86835
"Woodburn city, Iowa",60,60,0,150,19,86880
"Woodward city, Iowa",510,480,30,987,19,86970
"Woolstock city, Iowa",106,89,17,212,19,87015
"Worthington city, Iowa",212,209,3,400,19,87060
"Wyoming city, Iowa",297,268,29,540,19,87240
"Yale city, Iowa",143,143,0,316,19,87285
"Yarmouth CDP, Iowa",88,88,0,95,19,87330
"Yetter city, Iowa",4,4,0,16,19,87375
"Yorktown city, Iowa",14,11,3,35,19,87420
"Zearing city, Iowa",329,321,8,655,19,87555
"Zwingle city, Iowa",49,46,3,76,19,87690
"Abbyville city, Kansas",35,35,0,64,20,00100
"Abilene city, Kansas",3240,3136,104,6489,20,00125
"Ada CDP, Kansas",9,9,0,34,20,00225
"Admire city, Kansas",115,115,0,215,20,00325
"Agenda city, Kansas",30,30,0,59,20,00475
"Agra city, Kansas",104,100,4,193,20,00550
"Albert city, Kansas",70,49,21,111,20,00825
"Alden city, Kansas",58,49,9,127,20,00950
"Alexander city, Kansas",15,15,0,42,20,01050
"Allen city, Kansas",139,139,0,260,20,01275
"Alma city, Kansas",344,338,6,796,20,01350
"Almena city, Kansas",222,213,9,398,20,01425
"Altamont city, Kansas",592,589,3,1105,20,01550
"Alta Vista city, Kansas",216,181,35,458,20,01575
"Alton city, Kansas",48,37,11,121,20,01600
"Altoona city, Kansas",123,121,2,367,20,01625
"Americus city, Kansas",531,519,12,1028,20,01675
"Ames CDP, Kansas",0,0,0,0,20,01725
"Andale city, Kansas",568,548,20,1169,20,01775
"Andover city, Kansas",7009,6910,99,15460,20,01800
"Anthony city, Kansas",952,863,89,2290,20,01975
"Arcadia city, Kansas",99,92,7,302,20,02175
"Argonia city, Kansas",235,212,23,565,20,02250
"Arkansas City city, Kansas",5406,5046,360,11997,20,02300
"Arlington city, Kansas",235,225,10,475,20,02325
"Arma city, Kansas",619,588,31,1281,20,02375
"Asherville CDP, Kansas",0,0,0,0,20,02600
"Ashland city, Kansas",462,456,6,802,20,02675
"Assaria city, Kansas",240,236,4,408,20,02850
"Atchison city, Kansas",5227,4902,325,10834,20,02900
"Athol city, Kansas",5,5,0,32,20,03025
"Atlanta city, Kansas",49,49,0,108,20,03050
"Attica city, Kansas",248,246,2,631,20,03100
"Atwood city, Kansas",660,658,2,1238,20,03150
"Auburn city, Kansas",565,543,22,1210,20,03250
"Augusta city, Kansas",4590,4444,146,9253,20,03300
"Aurora city, Kansas",35,35,0,66,20,03425
"Axtell city, Kansas",185,176,9,492,20,03600
"Baileyville CDP, Kansas",11,11,0,122,20,03675
"Bala CDP, Kansas",0,0,0,0,20,03800
"Baldwin City city, Kansas",2289,2176,113,4845,20,03900
"Barnard city, Kansas",29,29,0,47,20,04225
"Barnes city, Kansas",72,72,0,150,20,04250
"Bartlett city, Kansas",32,31,1,69,20,04350
"Basehor city, Kansas",3441,3101,340,7004,20,04400
"Bassett city, Kansas",13,9,4,23,20,04450
"Bavaria CDP, Kansas",11,11,0,22,20,04575
"Baxter Springs city, Kansas",1880,1830,50,3901,20,04625
"Bazine city, Kansas",166,163,3,438,20,04775
"Beattie city, Kansas",134,134,0,262,20,04900
"Beaumont CDP, Kansas",21,0,21,40,20,04925
"Beaver CDP, Kansas",18,18,0,18,20,04950
"Bel Aire city, Kansas",4389,4286,103,8341,20,05337
"Belle Plaine city, Kansas",683,655,28,1445,20,05500
"Belleville city, Kansas",896,885,11,2096,20,05600
"Beloit city, Kansas",1335,1318,17,3083,20,05775
"Belpre city, Kansas",24,22,2,38,20,05825
"Belvue city, Kansas",96,93,3,187,20,05925
"Bendena CDP, Kansas",79,79,0,131,20,05975
"Benedict city, Kansas",35,35,0,70,20,06000
"Bennington city, Kansas",305,283,22,574,20,06075
"Bentley city, Kansas",229,196,33,452,20,06125
"Benton city, Kansas",537,526,11,909,20,06175
"Bern city, Kansas",90,90,0,137,20,06275
"Beverly city, Kansas",85,84,1,152,20,06500
"Big Bow CDP, Kansas",11,11,0,19,20,06575
"Bird City city, Kansas",283,272,11,525,20,06825
"Bison city, Kansas",113,90,23,173,20,06950
"Blue Mound city, Kansas",89,82,7,250,20,07600
"Blue Rapids city, Kansas",554,520,34,1076,20,07650
"Bluff City city, Kansas",24,22,2,43,20,07775
"Bogue city, Kansas",44,38,6,88,20,07825
"Bonner Springs city, Kansas",3806,3709,97,7770,20,07975
"Bremen CDP, Kansas",107,100,7,217,20,08300
"Brewster city, Kansas",191,190,1,413,20,08425
"Bridgeport CDP, Kansas",0,0,0,8,20,08450
"Bronson city, Kansas",284,268,16,539,20,08475
"Brookville city, Kansas",146,146,0,245,20,08575
"Brownell city, Kansas",1,1,0,17,20,08675
"Bucklin city, Kansas",364,362,2,684,20,09000
"Bucyrus CDP, Kansas",44,44,0,92,20,09050
"Buffalo city, Kansas",140,139,1,307,20,09150
"Buhler city, Kansas",613,603,10,1343,20,09200
"Bunker Hill city, Kansas",71,53,18,120,20,09225
"Burden city, Kansas",237,231,6,520,20,09250
"Burdett city, Kansas",171,162,9,360,20,09275
"Burdick CDP, Kansas",21,21,0,28,20,09300
"Burlingame city, Kansas",359,330,29,862,20,09350
"Burlington city, Kansas",1184,1114,70,2617,20,09400
"Burns city, Kansas",136,122,14,295,20,09450
"Burr Oak city, Kansas",44,44,0,120,20,09525
"Burrton city, Kansas",470,445,25,846,20,09575
"Bushong city, Kansas",20,19,1,33,20,09675
"Bushton city, Kansas",92,91,1,276,20,09700
"Byers city, Kansas",11,11,0,12,20,09800
"Caldwell city, Kansas",462,414,48,1007,20,09900
"Cambridge city, Kansas",34,34,0,68,20,10125
"Caney city, Kansas",578,546,32,1543,20,10375
"Canton city, Kansas",340,320,20,594,20,10475
"Carbondale city, Kansas",726,714,12,1396,20,10600
"Carlton city, Kansas",9,9,0,21,20,10675
"Cassoday city, Kansas",91,90,1,141,20,10925
"Catharine CDP, Kansas",89,89,0,215,20,11025
"Cawker City city, Kansas",200,200,0,425,20,11175
"Cedar city, Kansas",1,1,0,13,20,11325
"Cedar Point city, Kansas",1,1,0,2,20,11425
"Cedar Vale city, Kansas",271,245,26,593,20,11450
"Centerville CDP, Kansas",0,0,0,0,20,12325
"Centralia city, Kansas",195,186,9,441,20,12425
"Centropolis CDP, Kansas",46,46,0,92,20,12450
"Chanute city, Kansas",4003,3714,289,8713,20,12500
"Chapman city, Kansas",487,479,8,1140,20,12550
"Chase city, Kansas",267,261,6,487,20,12650
"Chautauqua city, Kansas",26,26,0,67,20,12675
"Cheney city, Kansas",1085,1058,27,2380,20,12775
"Cherokee city, Kansas",346,319,27,703,20,12825
"Cherryvale city, Kansas",961,911,50,2104,20,12925
"Chetopa city, Kansas",343,315,28,1022,20,12950
"Chicopee CDP, Kansas",231,231,0,388,20,13100
"Cimarron city, Kansas",1122,1095,27,1830,20,13275
"Circleville city, Kansas",70,67,3,146,20,13375
"Claflin city, Kansas",241,218,23,487,20,13425
"Clay Center city, Kansas",1724,1699,25,4154,20,13625
"Clayton city, Kansas",37,33,4,75,20,13675
"Clearwater city, Kansas",1163,1129,34,2544,20,13925
"Clifton city, Kansas",243,241,2,448,20,14200
"Climax city, Kansas",18,18,0,48,20,14275
"Clyde city, Kansas",337,330,7,889,20,14475
"Coats city, Kansas",55,55,0,152,20,14525
"Codell CDP, Kansas",50,50,0,50,20,14575
"Coffeyville city, Kansas",3635,3380,255,8842,20,14600
"Colby city, Kansas",2769,2759,10,5403,20,14650
"Coldwater city, Kansas",333,308,25,693,20,14700
"Collyer city, Kansas",41,40,1,80,20,14900
"Colony city, Kansas",187,182,5,358,20,14950
"Columbus city, Kansas",1189,1172,17,2922,20,15075
"Colwich city, Kansas",859,787,72,1513,20,15100
"Concordia city, Kansas",2456,2284,172,5080,20,15200
"Conway Springs city, Kansas",737,724,13,1560,20,15325
"Coolidge city, Kansas",44,44,0,88,20,15400
"Copeland city, Kansas",189,183,6,452,20,15475
"Corning city, Kansas",94,89,5,163,20,15725
"Cottonwood Falls city, Kansas",439,428,11,888,20,15900
"Council Grove city, Kansas",1167,1124,43,2452,20,15925
"Courtland city, Kansas",120,118,2,206,20,16025
"Coyville city, Kansas",14,14,0,50,20,16150
"Crestline CDP, Kansas",14,14,0,60,20,16325
"Croweburg CDP, Kansas",86,86,0,95,20,16475
"Cuba city, Kansas",148,147,1,290,20,16625
"Cullison city, Kansas",32,32,0,90,20,16675
"Culver city, Kansas",26,21,5,72,20,16700
"Cunningham city, Kansas",185,183,2,436,20,16775
"Damar city, Kansas",84,79,5,176,20,16975
"Danville city, Kansas",6,6,0,24,20,17000
"Dearing city, Kansas",187,166,21,371,20,17150
"Deerfield city, Kansas",360,360,0,736,20,17225
"Delia city, Kansas",137,137,0,221,20,17525
"Delphos city, Kansas",154,154,0,342,20,17600
"Denison city, Kansas",71,71,0,145,20,17625
"Dennis CDP, Kansas",79,79,0,168,20,17675
"Denton city, Kansas",88,88,0,140,20,17750
"Derby city, Kansas",12384,11888,496,25551,20,17800
"De Soto city, Kansas",3313,3065,248,6248,20,17850
"Detroit CDP, Kansas",65,65,0,139,20,17875
"Devon CDP, Kansas",46,46,0,46,20,17900
"Dexter city, Kansas",189,187,2,494,20,17925
"Dighton city, Kansas",364,364,0,703,20,18050
"Dodge City city, Kansas",14386,13864,522,27721,20,18250
"Dorrance city, Kansas",102,102,0,205,20,18325
"Douglass city, Kansas",734,703,31,1587,20,18400
"Downs city, Kansas",314,314,0,605,20,18500
"Dresden city, Kansas",15,15,0,46,20,18600
"Dunlap city, Kansas",35,29,6,45,20,18950
"Durham city, Kansas",22,22,0,55,20,19050
"Dwight city, Kansas",140,140,0,268,20,19125
"Earlton city, Kansas",46,46,0,124,20,19275
"Eastborough city, Kansas",371,366,5,712,20,19300
"Easton city, Kansas",82,76,6,259,20,19600
"Eastshore CDP, Kansas",0,0,0,17,20,19700
"Edgerton city, Kansas",1078,1061,17,1894,20,19825
"Edmond city, Kansas",74,70,4,112,20,19875
"Edna city, Kansas",189,182,7,350,20,19900
"Edson CDP, Kansas",0,0,0,9,20,19925
"Edwardsville city, Kansas",2592,2559,33,4744,20,20000
"Effingham city, Kansas",339,336,3,609,20,20025
"Elbing city, Kansas",144,134,10,271,20,20050
"El Dorado city, Kansas",6616,6389,227,12882,20,20075
"Elgin city, Kansas",17,10,7,49,20,20125
"Elk City city, Kansas",92,85,7,289,20,20250
"Elk Falls city, Kansas",39,39,0,93,20,20300
"Elkhart city, Kansas",639,607,32,1542,20,20350
"Ellinwood city, Kansas",1048,1012,36,2225,20,20425
"Ellis city, Kansas",1071,1034,37,2117,20,20450
"Ellsworth city, Kansas",1086,1064,22,3081,20,20500
"Elmdale city, Kansas",17,17,0,50,20,20675
"Elsmore city, Kansas",24,24,0,59,20,20875
"Elwood city, Kansas",508,505,3,1109,20,20950
"Elyria CDP, Kansas",261,261,0,261,20,20975
"Emmett city, Kansas",76,74,2,182,20,21100
"Emporia city, Kansas",13241,12823,418,24118,20,21275
"Englewood city, Kansas",18,18,0,85,20,21350
"Ensign city, Kansas",99,90,9,140,20,21400
"Enterprise city, Kansas",461,447,14,780,20,21425
"Erie city, Kansas",559,538,21,1396,20,21500
"Esbon city, Kansas",25,25,0,60,20,21600
"Eskridge city, Kansas",191,169,22,477,20,21650
"Eudora city, Kansas",3574,3491,83,6025,20,21675
"Eureka city, Kansas",1060,1011,49,2239,20,21800
"Everest city, Kansas",169,138,31,359,20,22025
"Fairview city, Kansas",221,221,0,334,20,22425
"Fairway city, Kansas",2297,2281,16,4162,20,22700
"Fall River city, Kansas",72,72,0,178,20,22775
"Falun CDP, Kansas",54,54,0,142,20,22900
"Farlington CDP, Kansas",40,40,0,64,20,23050
"Florence city, Kansas",216,212,4,509,20,23600
"Fontana city, Kansas",158,143,15,428,20,23650
"Ford city, Kansas",125,122,3,205,20,23725
"Formoso city, Kansas",23,23,0,93,20,23825
"Fort Dodge CDP, Kansas",16,16,0,149,20,23890
"Fort Riley CDP, Kansas",941,758,183,8623,20,23975
"Fort Scott city, Kansas",3366,3214,152,7569,20,24000
"Fowler city, Kansas",234,222,12,479,20,24175
"Frankfort city, Kansas",378,371,7,692,20,24275
"Franklin CDP, Kansas",419,383,36,774,20,24325
"Frederick city, Kansas",5,5,0,38,20,24550
"Fredonia city, Kansas",891,887,4,2121,20,24575
"Frontenac city, Kansas",1708,1680,28,3384,20,24850
"Fulton city, Kansas",33,33,0,95,20,24925
"Furley CDP, Kansas",50,42,8,50,20,24975
"Galatia city, Kansas",14,13,1,20,20,25050
"Galena city, Kansas",1234,1234,0,2764,20,25100
"Galesburg city, Kansas",21,21,0,83,20,25150
"Galva city, Kansas",603,597,6,1072,20,25200
"Garden City city, Kansas",14684,13993,691,27933,20,25325
"Garden Plain city, Kansas",536,510,26,1059,20,25375
"Gardner city, Kansas",13229,12660,569,23488,20,25425
"Garfield city, Kansas",80,78,2,144,20,25750
"Garland CDP, Kansas",4,4,0,11,20,25900
"Garnett city, Kansas",1326,1249,77,3219,20,25925
"Gas city, Kansas",292,284,8,532,20,25975
"Gaylord city, Kansas",35,35,0,84,20,26000
"Gem city, Kansas",60,52,8,113,20,26050
"Geneseo city, Kansas",86,81,5,214,20,26075
"Geuda Springs city, Kansas",110,103,7,202,20,26200
"Girard city, Kansas",1247,1199,48,2639,20,26300
"Glade city, Kansas",34,32,2,64,20,26325
"Glasco city, Kansas",136,128,8,342,20,26375
"Glen Elder city, Kansas",321,321,0,573,20,26500
"Goddard city, Kansas",2628,2533,95,5119,20,26725
"Goessel city, Kansas",252,247,5,545,20,26750
"Goff city, Kansas",20,20,0,64,20,26775
"Goodland city, Kansas",2091,2019,72,3813,20,26875
"Gorham city, Kansas",187,185,2,357,20,27000
"Gove City city, Kansas",65,62,3,88,20,27125
"Grainfield city, Kansas",143,127,16,250,20,27200
"Grandview Plaza city, Kansas",773,723,50,1791,20,27425
"Grantville CDP, Kansas",119,99,20,220,20,28200
"Great Bend city, Kansas",7548,7189,359,14725,20,28300
"Greeley city, Kansas",150,142,8,281,20,28350
"Greeley County unified government (balance), Kansas",188,188,0,356,20,28412
"Green city, Kansas",57,57,0,105,20,28425
"Greenleaf city, Kansas",148,148,0,313,20,28625
"Greensburg city, Kansas",313,302,11,629,20,28675
"Greenwich CDP, Kansas",41,41,0,88,20,28700
"Grenola city, Kansas",74,74,0,185,20,28800
"Gridley city, Kansas",217,215,2,432,20,28850
"Grinnell city, Kansas",140,139,1,320,20,28900
"Gypsum city, Kansas",173,168,5,336,20,29250
"Haddam city, Kansas",54,54,0,123,20,29400
"Hallowell CDP, Kansas",35,25,10,56,20,29550
"Halstead city, Kansas",1014,1010,4,2243,20,29600
"Hamilton city, Kansas",91,85,6,232,20,29675
"Hamlin city, Kansas",7,7,0,14,20,29700
"Hanover city, Kansas",319,307,12,692,20,29875
"Hanston city, Kansas",137,124,13,321,20,29925
"Hardtner city, Kansas",83,72,11,235,20,30000
"Harper city, Kansas",516,497,19,1134,20,30175
"Harris CDP, Kansas",11,11,0,11,20,30250
"Hartford city, Kansas",215,211,4,457,20,30475
"Harveyville city, Kansas",85,80,5,146,20,30575
"Havana city, Kansas",29,20,9,77,20,30700
"Haven city, Kansas",822,802,20,1421,20,30725
"Havensville city, Kansas",88,88,0,190,20,30775
"Haviland city, Kansas",384,354,30,711,20,30825
"Hays city, Kansas",12684,12239,445,21111,20,31100
"Haysville city, Kansas",5291,5017,274,10891,20,31125
"Hazelton city, Kansas",34,34,0,93,20,31150
"Healy CDP, Kansas",191,188,3,367,20,31200
"Hepler city, Kansas",50,46,4,111,20,31375
"Herington city, Kansas",996,990,6,2074,20,31400
"Herkimer CDP, Kansas",0,0,0,0,20,31425
"Herndon city, Kansas",63,63,0,117,20,31475
"Hesston city, Kansas",1553,1486,67,3703,20,31600
"Hiawatha city, Kansas",1772,1693,79,3246,20,31675
"Highland city, Kansas",386,367,19,1106,20,31850
"Hill City city, Kansas",879,809,70,1593,20,32175
"Hillsboro city, Kansas",1315,1283,32,2744,20,32275
"Hillsdale CDP, Kansas",87,87,0,190,20,32300
"Hoisington city, Kansas",1230,1178,52,2675,20,32550
"Holcomb city, Kansas",1168,1154,14,2395,20,32575
"Hollenberg city, Kansas",9,9,0,19,20,32650
"Holton city, Kansas",1751,1702,49,3386,20,32825
"Holyrood city, Kansas",224,216,8,416,20,32850
"Home CDP, Kansas",45,45,0,55,20,32875
"Hope city, Kansas",149,140,9,417,20,33075
"Horace city, Kansas",34,33,1,71,20,33150
"Horton city, Kansas",675,649,26,1704,20,33200
"Howard city, Kansas",224,219,5,546,20,33250
"Hoxie city, Kansas",680,680,0,1287,20,33350
"Hoyt city, Kansas",418,389,29,666,20,33375
"Hudson city, Kansas",64,55,9,100,20,33400
"Hugoton city, Kansas",1857,1826,31,4134,20,33425
"Humboldt city, Kansas",941,761,180,1941,20,33450
"Hunnewell city, Kansas",30,30,0,86,20,33500
"Hunter city, Kansas",21,21,0,108,20,33525
"Huron city, Kansas",18,16,2,30,20,33575
"Hutchinson city, Kansas",20031,19115,916,39995,20,33625
"Idana CDP, Kansas",25,25,0,34,20,33700
"Independence city, Kansas",4183,4065,118,8556,20,33875
"Ingalls city, Kansas",139,139,0,280,20,34225
"Inman city, Kansas",607,588,19,1417,20,34275
"Iola city, Kansas",2479,2314,165,5395,20,34300
"Ionia CDP, Kansas",0,0,0,0,20,34350
"Isabel city, Kansas",65,63,2,115,20,34550
"Iuka city, Kansas",71,59,12,198,20,34625
"Jamestown city, Kansas",141,136,5,221,20,34975
"Jennings city, Kansas",40,39,1,91,20,35375
"Jetmore city, Kansas",362,357,5,708,20,35450
"Jewell city, Kansas",205,188,17,411,20,35475
"Johnson City city, Kansas",766,740,26,1318,20,35600
"Junction City city, Kansas",10328,9874,454,22738,20,35750
"Kanopolis city, Kansas",300,286,14,592,20,35950
"Kanorado city, Kansas",130,130,0,261,20,35975
"Kansas City city, Kansas",76954,72311,4643,155438,20,36000
"Keats CDP, Kansas",82,82,0,280,20,36200
"Kechi city, Kansas",1509,1490,19,2949,20,36225
"Kelly CDP, Kansas",1,1,0,1,20,36375
"Kensington city, Kansas",230,227,3,534,20,36550
"Kickapoo Site 1 CDP, Kansas",30,26,4,95,20,36735
"Kickapoo Site 2 CDP, Kansas",14,14,0,22,20,36736
"Kickapoo Site 5 CDP, Kansas",32,15,17,136,20,36739
"Kickapoo Site 6 CDP, Kansas",0,0,0,0,20,36740
"Kickapoo Site 7 CDP, Kansas",22,17,5,62,20,36741
"Kickapoo Tribal Center CDP, Kansas",51,48,3,130,20,36744
"Kincaid city, Kansas",32,31,1,80,20,36875
"Kingman city, Kansas",1400,1275,125,3051,20,36950
"Kinsley city, Kansas",634,602,32,1371,20,37075
"Kiowa city, Kansas",429,415,14,785,20,37125
"Kipp CDP, Kansas",88,88,0,88,20,37200
"Kirwin city, Kansas",45,45,0,104,20,37275
"Kismet city, Kansas",292,283,9,475,20,37325
"Labette city, Kansas",9,9,0,22,20,37375
"La Crosse city, Kansas",658,656,2,1162,20,37500
"La Cygne city, Kansas",617,579,38,1427,20,37575
"Lafontaine CDP, Kansas",24,24,0,28,20,37675
"La Harpe city, Kansas",300,290,10,555,20,37725
"Lake City CDP, Kansas",0,0,0,0,20,37875
"Lake Quivira city, Kansas",405,405,0,994,20,37975
"Lakin city, Kansas",828,789,39,2066,20,38175
"Lancaster city, Kansas",208,200,8,379,20,38325
"Lane city, Kansas",93,84,9,227,20,38400
"Langdon city, Kansas",20,20,0,30,20,38500
"Lansing city, Kansas",4687,4520,167,11254,20,38650
"Larned city, Kansas",1502,1468,34,3167,20,38700
"Latham city, Kansas",113,31,82,204,20,38775
"Latimer city, Kansas",9,8,1,10,20,38800
"Lawrence city, Kansas",57863,54856,3007,95103,20,38900
"Leavenworth city, Kansas",14187,13530,657,37193,20,39000
"Leawood city, Kansas",17057,16803,254,33784,20,39075
"Lebanon city, Kansas",85,85,0,174,20,39100
"Lebo city, Kansas",366,358,8,834,20,39125
"Lecompton city, Kansas",494,468,26,864,20,39150
"Lehigh city, Kansas",98,98,0,196,20,39225
"Lenexa city, Kansas",34247,33354,893,57497,20,39350
"Lenora city, Kansas",78,75,3,205,20,39400
"Leon city, Kansas",211,194,17,454,20,39450
"Leona city, Kansas",13,13,0,49,20,39475
"Leonardville city, Kansas",246,240,6,602,20,39500
"Leoti city, Kansas",701,686,15,1536,20,39550
"LeRoy city, Kansas",255,239,16,532,20,39650
"Levant CDP, Kansas",62,62,0,90,20,39700
"Lewis city, Kansas",242,223,19,439,20,39725
"Liberal city, Kansas",9577,9315,262,19099,20,39825
"Liberty city, Kansas",67,66,1,132,20,40250
"Liebenthal city, Kansas",52,50,2,103,20,40400
"Lincoln Center city, Kansas",496,492,4,1063,20,41300
"Lincolnville city, Kansas",97,89,8,186,20,41325
"Lindsborg city, Kansas",1927,1889,38,3762,20,41375
"Linn city, Kansas",216,212,4,435,20,41425
"Linn Valley city, Kansas",501,472,29,938,20,41465
"Linwood city, Kansas",209,198,11,361,20,41475
"Little River city, Kansas",205,205,0,400,20,41575
"Logan city, Kansas",360,348,12,740,20,42100
"Lone Elm city, Kansas",26,8,18,35,20,42425
"Longford city, Kansas",24,22,2,53,20,42575
"Long Island city, Kansas",61,59,2,134,20,42600
"Longton city, Kansas",140,133,7,330,20,42650
"Lorraine city, Kansas",88,80,8,177,20,42800
"Lost Springs city, Kansas",37,37,0,78,20,42825
"Louisburg city, Kansas",2611,2535,76,4940,20,42875
"Louisville city, Kansas",75,70,5,196,20,42925
"Lowell CDP, Kansas",200,189,11,319,20,43050
"Lucas city, Kansas",228,226,2,448,20,43150
"Ludell CDP, Kansas",14,14,0,15,20,43175
"Luray city, Kansas",88,83,5,185,20,43250
"Lyndon city, Kansas",638,638,0,1276,20,43350
"Lyons city, Kansas",1765,1649,116,3596,20,43525
"McConnell AFB CDP, Kansas",264,248,16,2032,20,43675
"McCracken city, Kansas",46,46,0,101,20,43700
"McCune city, Kansas",149,145,4,297,20,43725
"McDonald city, Kansas",126,125,1,192,20,43750
"McFarland city, Kansas",215,213,2,363,20,43775
"Macksville city, Kansas",270,258,12,506,20,43850
"McLouth city, Kansas",486,478,8,1023,20,43900
"McPherson city, Kansas",7775,7560,215,13955,20,43950
"Madison city, Kansas",461,451,10,917,20,44050
"Mahaska city, Kansas",25,25,0,49,20,44150
"Maize city, Kansas",2913,2773,140,6071,20,44200
"Manchester city, Kansas",38,37,1,68,20,44225
"Manhattan city, Kansas",31375,29958,1417,54287,20,44250
"Mankato city, Kansas",372,372,0,824,20,44300
"Manter city, Kansas",72,70,2,190,20,44375
"Maple Hill city, Kansas",271,261,10,572,20,44500
"Mapleton city, Kansas",139,137,2,240,20,44550
"Marienthal CDP, Kansas",31,31,0,43,20,44600
"Marion city, Kansas",840,840,0,1837,20,44750
"Marquette city, Kansas",374,362,12,703,20,44925
"Marysville city, Kansas",1656,1605,51,3414,20,45050
"Matfield Green city, Kansas",22,22,0,56,20,45150
"Mayetta city, Kansas",229,199,30,432,20,45250
"Mayfield city, Kansas",43,39,4,80,20,45275
"Meade city, Kansas",752,752,0,1348,20,45325
"Medicine Lodge city, Kansas",660,641,19,1377,20,45500
"Melvern city, Kansas",150,144,6,322,20,45700
"Menlo city, Kansas",21,21,0,37,20,45750
"Mentor CDP, Kansas",52,52,0,131,20,45875
"Meriden city, Kansas",382,357,25,719,20,45950
"Merriam city, Kansas",6500,6099,401,11070,20,46000
"Milan city, Kansas",46,44,2,94,20,46450
"Mildred CDP, Kansas",8,6,2,12,20,46500
"Milford city, Kansas",137,128,9,316,20,46525
"Milton CDP, Kansas",105,105,0,145,20,46925
"Miltonvale city, Kansas",159,148,11,380,20,46950
"Minneapolis city, Kansas",1049,1002,47,2065,20,47075
"Minneola city, Kansas",305,301,4,695,20,47150
"Mission city, Kansas",6519,6265,254,9894,20,47225
"Mission Hills city, Kansas",1828,1819,9,3567,20,47350
"Mission Woods city, Kansas",86,81,5,155,20,47425
"Moline city, Kansas",139,115,24,334,20,47600
"Montezuma city, Kansas",439,420,19,855,20,47875
"Mont Ida CDP, Kansas",28,28,0,28,20,47975
"Monument CDP, Kansas",34,34,0,78,20,48025
"Moran city, Kansas",216,198,18,485,20,48125
"Morganville city, Kansas",92,92,0,200,20,48225
"Morland city, Kansas",87,87,0,139,20,48275
"Morrill city, Kansas",75,74,1,131,20,48300
"Morrowville city, Kansas",99,88,11,145,20,48450
"Moscow city, Kansas",96,96,0,192,20,48600
"Mound City city, Kansas",341,341,0,729,20,48750
"Moundridge city, Kansas",772,755,17,1854,20,48800
"Mound Valley city, Kansas",150,139,11,338,20,48825
"Mount Hope city, Kansas",412,398,14,818,20,48900
"Mulberry city, Kansas",146,139,7,432,20,49025
"Mullinville city, Kansas",167,165,2,231,20,49075
"Mulvane city, Kansas",3045,2818,227,6003,20,49100
"Munden city, Kansas",78,78,0,133,20,49150
"Munjor CDP, Kansas",57,53,4,90,20,49200
"Murdock CDP, Kansas",16,16,0,52,20,49250
"Muscotah city, Kansas",64,60,4,133,20,49325
"Narka city, Kansas",41,41,0,86,20,49350
"Nashville city, Kansas",29,29,0,37,20,49400
"Natoma city, Kansas",168,165,3,400,20,49425
"Navarre CDP, Kansas",44,44,0,137,20,49525
"Neal CDP, Kansas",3,3,0,34,20,49550
"Neodesha city, Kansas",1020,977,43,2236,20,49650
"Neosho Falls city, Kansas",47,46,1,150,20,49825
"Neosho Rapids city, Kansas",170,165,5,383,20,49875
"Ness City city, Kansas",691,688,3,1243,20,49925
"Netawaka city, Kansas",93,93,0,155,20,49950
"New Albany city, Kansas",26,26,0,56,20,50150
"Newbury CDP, Kansas",22,22,0,41,20,50250
"New Cambria city, Kansas",93,91,2,122,20,50300
"New Salem CDP, Kansas",0,0,0,22,20,50425
"New Strawn city, Kansas",233,225,8,425,20,50450
"Newton city, Kansas",10190,9645,545,18527,20,50475
"Nickerson city, Kansas",498,476,22,900,20,50525
"Nicodemus CDP, Kansas",0,0,0,0,20,50550
"Niles CDP, Kansas",31,31,0,97,20,50600
"Niotaze city, Kansas",53,44,9,139,20,50750
"Norcatur city, Kansas",119,117,2,255,20,50925
"North Newton city, Kansas",1065,982,83,2105,20,51225
"Norton city, Kansas",1288,1288,0,2729,20,51500
"Nortonville city, Kansas",343,340,3,794,20,51525
"Norway CDP, Kansas",9,9,0,9,20,51550
"Norwich city, Kansas",256,244,12,463,20,51600
"Oak Hill city, Kansas",9,8,1,16,20,51700
"Oaklawn-Sunview CDP, Kansas",1161,1115,46,2984,20,51810
"Oakley city, Kansas",1066,1063,3,2063,20,51825
"Oberlin city, Kansas",750,709,41,1629,20,52000
"Odin CDP, Kansas",68,68,0,131,20,52175
"Offerle city, Kansas",107,105,2,223,20,52200
"Ogallah CDP, Kansas",12,12,0,12,20,52225
"Ogden city, Kansas",628,561,67,1529,20,52275
"Oketo city, Kansas",92,91,1,119,20,52525
"Olathe city, Kansas",79754,77187,2567,142114,20,52575
"Olivet city, Kansas",22,22,0,72,20,52700
"Olmitz city, Kansas",48,48,0,90,20,52750
"Olpe city, Kansas",260,256,4,482,20,52800
"Olsburg city, Kansas",107,106,1,222,20,52825
"Onaga city, Kansas",228,221,7,618,20,52875
"Oneida city, Kansas",199,191,8,295,20,52900
"Opolis CDP, Kansas",11,11,0,11,20,52925
"Osage City city, Kansas",1292,1178,114,2854,20,53200
"Osawatomie city, Kansas",2132,2037,95,4256,20,53225
"Osborne city, Kansas",848,830,18,1512,20,53325
"Oskaloosa city, Kansas",583,535,48,1138,20,53375
"Oswego city, Kansas",771,692,79,1791,20,53450
"Otis city, Kansas",147,138,9,375,20,53525
"Ottawa city, Kansas",6533,6405,128,12615,20,53550
"Overbrook city, Kansas",389,389,0,967,20,53725
"Overland Park city, Kansas",114036,110350,3686,196676,20,53775
"Oxford city, Kansas",307,307,0,873,20,53850
"Ozawkie city, Kansas",315,312,3,666,20,53925
"Palco city, Kansas",67,64,3,161,20,54125
"Palmer city, Kansas",66,66,0,155,20,54200
"Paola city, Kansas",3035,2979,56,5742,20,54250
"Paradise city, Kansas",29,29,0,36,20,54325
"Park city, Kansas",65,65,0,94,20,54400
"Park City city, Kansas",4206,4058,148,7703,20,54450
"Parker city, Kansas",175,162,13,362,20,54500
"Parkerfield city, Kansas",221,216,5,564,20,54560
"Parkerville city, Kansas",7,7,0,84,20,54575
"Parsons city, Kansas",4453,4381,72,9564,20,54675
"Partridge city, Kansas",92,87,5,176,20,54700
"Pawnee Rock city, Kansas",134,134,0,290,20,54875
"Paxico city, Kansas",147,142,5,240,20,54950
"Peabody city, Kansas",541,475,66,1259,20,55100
"Peck CDP, Kansas",67,67,0,82,20,55175
"Penalosa city, Kansas",0,0,0,3,20,55225
"Perry city, Kansas",655,640,15,1169,20,55450
"Peru city, Kansas",59,50,9,162,20,55525
"Phillipsburg city, Kansas",1067,1033,34,2204,20,55675
"Piedmont CDP, Kansas",31,31,0,80,20,55750
"Pierceville CDP, Kansas",0,0,0,0,20,55775
"Pilsen CDP, Kansas",34,32,2,62,20,55875
"Piqua CDP, Kansas",33,33,0,64,20,56000
"Pittsburg city, Kansas",10844,10408,436,20610,20,56025
"Plains city, Kansas",612,601,11,1266,20,56100
"Plainville city, Kansas",1070,1058,12,1889,20,56150
"Pleasanton city, Kansas",866,809,57,1724,20,56450
"Plevna city, Kansas",44,43,1,114,20,56725
"Pomona city, Kansas",580,551,29,1164,20,57000
"Portis city, Kansas",57,57,0,114,20,57100
"Potwin city, Kansas",218,202,16,571,20,57300
"Powhattan city, Kansas",26,24,2,81,20,57350
"Prairie View city, Kansas",103,94,9,146,20,57525
"Prairie Village city, Kansas",12820,12360,460,22922,20,57575
"Pratt city, Kansas",3417,3299,118,6588,20,57625
"Prescott city, Kansas",84,77,7,223,20,57650
"Preston city, Kansas",71,66,5,169,20,57675
"Pretty Prairie city, Kansas",294,291,3,638,20,57700
"Princeton city, Kansas",113,112,1,208,20,57725
"Protection city, Kansas",288,286,2,529,20,57850
"Quenemo city, Kansas",127,127,0,362,20,58100
"Quinter city, Kansas",413,404,9,902,20,58250
"Radium city, Kansas",5,5,0,13,20,58300
"Radley CDP, Kansas",60,60,0,112,20,58325
"Ramona city, Kansas",51,50,1,93,20,58375
"Randall city, Kansas",87,84,3,219,20,58450
"Randolph city, Kansas",102,99,3,182,20,58475
"Ransom city, Kansas",130,130,0,265,20,58500
"Rantoul city, Kansas",52,52,0,108,20,58525
"Raymond city, Kansas",43,41,2,109,20,58550
"Reading city, Kansas",86,82,4,157,20,58600
"Redfield city, Kansas",36,36,0,92,20,58725
"Republic city, Kansas",45,45,0,125,20,59000
"Reserve city, Kansas",31,31,0,58,20,59050
"Rexford city, Kansas",95,89,6,156,20,59125
"Richfield city, Kansas",14,14,0,19,20,59200
"Richmond city, Kansas",274,272,2,514,20,59675
"Riley city, Kansas",494,487,7,875,20,59875
"Ringo CDP, Kansas",40,40,0,64,20,59975
"Riverton CDP, Kansas",281,281,0,729,20,60200
"Robinson city, Kansas",64,60,4,189,20,60325
"Rock CDP, Kansas",37,37,0,97,20,60400
"Roeland Park city, Kansas",4108,3959,149,6848,20,60825
"Rolla city, Kansas",389,381,8,711,20,60900
"Rosalia CDP, Kansas",63,63,0,152,20,61100
"Rose Hill city, Kansas",2165,2077,88,4357,20,61250
"Roseland city, Kansas",29,29,0,39,20,61275
"Rossville city, Kansas",527,494,33,1083,20,61400
"Roxbury CDP, Kansas",0,0,0,7,20,61550
"Rozel city, Kansas",72,72,0,126,20,61600
"Rush Center city, Kansas",129,129,0,223,20,61775
"Russell city, Kansas",2064,1997,67,4238,20,61825
"Russell Springs city, Kansas",13,13,0,28,20,61875
"Sabetha city, Kansas",1133,1133,0,2349,20,62025
"St. Benedict CDP, Kansas",32,32,0,32,20,62075
"St. Francis city, Kansas",542,534,8,1230,20,62175
"St. George city, Kansas",633,633,0,1190,20,62200
"St. John city, Kansas",616,596,20,1238,20,62275
"St. Marks CDP, Kansas",18,18,0,107,20,62375
"St. Marys city, Kansas",1261,1222,39,2661,20,62400
"St. Paul city, Kansas",249,230,19,604,20,62500
"Salina city, Kansas",24742,23761,981,46734,20,62700
"Satanta city, Kansas",485,459,26,872,20,63150
"Savonburg city, Kansas",47,44,3,104,20,63200
"Sawyer city, Kansas",39,37,2,114,20,63275
"Scammon city, Kansas",193,185,8,374,20,63325
"Scandia city, Kansas",181,181,0,345,20,63350
"Schoenchen city, Kansas",141,129,12,211,20,63425
"Scott City city, Kansas",2145,2080,65,4121,20,63600
"Scottsville city, Kansas",19,19,0,24,20,63650
"Scranton city, Kansas",366,347,19,868,20,63675
"Sedan city, Kansas",402,395,7,991,20,63750
"Sedgwick city, Kansas",688,681,7,1465,20,63800
"Selden city, Kansas",183,178,5,297,20,63875
"Seneca city, Kansas",1015,1003,12,2045,20,63950
"Severance city, Kansas",32,32,0,50,20,64025
"Severy city, Kansas",117,117,0,212,20,64050
"Seward city, Kansas",58,57,1,108,20,64100
"Shallow Water CDP, Kansas",34,34,0,56,20,64200
"Sharon city, Kansas",67,67,0,110,20,64325
"Sharon Springs city, Kansas",368,355,13,869,20,64375
"Shawnee city, Kansas",38315,37087,1228,67671,20,64500
"Silverdale CDP, Kansas",0,0,0,35,20,65550
"Silver Lake city, Kansas",657,641,16,1446,20,65600
"Simpson city, Kansas",62,61,1,80,20,65650
"Smith Center city, Kansas",771,751,20,1539,20,65925
"Smolan city, Kansas",100,93,7,165,20,66100
"Soldier city, Kansas",20,20,0,51,20,66175
"Solomon city, Kansas",457,445,12,1079,20,66275
"Somerset CDP, Kansas",30,30,0,51,20,66475
"South Haven city, Kansas",183,178,5,340,20,66650
"South Hutchinson city, Kansas",1415,1356,59,2820,20,66750
"South Mound CDP, Kansas",28,28,0,28,20,66800
"Spearville city, Kansas",541,533,8,1008,20,67125
"Speed city, Kansas",19,19,0,22,20,67175
"Spivey city, Kansas",26,26,0,132,20,67250
"Spring Hill city, Kansas",4616,4509,107,8279,20,67625
"Stafford city, Kansas",307,304,3,726,20,67775
"Stark city, Kansas",39,39,0,70,20,68025
"Sterling city, Kansas",1137,1114,23,2507,20,68200
"Stockton city, Kansas",687,671,16,1567,20,68350
"Strong City city, Kansas",255,252,3,465,20,68650
"Stuttgart CDP, Kansas",24,24,0,55,20,68750
"Sublette city, Kansas",675,675,0,1385,20,68775
"Summerfield city, Kansas",71,71,0,147,20,68950
"Sun City city, Kansas",21,21,0,52,20,69275
"Susank city, Kansas",14,12,2,36,20,69525
"Sycamore CDP, Kansas",87,87,0,123,20,69725
"Sylvan Grove city, Kansas",173,161,12,317,20,69775
"Sylvia city, Kansas",77,73,4,169,20,69800
"Syracuse city, Kansas",647,647,0,1511,20,69850
"Talmage CDP, Kansas",29,29,0,96,20,69925
"Tampa city, Kansas",52,52,0,131,20,70000
"Tecumseh CDP, Kansas",158,158,0,322,20,70075
"Tescott city, Kansas",140,138,2,293,20,70250
"Thayer city, Kansas",162,161,1,442,20,70300
"The Highlands city, Kansas",266,243,23,516,20,70357
"Timken city, Kansas",19,15,4,40,20,70625
"Tipton city, Kansas",138,138,0,190,20,70675
"Tonganoxie city, Kansas",2746,2609,137,5484,20,70800
"Topeka city, Kansas",62453,59335,3118,126431,20,71000
"Toronto city, Kansas",82,81,1,204,20,71050
"Towanda city, Kansas",771,749,22,1673,20,71125
"Tribune city, Kansas",490,490,0,852,20,71450
"Troy city, Kansas",394,369,25,825,20,71575
"Turon city, Kansas",131,130,1,266,20,71800
"Tyro city, Kansas",76,76,0,203,20,71925
"Udall city, Kansas",290,284,6,656,20,71950
"Ulysses city, Kansas",2889,2759,130,5834,20,71975
"Uniontown city, Kansas",111,107,4,356,20,72525
"Urbana CDP, Kansas",0,0,0,20,20,72600
"Utica city, Kansas",65,65,0,113,20,72650
"Valley Center city, Kansas",3705,3397,308,8448,20,73250
"Valley Falls city, Kansas",576,560,16,1192,20,73300
"Vassar CDP, Kansas",464,441,23,882,20,73450
"Vermillion city, Kansas",31,31,0,64,20,73525
"Victoria city, Kansas",647,636,11,1027,20,73775
"Vining city, Kansas",24,24,0,61,20,73950
"Viola city, Kansas",106,104,2,203,20,74025
"Virgil city, Kansas",18,18,0,33,20,74075
"Wabaunsee CDP, Kansas",46,46,0,46,20,74225
"Wakarusa CDP, Kansas",80,64,16,243,20,74425
"WaKeeney city, Kansas",1052,1021,31,1801,20,74450
"Wakefield city, Kansas",498,473,25,995,20,74525
"Waldo city, Kansas",14,5,9,51,20,74575
"Waldron city, Kansas",4,4,0,9,20,74625
"Wallace city, Kansas",33,33,0,50,20,74750
"Walnut city, Kansas",120,113,7,201,20,74950
"Walton city, Kansas",166,162,4,289,20,75200
"Wamego city, Kansas",2520,2418,102,4190,20,75325
"Washington city, Kansas",466,458,8,1017,20,75825
"Waterville city, Kansas",391,389,2,735,20,75950
"Wathena city, Kansas",835,835,0,1499,20,76000
"Waverly city, Kansas",244,230,14,526,20,76050
"Wayside CDP, Kansas",0,0,0,0,20,76175
"Webber city, Kansas",12,12,0,27,20,76250
"Weir city, Kansas",211,196,15,804,20,76350
"Welda CDP, Kansas",81,81,0,163,20,76425
"Wellington city, Kansas",3361,3187,174,7710,20,76475
"Wells CDP, Kansas",0,0,0,0,20,76550
"Wellsville city, Kansas",942,926,16,2022,20,76625
"Weskan CDP, Kansas",78,78,0,123,20,76675
"West Mineral city, Kansas",53,51,2,164,20,77150
"Westmoreland city, Kansas",277,268,9,641,20,77200
"Westphalia city, Kansas",82,81,1,171,20,77250
"Westwood city, Kansas",1084,1078,6,1829,20,77500
"Westwood Hills city, Kansas",258,245,13,444,20,77525
"Wetmore city, Kansas",119,119,0,291,20,77550
"Wheaton city, Kansas",49,49,0,79,20,77700
"White City city, Kansas",186,186,0,518,20,77825
"White Cloud city, Kansas",48,38,10,106,20,77850
"Whitewater city, Kansas",491,480,11,963,20,78050
"Whiting city, Kansas",126,126,0,257,20,78100
"Wichita city, Kansas",202991,191424,11567,395951,20,79000
"Willard city, Kansas",45,44,1,97,20,79250
"Williamsburg city, Kansas",180,166,14,429,20,79300
"Williamstown CDP, Kansas",102,102,0,160,20,79375
"Willis city, Kansas",24,24,0,32,20,79400
"Willowbrook city, Kansas",31,31,0,88,20,79425
"Wilmore city, Kansas",17,17,0,33,20,79550
"Wilroads Gardens CDP, Kansas",405,370,35,897,20,79625
"Wilsey city, Kansas",86,84,2,152,20,79650
"Wilson city, Kansas",303,297,6,777,20,79675
"Winchester city, Kansas",172,163,9,385,20,79800
"Windom city, Kansas",28,28,0,69,20,79850
"Winfield city, Kansas",5689,5327,362,11804,20,79950
"Winona city, Kansas",93,93,0,187,20,80075
"Woodbine city, Kansas",63,61,2,127,20,80350
"Woodruff CDP, Kansas",2,2,0,4,20,80400
"Woodston city, Kansas",33,33,0,102,20,80450
"Wright CDP, Kansas",17,17,0,96,20,80500
"Yale CDP, Kansas",54,54,0,76,20,80650
"Yates Center city, Kansas",706,636,70,1488,20,80700
"Yoder CDP, Kansas",0,0,0,44,20,80750
"Zeandale CDP, Kansas",27,27,0,27,20,80875
"Zenda city, Kansas",38,38,0,71,20,80925
"Zurich city, Kansas",40,40,0,63,20,81025
"Adairville city, Kentucky",297,285,12,747,21,00298
"Ages CDP, Kentucky",165,113,52,344,21,00514
"Albany city, Kentucky",998,942,56,2264,21,00694
"Alexandria city, Kentucky",5914,5756,158,10322,21,00802
"Allen city, Kentucky",78,54,24,213,21,00946
"Allensville CDP, Kentucky",93,73,20,161,21,01000
"Anchorage city, Kentucky",1107,1040,67,2419,21,01504
"Annville CDP, Kentucky",318,318,0,1189,21,01648
"Anthoston CDP, Kentucky",145,135,10,301,21,01720
"Arjay CDP, Kentucky",57,12,45,96,21,01972
"Arlington city, Kentucky",96,92,4,266,21,02044
"Artemus CDP, Kentucky",224,169,55,689,21,02188
"Ashland city, Kentucky",9454,8659,795,21542,21,02368
"Auburn city, Kentucky",788,719,69,1645,21,02638
"Audubon Park city, Kentucky",792,783,9,1412,21,02656
"Augusta city, Kentucky",824,725,99,1599,21,02674
"Auxier CDP, Kentucky",348,337,11,856,21,02764
"Bancroft city, Kentucky",223,213,10,499,21,03376
"Bandana CDP, Kentucky",85,85,0,173,21,03412
"Barbourmeade city, Kentucky",570,533,37,1213,21,03556
"Barbourville city, Kentucky",1394,1063,331,3195,21,03574
"Bardstown city, Kentucky",6426,6207,219,13564,21,03628
"Bardwell city, Kentucky",240,230,10,766,21,03664
"Barlow city, Kentucky",189,180,9,544,21,03718
"Beattyville city, Kentucky",438,388,50,1956,21,04546
"Beaver Dam city, Kentucky",1537,1401,136,3535,21,04654
"Bedford city, Kentucky",95,79,16,303,21,04816
"Beech Grove CDP, Kentucky",99,68,31,198,21,04978
"Beechmont CDP, Kentucky",274,274,0,747,21,05014
"Beechwood Village city, Kentucky",700,681,19,1302,21,05068
"Belfry CDP, Kentucky",122,75,47,233,21,05266
"Bellefonte city, Kentucky",522,508,14,1216,21,05374
"Bellemeade city, Kentucky",497,485,12,944,21,05392
"Belleview CDP, Kentucky",80,80,0,223,21,05428
"Bellevue city, Kentucky",3272,3223,49,5596,21,05446
"Bellewood city, Kentucky",123,123,0,235,21,05464
"Benham city, Kentucky",215,194,21,610,21,05662
"Benton city, Kentucky",2176,2136,40,4753,21,05824
"Berea city, Kentucky",7081,6914,167,15404,21,05842
"Berry city, Kentucky",63,58,5,164,21,05968
"Betsy Layne CDP, Kentucky",225,203,22,662,21,06220
"Big Clifty CDP, Kentucky",82,67,15,227,21,06508
"Blackey city, Kentucky",22,22,0,105,21,07012
"Blaine city, Kentucky",33,30,3,84,21,07264
"Blandville city, Kentucky",28,28,0,118,21,07390
"Bloomfield city, Kentucky",427,412,15,1013,21,07516
"Blue Ridge Manor city, Kentucky",513,498,15,854,21,07858
"Bonnieville city, Kentucky",72,72,0,263,21,08488
"Booneville city, Kentucky",83,83,0,139,21,08614
"Boston CDP, Kentucky",165,165,0,215,21,08722
"Bowling Green city, Kentucky",39303,37104,2199,72385,21,08902
"Bradfordsville city, Kentucky",144,125,19,359,21,09100
"Brandenburg city, Kentucky",1236,1199,37,2896,21,09226
"Breckinridge Center CDP, Kentucky",670,618,52,1770,21,09379
"Bremen city, Kentucky",154,135,19,383,21,09406
"Briarwood city, Kentucky",220,209,11,385,21,09532
"Brodhead city, Kentucky",537,472,65,1361,21,09838
"Broeck Pointe city, Kentucky",135,131,4,271,21,09847
"Bromley city, Kentucky",495,445,50,956,21,09856
"Brooks CDP, Kentucky",864,847,17,2069,21,09964
"Brooksville city, Kentucky",270,264,6,764,21,10000
"Brownsboro Farm city, Kentucky",296,289,7,553,21,10162
"Brownsboro Village city, Kentucky",173,168,5,326,21,10198
"Brownsville city, Kentucky",302,279,23,1050,21,10324
"Buckhorn city, Kentucky",30,30,0,68,21,10612
"Buckner CDP, Kentucky",2070,2052,18,3658,21,10648
"Buffalo CDP, Kentucky",195,195,0,565,21,10774
"Burgin city, Kentucky",484,472,12,1044,21,11044
"Burkesville city, Kentucky",502,490,12,1423,21,11098
"Burlington CDP, Kentucky",10182,9880,302,18264,21,11170
"Burna CDP, Kentucky",38,38,0,101,21,11188
"Burnside city, Kentucky",385,375,10,1081,21,11278
"Butler city, Kentucky",203,194,9,553,21,11530
"Cadiz city, Kentucky",1142,1117,25,2618,21,11692
"Calhoun city, Kentucky",334,296,38,833,21,11854
"California city, Kentucky",38,38,0,52,21,11872
"Calvert City city, Kentucky",1242,1195,47,2524,21,12016
"Camargo city, Kentucky",335,312,23,1018,21,12052
"Cambridge city, Kentucky",118,111,7,153,21,12066
"Campbellsburg city, Kentucky",474,431,43,1045,21,12142
"Campbellsville city, Kentucky",5176,4755,421,11434,21,12160
"Campton city, Kentucky",79,72,7,237,21,12358
"Caneyville city, Kentucky",285,284,1,665,21,12538
"Cannonsburg CDP, Kentucky",547,513,34,1032,21,12610
"Carlisle city, Kentucky",1193,1148,45,2627,21,12898
"Carrollton city, Kentucky",1469,1352,117,3889,21,13024
"Carrsville city, Kentucky",8,8,0,48,21,13060
"Catlettsburg city, Kentucky",485,433,52,1782,21,13420
"Cave City city, Kentucky",1211,1100,111,2707,21,13492
"Cawood CDP, Kentucky",179,179,0,526,21,13582
"Cayce CDP, Kentucky",30,30,0,68,21,13600
"Cecilia CDP, Kentucky",213,152,61,439,21,13636
"Centertown city, Kentucky",133,120,13,436,21,13870
"Central City city, Kentucky",2468,2344,124,5740,21,13978
"Cerulean CDP, Kentucky",199,199,0,419,21,14068
"Chaplin CDP, Kentucky",256,256,0,603,21,14266
"Clarkson city, Kentucky",467,442,25,1218,21,15148
"Claryville CDP, Kentucky",1537,1493,44,3364,21,15166
"Clay city, Kentucky",481,426,55,1079,21,15202
"Clay City city, Kentucky",544,479,65,1567,21,15238
"Cleaton CDP, Kentucky",53,53,0,102,21,15490
"Clinton city, Kentucky",391,339,52,1173,21,15742
"Cloverport city, Kentucky",443,363,80,1185,21,15904
"Coal Run Village city, Kentucky",666,646,20,1519,21,16110
"Coldiron CDP, Kentucky",175,175,0,434,21,16354
"Cold Spring city, Kentucky",3256,3173,83,6258,21,16372
"Coldstream city, Kentucky",781,757,24,1374,21,16395
"Columbia city, Kentucky",2172,2045,127,4811,21,16750
"Columbus city, Kentucky",75,75,0,188,21,16768
"Combs CDP, Kentucky",22,22,0,34,21,16822
"Concord city, Kentucky",1,1,0,12,21,16894
"Corbin city, Kentucky",3257,3108,149,8611,21,17362
"Corinth city, Kentucky",130,115,15,277,21,17434
"Corydon city, Kentucky",347,334,13,774,21,17686
"Covington city, Kentucky",22242,20892,1350,40923,21,17848
"Coxton CDP, Kentucky",56,56,0,229,21,17938
"Crab Orchard city, Kentucky",290,248,42,796,21,17956
"Crayne CDP, Kentucky",78,78,0,146,21,18190
"Creekside city, Kentucky",228,213,15,364,21,18270
"Crescent Springs city, Kentucky",2147,2013,134,4350,21,18352
"Crestview city, Kentucky",337,329,8,488,21,18424
"Crestview Hills city, Kentucky",1877,1776,101,3212,21,18442
"Crestwood city, Kentucky",3420,3250,170,6175,21,18496
"Crittenden city, Kentucky",1886,1779,107,4033,21,18568
"Crofton city, Kentucky",213,206,7,529,21,18658
"Crossgate city, Kentucky",106,101,5,196,21,18766
"Cumberland city, Kentucky",591,340,251,2390,21,19108
"Cunningham CDP, Kentucky",105,105,0,257,21,19234
"Curdsville CDP, Kentucky",55,42,13,114,21,19288
"Cynthiana city, Kentucky",2764,2705,59,6355,21,19432
"Danville city, Kentucky",7651,7027,624,17191,21,19882
"Dawson Springs city, Kentucky",561,497,64,2026,21,20224
"Dayton city, Kentucky",2965,2808,157,5674,21,20350
"Dexter CDP, Kentucky",58,58,0,99,21,21322
"Diablock CDP, Kentucky",216,183,33,425,21,21358
"Dixon city, Kentucky",441,373,68,1134,21,21682
"Doe Valley CDP, Kentucky",832,832,0,1871,21,21844
"Douglass Hills city, Kentucky",3226,2997,229,5466,21,22204
"Dover city, Kentucky",110,106,4,302,21,22222
"Drakesboro city, Kentucky",166,158,8,491,21,22348
"Druid Hills city, Kentucky",179,173,6,317,21,22474
"Dry Ridge city, Kentucky",915,862,53,2227,21,22582
"Dunmor CDP, Kentucky",95,86,9,209,21,23014
"Dwale CDP, Kentucky",57,49,8,165,21,23104
"Earlington city, Kentucky",544,495,49,1219,21,23230
"East Bernstadt CDP, Kentucky",308,275,33,850,21,23284
"Eddyville city, Kentucky",852,831,21,2783,21,23824
"Edgewood city, Kentucky",4269,4206,63,8447,21,23932
"Edmonton city, Kentucky",759,682,77,1898,21,23968
"Ekron city, Kentucky",84,84,0,185,21,24094
"Elizabethtown city, Kentucky",15036,14164,872,31425,21,24274
"Elizaville CDP, Kentucky",56,42,14,114,21,24292
"Elk Creek CDP, Kentucky",1181,1123,58,2295,21,24328
"Elkhorn City city, Kentucky",389,332,57,1013,21,24382
"Elkton city, Kentucky",807,758,49,1953,21,24400
"Elsmere city, Kentucky",5526,5207,319,9126,21,24778
"Eminence city, Kentucky",1225,1144,81,2705,21,24904
"Emlyn CDP, Kentucky",280,235,45,540,21,24922
"Erlanger city, Kentucky",11065,10570,495,19577,21,25300
"Eubank city, Kentucky",193,168,25,471,21,25552
"Evarts city, Kentucky",228,183,45,874,21,25606
"Ewing city, Kentucky",116,101,15,261,21,25786
"Ezel CDP, Kentucky",79,79,0,325,21,25876
"Fairfield city, Kentucky",66,66,0,196,21,26020
"Fairview CDP, Kentucky",21,21,0,117,21,26182
"Fairview city, Kentucky",81,81,0,148,21,26236
"Falmouth city, Kentucky",1097,1026,71,2548,21,26434
"Fancy Farm CDP, Kentucky",117,117,0,300,21,26452
"Farley CDP, Kentucky",1831,1759,72,4559,21,26528
"Farmers CDP, Kentucky",9,9,0,25,21,26560
"Farmington CDP, Kentucky",47,47,0,167,21,26614
"Ferguson city, Kentucky",298,276,22,827,21,27010
"Fincastle city, Kentucky",327,317,10,588,21,27262
"Flat Lick CDP, Kentucky",164,137,27,883,21,27730
"Flatwoods city, Kentucky",3241,3084,157,7312,21,27802
"Fleming-Neon city, Kentucky",307,307,0,862,21,27846
"Flemingsburg city, Kentucky",1267,1057,210,2955,21,27856
"Florence city, Kentucky",16924,16442,482,32056,21,27982
"Fordsville city, Kentucky",251,248,3,546,21,28270
"Forest Hills city, Kentucky",232,224,8,440,21,28342
"Fort Campbell North CDP, Kentucky",1384,1152,232,12014,21,28486
"Fort Knox CDP, Kentucky",1778,1622,156,8655,21,28540
"Fort Mitchell city, Kentucky",4861,4782,79,8667,21,28558
"Fort Thomas city, Kentucky",9066,8720,346,17310,21,28594
"Fort Wright city, Kentucky",3192,3105,87,5841,21,28612
"Fountain Run city, Kentucky",148,139,9,264,21,28666
"Fox Chase city, Kentucky",319,313,6,631,21,28785
"Francisville CDP, Kentucky",5838,5716,122,10044,21,28882
"Frankfort city, Kentucky",14012,13258,754,28460,21,28900
"Franklin city, Kentucky",4109,3895,214,10141,21,28918
"Fredonia city, Kentucky",234,232,2,475,21,29080
"Freeburn CDP, Kentucky",20,20,0,111,21,29134
"Frenchburg city, Kentucky",304,291,13,757,21,29260
"Fulton city, Kentucky",979,952,27,2693,21,29566
"Gamaliel city, Kentucky",193,185,8,430,21,29872
"Garrison CDP, Kentucky",177,165,12,888,21,30232
"Georgetown city, Kentucky",20139,19424,715,37510,21,30700
"Germantown city, Kentucky",122,122,0,234,21,30718
"Ghent city, Kentucky",161,161,0,313,21,30808
"Gilbertsville CDP, Kentucky",127,127,0,245,21,30880
"Glasgow city, Kentucky",6086,5778,308,15043,21,31114
"Glencoe city, Kentucky",124,119,5,339,21,31204
"Glenview city, Kentucky",290,287,3,574,21,31348
"Glenview Hills city, Kentucky",182,182,0,345,21,31402
"Glenview Manor city, Kentucky",104,101,3,206,21,31420
"Goose Creek city, Kentucky",125,118,7,287,21,31870
"Goshen city, Kentucky",613,598,15,1037,21,31960
"Gracey CDP, Kentucky",27,27,0,77,21,32032
"Grand Rivers city, Kentucky",178,174,4,432,21,32212
"Gratz city, Kentucky",32,32,0,89,21,32428
"Graymoor-Devondale city, Kentucky",1395,1366,29,2845,21,32523
"Grayson city, Kentucky",1413,1223,190,3841,21,32572
"Greensburg city, Kentucky",976,798,178,2307,21,32968
"Green Spring city, Kentucky",276,270,6,579,21,32986
"Greenup city, Kentucky",430,398,32,1068,21,33004
"Greenville city, Kentucky",2099,2003,96,4463,21,33022
"Guthrie city, Kentucky",515,433,82,1414,21,33562
"Hanson city, Kentucky",378,363,15,1015,21,34390
"Hardin city, Kentucky",195,178,17,629,21,34534
"Hardinsburg city, Kentucky",1016,946,70,2476,21,34552
"Hardyville CDP, Kentucky",74,74,0,255,21,34660
"Harlan city, Kentucky",723,638,85,1908,21,34732
"Harrodsburg city, Kentucky",4669,4519,150,9057,21,34966
"Hartford city, Kentucky",1324,1290,34,2672,21,35020
"Hawesville city, Kentucky",528,491,37,1043,21,35200
"Hazard city, Kentucky",1916,1702,214,5194,21,35362
"Hazel city, Kentucky",152,134,18,448,21,35380
"Hazel Green CDP, Kentucky",4,4,0,51,21,35398
"Hebron CDP, Kentucky",4015,3945,70,6607,21,35542
"Hebron Estates city, Kentucky",716,622,94,1308,21,35545
"Henderson city, Kentucky",12702,12283,419,28166,21,35866
"Hendron CDP, Kentucky",2405,2291,114,5112,21,35902
"Heritage Creek city, Kentucky",585,571,14,1109,21,36102
"Hickman city, Kentucky",556,529,27,1884,21,36298
"Hickory CDP, Kentucky",38,38,0,115,21,36316
"Hickory Hill city, Kentucky",68,68,0,119,21,36374
"High Bridge CDP, Kentucky",2,2,0,13,21,36460
"Highland Heights city, Kentucky",3717,3605,112,6566,21,36604
"Hills and Dales city, Kentucky",64,63,1,128,21,36865
"Hillview city, Kentucky",4691,4507,184,8681,21,36982
"Hindman city, Kentucky",166,161,5,647,21,37108
"Hiseville CDP, Kentucky",12,12,0,109,21,37234
"Hodgenville city, Kentucky",1152,1152,0,3243,21,37396
"Hollow Creek city, Kentucky",334,330,4,702,21,37576
"Hollyvilla city, Kentucky",271,259,12,376,21,37630
"Hopkinsville city, Kentucky",13079,12065,1014,31042,21,37918
"Horse Cave city, Kentucky",794,732,62,2353,21,38008
"Houston Acres city, Kentucky",378,372,6,751,21,38170
"Hunters Hollow city, Kentucky",177,170,7,327,21,38670
"Hurstbourne city, Kentucky",2199,2129,70,4654,21,38814
"Hurstbourne Acres city, Kentucky",1099,1082,17,1999,21,38818
"Hustonville city, Kentucky",250,225,25,612,21,38836
"Hyden city, Kentucky",262,236,26,547,21,38908
"Independence city, Kentucky",16194,15613,581,28722,21,39142
"Indian Hills city, Kentucky",1345,1317,28,2891,21,39304
"Inez city, Kentucky",360,340,20,835,21,39430
"Ironville CDP, Kentucky",383,383,0,735,21,39592
"Irvine city, Kentucky",988,873,115,2785,21,39646
"Irvington city, Kentucky",660,585,75,1387,21,39664
"Island city, Kentucky",241,204,37,615,21,39700
"Jackson city, Kentucky",1026,928,98,2286,21,39952
"Jamestown city, Kentucky",755,694,61,2343,21,40114
"Jeff CDP, Kentucky",116,116,0,175,21,40204
"Jeffersontown city, Kentucky",15202,14524,678,28796,21,40222
"Jeffersonville city, Kentucky",867,791,76,1833,21,40240
"Jenkins city, Kentucky",771,640,131,1862,21,40312
"Junction City city, Kentucky",946,853,93,2166,21,41338
"Keene city, Kentucky",209,209,0,247,21,41716
"Kenton Vale city, Kentucky",76,76,0,143,21,42094
"Kenvir CDP, Kentucky",164,138,26,458,21,42112
"Kevil city, Kentucky",243,227,16,634,21,42292
"Kingsley city, Kentucky",245,238,7,389,21,42598
"Knottsville CDP, Kentucky",90,90,0,166,21,43030
"Kuttawa city, Kentucky",142,135,7,622,21,43264
"La Center city, Kentucky",278,276,2,846,21,43336
"LaFayette city, Kentucky",103,103,0,196,21,43444
"La Grange city, Kentucky",5385,5132,253,10073,21,43480
"Lakeside Park city, Kentucky",1657,1657,0,2830,21,43606
"Lakeview Heights city, Kentucky",140,136,4,356,21,43668
"Lancaster city, Kentucky",1662,1481,181,3943,21,43840
"Langdon Place city, Kentucky",497,487,10,933,21,43900
"Lawrenceburg city, Kentucky",5749,5407,342,11749,21,44146
"Lebanon city, Kentucky",2582,2361,221,6274,21,44344
"Lebanon Junction city, Kentucky",1047,925,122,2090,21,44362
"Ledbetter CDP, Kentucky",939,849,90,1815,21,44434
"Leitchfield city, Kentucky",2716,2604,112,6432,21,44686
"Lewisburg city, Kentucky",306,277,29,1084,21,45064
"Lewisport city, Kentucky",897,855,42,2180,21,45136
"Lexington-Fayette urban county, Kentucky",178308,169451,8857,321276,21,46027
"Liberty city, Kentucky",879,717,162,2164,21,46072
"Lincolnshire city, Kentucky",50,50,0,105,21,46540
"Livermore city, Kentucky",271,253,18,892,21,47062
"Livingston city, Kentucky",50,50,0,158,21,47098
"London city, Kentucky",2939,2899,40,7612,21,47476
"Loretto city, Kentucky",277,275,2,640,21,47710
"Louisa city, Kentucky",863,795,68,2652,21,47854
"Louisville/Jefferson County metro government (balance), Kentucky",331742,314111,17631,629176,21,48006
"Lovelaceville CDP, Kentucky",0,0,0,8,21,48072
"Lowes CDP, Kentucky",14,14,0,154,21,48234
"Loyall city, Kentucky",192,176,16,614,21,48288
"Ludlow city, Kentucky",2398,2231,167,4384,21,48378
"Lynch city, Kentucky",231,217,14,684,21,48540
"Lyndon city, Kentucky",6749,6480,269,10997,21,48558
"Lynnview city, Kentucky",356,353,3,641,21,48648
"McCarr CDP, Kentucky",79,79,0,241,21,48810
"McDowell CDP, Kentucky",171,130,41,516,21,48954
"Maceo CDP, Kentucky",207,207,0,554,21,49026
"McHenry city, Kentucky",171,161,10,337,21,49098
"McKee city, Kentucky",272,246,26,862,21,49116
"McKinney CDP, Kentucky",0,0,0,37,21,49134
"Mackville city, Kentucky",133,115,18,326,21,49206
"McRoberts CDP, Kentucky",270,270,0,726,21,49278
"Madisonville city, Kentucky",8448,7662,786,19433,21,49368
"Magnolia CDP, Kentucky",366,341,25,696,21,49476
"Manchester city, Kentucky",785,757,28,2195,21,49656
"Manitou CDP, Kentucky",111,111,0,183,21,49746
"Manor Creek city, Kentucky",161,157,4,275,21,49800
"Marion city, Kentucky",1034,1008,26,2905,21,50034
"Marrowbone CDP, Kentucky",50,50,0,75,21,50124
"Martin city, Kentucky",129,129,0,410,21,50286
"Maryhill Estates city, Kentucky",93,93,0,241,21,50412
"Masonville CDP, Kentucky",1106,1066,40,2175,21,50520
"Massac CDP, Kentucky",2059,2059,0,4722,21,50556
"Mayfield city, Kentucky",4140,3920,220,10011,21,50898
"Mayking CDP, Kentucky",184,184,0,527,21,50952
"Mays Lick CDP, Kentucky",40,40,0,94,21,51006
"Maysville city, Kentucky",4023,3828,195,8831,21,51024
"Maytown CDP, Kentucky",0,0,0,13,21,51042
"Meadowbrook Farm city, Kentucky",50,50,0,106,21,51193
"Meadow Vale city, Kentucky",379,376,3,922,21,51258
"Meadowview Estates city, Kentucky",59,57,2,149,21,51294
"Melbourne city, Kentucky",194,181,13,547,21,51438
"Mentor city, Kentucky",124,121,3,208,21,51564
"Middlesborough city, Kentucky",3118,2844,274,9383,21,51924
"Middletown city, Kentucky",4920,4644,276,9594,21,51978
"Midway city, Kentucky",921,875,46,1748,21,52140
"Millersburg city, Kentucky",390,361,29,808,21,52302
"Millstone CDP, Kentucky",132,132,0,675,21,52464
"Milton city, Kentucky",331,317,14,633,21,52590
"Mockingbird Valley city, Kentucky",59,58,1,161,21,52842
"Monterey city, Kentucky",52,43,9,103,21,53076
"Monticello city, Kentucky",2520,2415,105,5770,21,53130
"Moorland city, Kentucky",321,294,27,510,21,53328
"Morehead city, Kentucky",3346,3171,175,7001,21,53418
"Morganfield city, Kentucky",1444,1412,32,3242,21,53472
"Morgantown city, Kentucky",947,836,111,2734,21,53490
"Mortons Gap city, Kentucky",277,274,3,841,21,53616
"Moseleyville CDP, Kentucky",84,84,0,200,21,53670
"Mount Olivet city, Kentucky",51,49,2,147,21,53976
"Mount Sterling city, Kentucky",3226,3042,184,7532,21,54084
"Mount Vernon city, Kentucky",876,844,32,2342,21,54174
"Mount Washington city, Kentucky",9418,8979,439,17987,21,54228
"Muldraugh city, Kentucky",454,416,38,1221,21,54480
"Munfordville city, Kentucky",707,675,32,1746,21,54570
"Murray city, Kentucky",8690,8248,442,17414,21,54642
"Murray Hill city, Kentucky",273,266,7,585,21,54660
"Nebo city, Kentucky",108,105,3,203,21,55092
"New Castle city, Kentucky",348,331,17,880,21,55596
"New Haven city, Kentucky",395,346,49,789,21,55758
"New Hope CDP, Kentucky",9,9,0,35,21,55794
"Newport city, Kentucky",7142,6706,436,14190,21,55884
"Nicholasville city, Kentucky",15148,14359,789,31352,21,56136
"Norbourne Estates city, Kentucky",215,211,4,464,21,56550
"North Corbin CDP, Kentucky",901,812,89,1955,21,56694
"Northfield city, Kentucky",503,499,4,1106,21,56730
"North Middletown city, Kentucky",346,323,23,766,21,56820
"Nortonville city, Kentucky",358,310,48,882,21,56910
"Norwood city, Kentucky",207,197,10,389,21,56928
"Oakbrook CDP, Kentucky",6066,5906,160,10045,21,57030
"Oak Grove city, Kentucky",2880,2529,351,7895,21,57090
"Oakland city, Kentucky",97,96,1,223,21,57144
"Old Brownsboro Place city, Kentucky",177,173,4,384,21,57658
"Olive Hill city, Kentucky",696,690,6,1545,21,57918
"Oneida CDP, Kentucky",102,78,24,269,21,58062
"Onton CDP, Kentucky",0,0,0,0,21,58116
"Orchard Grass Hills city, Kentucky",1040,1012,28,1937,21,58200
"Owensboro city, Kentucky",27618,26459,1159,60019,21,58620
"Owenton city, Kentucky",694,632,62,1640,21,58692
"Owingsville city, Kentucky",789,748,41,1960,21,58710
"Paducah city, Kentucky",12729,12251,478,26869,21,58836
"Paintsville city, Kentucky",1399,1292,107,4277,21,58962
"Panther CDP, Kentucky",0,0,0,0,21,59124
"Paris city, Kentucky",4598,4328,270,10143,21,59196
"Park City city, Kentucky",353,353,0,700,21,59232
"Park Hills city, Kentucky",1738,1660,78,3159,21,59255
"Parkway Village city, Kentucky",393,388,5,622,21,59322
"Pathfork CDP, Kentucky",41,23,18,297,21,59466
"Payne Gap CDP, Kentucky",99,66,33,230,21,59592
"Pembroke city, Kentucky",418,402,16,900,21,59934
"Perryville city, Kentucky",394,391,3,817,21,60258
"Petersburg CDP, Kentucky",351,351,0,587,21,60312
"Pewee Valley city, Kentucky",665,650,15,1514,21,60492
"Phelps CDP, Kentucky",103,14,89,446,21,60600
"Philpot CDP, Kentucky",492,459,33,970,21,60654
"Pikeville city, Kentucky",3018,2893,125,7563,21,60852
"Pine Knot CDP, Kentucky",560,538,22,1483,21,61122
"Pineville city, Kentucky",572,505,67,1796,21,61248
"Pioneer Village city, Kentucky",1328,1303,25,2687,21,61356
"Pippa Passes city, Kentucky",178,173,5,543,21,61374
"Plano CDP, Kentucky",725,689,36,1314,21,61536
"Plantation city, Kentucky",477,460,17,890,21,61554
"Pleasant Ridge CDP, Kentucky",406,387,19,890,21,61680
"Pleasant View CDP, Kentucky",85,85,0,252,21,61734
"Pleasureville city, Kentucky",598,583,15,1223,21,61788
"Plum Springs city, Kentucky",195,187,8,458,21,61860
"Poole CDP, Kentucky",95,95,0,108,21,62202
"Poplar Hills city, Kentucky",286,281,5,519,21,62370
"Powderly city, Kentucky",237,227,10,849,21,62652
"Prestonsburg city, Kentucky",1236,1053,183,3868,21,62940
"Prestonville city, Kentucky",55,43,12,115,21,62958
"Princeton city, Kentucky",2599,2501,98,6248,21,63138
"Prospect city, Kentucky",2265,2159,106,4624,21,63264
"Providence city, Kentucky",1302,1195,107,2883,21,63372
"Pryorsburg CDP, Kentucky",43,43,0,152,21,63426
"Rabbit Hash CDP, Kentucky",85,85,0,117,21,63804
"Raceland city, Kentucky",740,687,53,2015,21,63858
"Radcliff city, Kentucky",10633,9663,970,22981,21,63912
"Ravenna city, Kentucky",281,250,31,650,21,64092
"Raywick city, Kentucky",62,61,1,123,21,64146
"Reidland CDP, Kentucky",2382,2261,121,4647,21,64632
"Richlawn city, Kentucky",226,220,6,361,21,65208
"Richmond city, Kentucky",19963,18508,1455,34883,21,65226
"Rineyville CDP, Kentucky",1276,1181,95,3006,21,65388
"River Bluff city, Kentucky",275,275,0,496,21,65559
"Riverwood city, Kentucky",259,257,2,501,21,65766
"Robards city, Kentucky",276,257,19,550,21,65874
"Rochester city, Kentucky",92,92,0,180,21,65982
"Rockholds CDP, Kentucky",198,162,36,369,21,66162
"Rockport city, Kentucky",74,63,11,236,21,66216
"Rolling Fields city, Kentucky",236,234,2,516,21,66486
"Rolling Hills city, Kentucky",621,600,21,1001,21,66504
"Rosine CDP, Kentucky",53,53,0,125,21,66846
"Russell city, Kentucky",1473,1382,91,3704,21,67458
"Russell Springs city, Kentucky",1256,1154,102,2713,21,67494
"Russellville city, Kentucky",3039,2759,280,7186,21,67512
"Ryland Heights city, Kentucky",402,380,22,888,21,67602
"Sacramento city, Kentucky",193,133,60,413,21,67638
"Sadieville city, Kentucky",174,174,0,325,21,67656
"St. Charles city, Kentucky",102,102,0,272,21,67710
"St. Joseph CDP, Kentucky",26,26,0,243,21,67854
"St. Mary city, Kentucky",80,76,4,184,21,67890
"St. Matthews city, Kentucky",10849,10450,399,17511,21,67944
"St. Regis Park city, Kentucky",829,812,17,1671,21,67998
"Salem city, Kentucky",327,315,12,879,21,68052
"Salt Lick city, Kentucky",118,96,22,376,21,68160
"Salvisa CDP, Kentucky",133,106,27,258,21,68214
"Salyersville city, Kentucky",434,399,35,1880,21,68232
"Sanders city, Kentucky",235,235,0,385,21,68358
"Sandy Hook city, Kentucky",150,142,8,708,21,68556
"Sardis city, Kentucky",24,22,2,78,21,68646
"Science Hill city, Kentucky",288,269,19,714,21,68952
"Scottsville city, Kentucky",1966,1648,318,4332,21,69114
"Sebree city, Kentucky",819,817,2,1798,21,69222
"Sedalia CDP, Kentucky",70,70,0,162,21,69258
"Seneca Gardens city, Kentucky",288,287,1,570,21,69384
"Sharpsburg city, Kentucky",164,151,13,428,21,69852
"Shelbyville city, Kentucky",9333,9066,267,17239,21,70050
"Shepherdsville city, Kentucky",7132,6877,255,14136,21,70086
"Shively city, Kentucky",7509,7078,431,15595,21,70284
"Silver Grove city, Kentucky",666,630,36,1335,21,70644
"Simpsonville city, Kentucky",1557,1545,12,2976,21,70752
"Slaughters city, Kentucky",84,78,6,201,21,71130
"Smithfield city, Kentucky",121,118,3,186,21,71364
"Smithland city, Kentucky",115,115,0,274,21,71382
"Smiths Grove city, Kentucky",381,362,19,707,21,71454
"Somerset city, Kentucky",5061,4622,439,11998,21,71688
"Sonora city, Kentucky",239,234,5,688,21,71724
"Sorgho CDP, Kentucky",1436,1422,14,2696,21,71760
"South Carrollton city, Kentucky",54,54,0,152,21,71814
"Southgate city, Kentucky",2156,2056,100,3677,21,71976
"South Park View city, Kentucky",0,0,0,0,21,72138
"South Shore city, Kentucky",486,353,133,1375,21,72210
"South Wallins CDP, Kentucky",221,201,20,976,21,72255
"South Williamson CDP, Kentucky",201,201,0,367,21,72264
"Sparta city, Kentucky",120,114,6,281,21,72372
"Spottsville CDP, Kentucky",95,79,16,194,21,72570
"Springfield city, Kentucky",1481,1473,8,2846,21,72660
"Spring Mill city, Kentucky",187,182,5,325,21,72770
"Spring Valley city, Kentucky",403,395,8,859,21,72790
"Stamping Ground city, Kentucky",464,464,0,908,21,73038
"Stanford city, Kentucky",1407,1361,46,3654,21,73110
"Stanley CDP, Kentucky",148,148,0,369,21,73146
"Stanton city, Kentucky",1120,1053,67,3214,21,73164
"Stearns CDP, Kentucky",379,369,10,1224,21,73362
"Strathmoor Manor city, Kentucky",267,260,7,486,21,74064
"Strathmoor Village city, Kentucky",280,270,10,525,21,74082
"Sturgis city, Kentucky",653,629,24,1693,21,74316
"Summer Shade CDP, Kentucky",128,128,0,292,21,74586
"Summersville CDP, Kentucky",146,146,0,366,21,74604
"Sycamore city, Kentucky",83,80,3,140,21,75190
"Symsonia CDP, Kentucky",278,278,0,464,21,75270
"Taylor Mill city, Kentucky",3627,3462,165,6851,21,75738
"Taylorsville city, Kentucky",646,632,14,1718,21,75810
"Ten Broeck city, Kentucky",31,31,0,73,21,75963
"Thornhill city, Kentucky",96,94,2,177,21,76380
"Thruston CDP, Kentucky",1400,1322,78,2388,21,76620
"Tolu CDP, Kentucky",8,8,0,8,21,77124
"Tompkinsville city, Kentucky",1159,1069,90,2699,21,77160
"Trenton city, Kentucky",159,159,0,286,21,77592
"Union city, Kentucky",3999,3966,33,7369,21,78384
"Uniontown city, Kentucky",338,313,25,732,21,78492
"Upton city, Kentucky",326,324,2,600,21,78672
"Utica CDP, Kentucky",53,53,0,268,21,78708
"Vanceburg city, Kentucky",286,265,21,1303,21,79068
"Van Lear CDP, Kentucky",165,165,0,349,21,79194
"Verona CDP, Kentucky",584,564,20,1146,21,79464
"Versailles city, Kentucky",5585,5424,161,10297,21,79482
"Vicco city, Kentucky",107,92,15,302,21,79590
"Villa Hills city, Kentucky",4066,3944,122,7331,21,79698
"Vine Grove city, Kentucky",2962,2837,125,6611,21,79734
"Virgie CDP, Kentucky",216,192,24,522,21,79860
"Wallins Creek CDP, Kentucky",152,137,15,429,21,80310
"Walton city, Kentucky",2767,2724,43,5492,21,80490
"Warfield city, Kentucky",84,78,6,261,21,80616
"Warsaw city, Kentucky",1002,958,44,2180,21,80706
"Water Valley CDP, Kentucky",54,54,0,88,21,80832
"Watterson Park city, Kentucky",388,366,22,807,21,80913
"Waverly city, Kentucky",148,147,1,353,21,80958
"Wayland city, Kentucky",118,108,10,329,21,81012
"Wellington city, Kentucky",262,258,4,443,21,81372
"West Buechel city, Kentucky",1114,1060,54,1936,21,81624
"West Liberty city, Kentucky",679,658,21,3247,21,81858
"West Louisville CDP, Kentucky",0,0,0,0,21,81876
"West Point city, Kentucky",433,418,15,1073,21,81930
"Westport CDP, Kentucky",148,135,13,206,21,81948
"West Van Lear CDP, Kentucky",656,656,0,1304,21,82056
"Westwood CDP, Kentucky",2003,1941,62,4581,21,82146
"Westwood city, Kentucky",261,257,4,496,21,82164
"Wheatcroft city, Kentucky",61,58,3,143,21,82200
"Wheelwright city, Kentucky",206,181,25,850,21,82272
"White Plains city, Kentucky",375,363,12,1009,21,82722
"Whitesburg city, Kentucky",790,651,139,2153,21,82776
"Whitesville city, Kentucky",224,222,2,570,21,82830
"Whitley City CDP, Kentucky",284,284,0,1148,21,82938
"Wickliffe city, Kentucky",210,210,0,727,21,83064
"Wilder city, Kentucky",1578,1491,87,3152,21,83172
"Wildwood city, Kentucky",116,114,2,238,21,83208
"Williamsburg city, Kentucky",2141,1881,260,5229,21,83334
"Williamstown city, Kentucky",1763,1741,22,3909,21,83406
"Willisburg city, Kentucky",196,193,3,431,21,83424
"Wilmore city, Kentucky",3291,3222,69,6017,21,83550
"Winchester city, Kentucky",9128,8616,512,19080,21,83676
"Windy Hills city, Kentucky",1042,1027,15,2193,21,83784
"Wingo city, Kentucky",310,277,33,718,21,83856
"Woodburn city, Kentucky",115,109,6,306,21,84414
"Woodbury city, Kentucky",37,36,1,67,21,84432
"Woodland Hills city, Kentucky",349,344,5,621,21,84486
"Woodlawn city, Kentucky",114,109,5,179,21,84522
"Woodlawn Park city, Kentucky",425,409,16,776,21,84576
"Worthington city, Kentucky",820,797,23,1722,21,84864
"Worthington Hills city, Kentucky",1163,1127,36,2042,21,84891
"Worthville city, Kentucky",75,73,2,211,21,84900
"Wurtland city, Kentucky",402,379,23,1133,21,85008
"Yelvington CDP, Kentucky",203,203,0,433,21,85224
"Abbeville city, Louisiana",4809,4481,328,11213,22,00100
"Abita Springs town, Louisiana",1242,1204,38,2639,22,00240
"Addis town, Louisiana",3637,3570,67,6779,22,00415
"Albany town, Louisiana",474,469,5,1140,22,00835
"Alexandria city, Louisiana",20739,19191,1548,45133,22,00975
"Ama CDP, Louisiana",483,441,42,1392,22,01780
"Amelia CDP, Louisiana",811,742,69,2000,22,01815
"Amite City town, Louisiana",1638,1579,59,4033,22,01885
"Anacoco village, Louisiana",508,491,17,1066,22,01920
"Angie village, Louisiana",126,115,11,324,22,02165
"Arabi CDP, Louisiana",2101,1891,210,4296,22,02550
"Arcadia town, Louisiana",978,952,26,2725,22,02655
"Arnaudville town, Louisiana",600,558,42,1522,22,03110
"Ashland village, Louisiana",72,68,4,155,22,03145
"Athens village, Louisiana",95,94,1,282,22,03320
"Atlanta village, Louisiana",70,67,3,159,22,03390
"Avondale CDP, Louisiana",2233,1998,235,4870,22,03810
"Baker city, Louisiana",6651,5811,840,12463,22,03985
"Baldwin town, Louisiana",529,525,4,2065,22,04020
"Ball town, Louisiana",1989,1873,116,3926,22,04055
"Banks Springs CDP, Louisiana",677,548,129,1485,22,04230
"Barataria CDP, Louisiana",241,241,0,772,22,04300
"Basile town, Louisiana",687,510,177,2353,22,04580
"Baskin village, Louisiana",65,59,6,170,22,04615
"Bastrop city, Louisiana",3861,3416,445,9623,22,04685
"Baton Rouge city, Louisiana",114785,104955,9830,225500,22,05000
"Bawcomville CDP, Louisiana",1108,1046,62,2654,22,05105
"Bayou Blue CDP, Louisiana",5163,4884,279,11624,22,05175
"Bayou Cane CDP, Louisiana",11257,10551,706,21142,22,05210
"Bayou Corne CDP, Louisiana",11,11,0,21,22,05255
"Bayou Country Club CDP, Louisiana",459,459,0,1271,22,05260
"Bayou Gauche CDP, Louisiana",848,848,0,1480,22,05315
"Bayou Goula CDP, Louisiana",154,154,0,342,22,05350
"Bayou L'Ourse CDP, Louisiana",806,711,95,2039,22,05378
"Bayou Vista CDP, Louisiana",1917,1887,30,3953,22,05525
"Belcher village, Louisiana",120,117,3,292,22,05945
"Belle Chasse CDP, Louisiana",5764,5590,174,10781,22,06120
"Belle Rose CDP, Louisiana",1102,1027,75,2030,22,06260
"Belmont CDP, Louisiana",68,56,12,198,22,06750
"Benton town, Louisiana",1179,1155,24,2386,22,06925
"Bernice town, Louisiana",486,469,17,1206,22,07030
"Berwick town, Louisiana",2110,1893,217,4717,22,07100
"Bienville village, Louisiana",73,65,8,167,22,07205
"Blanchard town, Louisiana",1618,1519,99,3471,22,07730
"Bogalusa city, Louisiana",4693,4147,546,10689,22,08150
"Bonita village, Louisiana",100,98,2,218,22,08535
"Boothville CDP, Louisiana",249,249,0,585,22,08710
"Bordelonville CDP, Louisiana",127,77,50,315,22,08745
"Bossier City city, Louisiana",26796,25249,1547,62971,22,08920
"Bourg CDP, Louisiana",1061,1053,8,2010,22,09095
"Boutte CDP, Louisiana",1100,964,136,2274,22,09130
"Boyce town, Louisiana",597,564,33,1324,22,09165
"Branch CDP, Louisiana",146,109,37,470,22,09235
"Breaux Bridge city, Louisiana",3199,2893,306,7544,22,09340
"Bridge City CDP, Louisiana",3015,2687,328,6916,22,09480
"Broussard city, Louisiana",7415,7140,275,13322,22,10075
"Brownfields CDP, Louisiana",2777,2567,210,5358,22,10145
"Brownsville CDP, Louisiana",1894,1694,200,4198,22,10225
"Brusly town, Louisiana",1319,1075,244,2585,22,10600
"Bryceland village, Louisiana",131,124,7,207,22,10705
"Bunkie city, Louisiana",1150,1021,129,3362,22,10950
"Buras CDP, Louisiana",333,333,0,921,22,10985
"Cade CDP, Louisiana",1110,1094,16,1960,22,11580
"Calhoun CDP, Louisiana",167,167,0,197,22,11825
"Calvin village, Louisiana",54,51,3,174,22,11930
"Cameron CDP, Louisiana",85,69,16,191,22,12000
"Campti town, Louisiana",231,194,37,961,22,12280
"Cankton village, Louisiana",253,253,0,576,22,12420
"Carencro city, Louisiana",5083,4955,128,10194,22,12665
"Carlyss CDP, Louisiana",2036,2033,3,5018,22,12840
"Castor village, Louisiana",98,98,0,292,22,13260
"Catahoula CDP, Louisiana",472,466,6,1042,22,13330
"Cecilia CDP, Louisiana",730,707,23,1375,22,13575
"Center Point CDP, Louisiana",274,274,0,807,22,13855
"Centerville CDP, Louisiana",172,172,0,621,22,13925
"Central city, Louisiana",14136,13819,317,29518,22,13960
"Chackbay CDP, Louisiana",2974,2770,204,5641,22,14100
"Chalmette CDP, Louisiana",10230,9260,970,22192,22,14135
"Charenton CDP, Louisiana",463,444,19,1051,22,14310
"Chataignier village, Louisiana",158,143,15,290,22,14450
"Chatham town, Louisiana",221,218,3,783,22,14485
"Chauvin CDP, Louisiana",1071,959,112,2511,22,14520
"Cheneyville town, Louisiana",221,211,10,679,22,14660
"Choctaw CDP, Louisiana",293,293,0,647,22,15150
"Choudrant village, Louisiana",655,646,9,1395,22,15290
"Church Point town, Louisiana",2120,1967,153,4182,22,15465
"Claiborne CDP, Louisiana",6193,6141,52,12159,22,15605
"Clarence village, Louisiana",200,191,9,429,22,15745
"Clarks village, Louisiana",165,162,3,609,22,15780
"Clayton town, Louisiana",146,139,7,317,22,15850
"Clinton town, Louisiana",563,473,90,1550,22,15990
"Colfax town, Louisiana",479,445,34,1632,22,16375
"Collinston village, Louisiana",104,79,25,227,22,16655
"Columbia town, Louisiana",124,116,8,341,22,16830
"Convent CDP, Louisiana",212,212,0,552,22,17180
"Converse village, Louisiana",179,160,19,445,22,17215
"Cottonport town, Louisiana",664,642,22,1734,22,17880
"Cotton Valley town, Louisiana",211,205,6,713,22,17915
"Coushatta town, Louisiana",662,656,6,2053,22,18055
"Covington city, Louisiana",5105,4863,242,11444,22,18125
"Creola village, Louisiana",79,74,5,257,22,18295
"Crescent CDP, Louisiana",333,316,17,946,22,18335
"Crowley city, Louisiana",3904,3325,579,11726,22,18650
"Cullen town, Louisiana",263,244,19,742,22,18790
"Cut Off CDP, Louisiana",2264,2194,70,5619,22,18930
"Darrow CDP, Louisiana",137,137,0,137,22,19490
"Delacroix CDP, Louisiana",60,60,0,116,22,20050
"Delcambre town, Louisiana",961,906,55,2422,22,20155
"Delhi town, Louisiana",1035,932,103,2630,22,20190
"Delta village, Louisiana",66,66,0,169,22,20330
"Denham Springs city, Louisiana",4649,4305,344,9393,22,20435
"DeQuincy city, Louisiana",1106,1093,13,3058,22,20575
"DeRidder city, Louisiana",4160,3704,456,9850,22,20610
"Des Allemands CDP, Louisiana",1122,1058,64,2340,22,20680
"Destrehan CDP, Louisiana",6418,5826,592,12057,22,20820
"Deville CDP, Louisiana",514,460,54,1083,22,20890
"Dixie Inn village, Louisiana",96,87,9,265,22,21135
"Dodson village, Louisiana",130,119,11,312,22,21170
"Donaldsonville city, Louisiana",2822,2367,455,6799,22,21240
"Dorseyville CDP, Louisiana",61,61,0,120,22,21388
"Downsville village, Louisiana",66,65,1,116,22,21450
"Doyline village, Louisiana",287,274,13,699,22,21590
"Dry Prong village, Louisiana",218,218,0,428,22,21765
"Dubach town, Louisiana",486,472,14,1026,22,21800
"Dubberly village, Louisiana",173,171,2,390,22,21835
"Dulac CDP, Louisiana",327,263,64,844,22,21940
"Duson town, Louisiana",454,425,29,1441,22,22255
"East Hodge village, Louisiana",85,85,0,333,22,22465
"Eastwood CDP, Louisiana",1871,1780,91,4229,22,22610
"Echo CDP, Louisiana",177,156,21,292,22,22640
"Eden Isle CDP, Louisiana",4292,3965,327,8588,22,22722
"Edgard CDP, Louisiana",492,438,54,1154,22,22815
"Edgefield village, Louisiana",181,181,0,334,22,22850
"Egan CDP, Louisiana",384,353,31,833,22,23025
"Elizabeth village, Louisiana",205,186,19,488,22,23235
"Elmwood CDP, Louisiana",4051,3789,262,6081,22,23567
"Elton town, Louisiana",489,485,4,1284,22,23620
"Empire CDP, Louisiana",433,409,24,999,22,23725
"Epps village, Louisiana",121,105,16,559,22,24145
"Erath town, Louisiana",1147,1105,42,2231,22,24180
"Eros town, Louisiana",85,85,0,279,22,24215
"Erwinville CDP, Louisiana",1364,1004,360,2759,22,24250
"Estelle CDP, Louisiana",9406,8800,606,17091,22,24390
"Estherwood village, Louisiana",277,222,55,737,22,24460
"Eunice city, Louisiana",4091,3577,514,9440,22,24565
"Evergreen town, Louisiana",103,90,13,285,22,24775
"Farmerville town, Louisiana",1015,926,89,3371,22,25160
"Fenton village, Louisiana",118,118,0,213,22,25335
"Ferriday town, Louisiana",1122,862,260,3192,22,25440
"Fifth Ward CDP, Louisiana",527,499,28,1147,22,25545
"Fisher village, Louisiana",66,63,3,199,22,25615
"Florien village, Louisiana",278,252,26,665,22,25860
"Folsom village, Louisiana",320,303,17,705,22,26140
"Fordoche town, Louisiana",387,360,27,1060,22,26280
"Forest village, Louisiana",93,72,21,256,22,26350
"Forest Hill village, Louisiana",286,282,4,690,22,26420
"Fort Jesup CDP, Louisiana",128,128,0,483,22,26665
"Fort Polk North CDP, Louisiana",507,446,61,2075,22,26746
"Fort Polk South CDP, Louisiana",1219,1196,23,8327,22,26757
"Franklin city, Louisiana",2728,2654,74,6666,22,27155
"Franklinton town, Louisiana",1651,1581,70,3638,22,27190
"French Settlement village, Louisiana",432,427,5,981,22,27435
"Frierson CDP, Louisiana",0,0,0,14,22,27540
"Galliano CDP, Louisiana",2863,2712,151,6681,22,28065
"Gardere CDP, Louisiana",6768,6348,420,11565,22,28275
"Garyville CDP, Louisiana",774,745,29,2108,22,28345
"Georgetown village, Louisiana",98,90,8,211,22,28660
"Gibsland town, Louisiana",218,214,4,670,22,28835
"Gilbert village, Louisiana",134,126,8,314,22,28940
"Gilliam village, Louisiana",55,53,2,136,22,29010
"Gillis CDP, Louisiana",418,321,97,860,22,29045
"Glencoe CDP, Louisiana",89,89,0,199,22,29150
"Glenmora town, Louisiana",688,641,47,1574,22,29220
"Gloster CDP, Louisiana",27,27,0,66,22,29395
"Golden Meadow town, Louisiana",868,836,32,2053,22,29640
"Goldonna village, Louisiana",98,89,9,352,22,29745
"Gonzales city, Louisiana",6255,5701,554,12356,22,29850
"Good Pine CDP, Louisiana",95,95,0,342,22,29990
"Grambling city, Louisiana",1915,1850,65,5315,22,30515
"Gramercy town, Louisiana",1621,1550,71,2920,22,30550
"Grand Cane village, Louisiana",70,70,0,118,22,30690
"Grand Coteau town, Louisiana",299,283,16,831,22,30760
"Grand Isle town, Louisiana",400,375,25,903,22,30830
"Grand Point CDP, Louisiana",1535,1477,58,2533,22,30900
"Gray CDP, Louisiana",2691,2515,176,5951,22,31180
"Grayson village, Louisiana",218,195,23,633,22,31250
"Greensburg town, Louisiana",438,344,94,1096,22,31565
"Greenwood town, Louisiana",1644,1637,7,3149,22,31705
"Gretna city, Louisiana",8359,7785,574,17640,22,31915
"Grosse Tete village, Louisiana",184,184,0,389,22,32020
"Gueydan town, Louisiana",404,324,80,1220,22,32055
"Hackberry CDP, Louisiana",532,524,8,988,22,32405
"Hahnville CDP, Louisiana",1736,1713,23,3795,22,32510
"Hall Summit village, Louisiana",118,115,3,250,22,32650
"Hammond city, Louisiana",9128,8668,460,20239,22,32755
"Harahan city, Louisiana",4811,4677,134,9043,22,32930
"Harrisonburg village, Louisiana",113,113,0,278,22,33210
"Harvey CDP, Louisiana",9788,8862,926,21485,22,33245
"Haughton town, Louisiana",2308,2178,130,4450,22,33420
"Hayes CDP, Louisiana",201,157,44,477,22,33490
"Haynesville town, Louisiana",616,519,97,2287,22,33525
"Heflin village, Louisiana",113,111,2,250,22,33735
"Henderson town, Louisiana",579,539,40,1677,22,33875
"Hessmer village, Louisiana",247,233,14,626,22,34015
"Hester CDP, Louisiana",364,364,0,706,22,34085
"Hodge village, Louisiana",130,126,4,610,22,35100
"Homer town, Louisiana",878,832,46,2739,22,35870
"Hornbeck town, Louisiana",343,327,16,674,22,36045
"Hosston village, Louisiana",175,164,11,308,22,36150
"Houma city, Louisiana",15615,14818,797,33094,22,36255
"Ida village, Louisiana",72,70,2,217,22,36885
"Independence town, Louisiana",1067,891,176,2258,22,37025
"Inniswold CDP, Louisiana",3274,3038,236,6236,22,37270
"Iota town, Louisiana",628,593,35,1518,22,37410
"Iowa town, Louisiana",1410,1336,74,3297,22,37445
"Jackson town, Louisiana",737,636,101,4600,22,37830
"Jamestown village, Louisiana",48,48,0,115,22,37935
"Jeanerette city, Louisiana",2024,1926,98,4807,22,38075
"Jean Lafitte town, Louisiana",1109,911,198,2517,22,38092
"Jefferson CDP, Louisiana",5885,5640,245,10141,22,38145
"Jena town, Louisiana",2129,2046,83,4099,22,38285
"Jennings city, Louisiana",3692,3505,187,9819,22,38355
"Jonesboro town, Louisiana",1162,1144,18,4135,22,38670
"Jonesville town, Louisiana",443,408,35,1252,22,38775
"Jordan Hill CDP, Louisiana",171,171,0,180,22,38845
"Joyce CDP, Louisiana",72,72,0,184,22,38880
"Junction City village, Louisiana",140,140,0,556,22,38985
"Kaplan city, Louisiana",1361,1239,122,4335,22,39055
"Keachi town, Louisiana",77,75,2,190,22,39085
"Kenner city, Louisiana",34330,32363,1967,65785,22,39475
"Kentwood town, Louisiana",634,534,100,1932,22,39545
"Kilbourne village, Louisiana",106,104,2,391,22,39650
"Killian town, Louisiana",502,482,20,1345,22,39685
"Killona CDP, Louisiana",125,116,9,262,22,39720
"Kinder town, Louisiana",911,819,92,1934,22,39755
"Kraemer CDP, Louisiana",544,471,73,1128,22,40210
"Krotz Springs town, Louisiana",328,284,44,915,22,40280
"Labadieville CDP, Louisiana",716,625,91,1546,22,40420
"Lacassine CDP, Louisiana",97,97,0,157,22,40595
"Lacombe CDP, Louisiana",3418,2979,439,7035,22,40665
"Lafayette city, Louisiana",61880,58081,3799,121706,22,40735
"Lafitte CDP, Louisiana",205,178,27,558,22,40840
"Lafourche Crossing CDP, Louisiana",994,994,0,2347,22,40878
"Lake Arthur town, Louisiana",1128,1022,106,2617,22,41050
"Lake Charles city, Louisiana",38700,36480,2220,82430,22,41155
"Lake Providence town, Louisiana",1173,1013,160,3542,22,41400
"Lakeshore CDP, Louisiana",1356,1295,61,3114,22,41470
"Lakeview CDP, Louisiana",435,379,56,837,22,41645
"Laplace CDP, Louisiana",13895,12735,1160,28956,22,42030
"Larose CDP, Louisiana",2934,2681,253,6069,22,42135
"Lawtell CDP, Louisiana",390,341,49,997,22,42520
"Lecompte town, Louisiana",302,265,37,705,22,42800
"Leesville city, Louisiana",2250,2037,213,5681,22,43010
"Lemannville CDP, Louisiana",42,42,0,662,22,43255
"Leonville town, Louisiana",347,347,0,1442,22,43395
"Lewisburg CDP, Louisiana",282,282,0,442,22,43640
"Lillie village, Louisiana",67,67,0,194,22,43920
"Lisbon village, Louisiana",101,96,5,266,22,44235
"Livingston town, Louisiana",960,921,39,2008,22,44655
"Livonia town, Louisiana",546,538,8,1290,22,44690
"Lockport town, Louisiana",1051,972,79,2761,22,44900
"Lockport Heights CDP, Louisiana",690,690,0,1473,22,44970
"Logansport town, Louisiana",685,631,54,1972,22,45040
"Longstreet village, Louisiana",31,27,4,111,22,45460
"Longville CDP, Louisiana",22,22,0,319,22,45530
"Loreauville village, Louisiana",345,344,1,915,22,45670
"Lucky village, Louisiana",65,63,2,155,22,46370
"Luling CDP, Louisiana",7225,6876,349,14207,22,46615
"Lutcher town, Louisiana",959,910,49,3114,22,46720
"Lydia CDP, Louisiana",372,334,38,976,22,46755
"McNary village, Louisiana",81,77,4,177,22,47315
"Madisonville town, Louisiana",512,484,28,981,22,47560
"Mamou town, Louisiana",1129,946,183,2918,22,48085
"Mandeville city, Louisiana",6275,6049,226,13194,22,48225
"Mangham town, Louisiana",253,206,47,657,22,48260
"Mansfield city, Louisiana",1962,1652,310,4675,22,48365
"Mansura town, Louisiana",531,408,123,1376,22,48400
"Many town, Louisiana",811,744,67,2566,22,48470
"Maringouin town, Louisiana",435,411,24,694,22,48610
"Marion town, Louisiana",245,228,17,612,22,48645
"Marksville city, Louisiana",2115,1968,147,5034,22,48750
"Marrero CDP, Louisiana",14856,13819,1037,32003,22,48785
"Marthaville CDP, Louisiana",12,12,0,32,22,48890
"Martin village, Louisiana",167,160,7,610,22,48925
"Mathews CDP, Louisiana",688,666,22,1435,22,49170
"Maurice village, Louisiana",973,948,25,2215,22,49240
"Melville town, Louisiana",226,226,0,729,22,49730
"Meraux CDP, Louisiana",3904,3767,137,7297,22,49800
"Mermentau village, Louisiana",149,149,0,644,22,49870
"Mer Rouge village, Louisiana",315,285,30,812,22,49905
"Merrydale CDP, Louisiana",3674,3063,611,8557,22,49940
"Merryville town, Louisiana",387,325,62,918,22,50010
"Metairie CDP, Louisiana",73765,70558,3207,140046,22,50115
"Midland CDP, Louisiana",126,113,13,216,22,50325
"Midway CDP, Louisiana",366,366,0,749,22,50395
"Milton CDP, Louisiana",1372,1347,25,2459,22,50815
"Minden city, Louisiana",4364,4217,147,11789,22,50885
"Minorca CDP, Louisiana",553,504,49,1398,22,50990
"Monroe city, Louisiana",19920,17789,2131,47631,22,51410
"Montegut CDP, Louisiana",347,344,3,1347,22,51550
"Monterey CDP, Louisiana",55,48,7,238,22,51585
"Montgomery town, Louisiana",329,303,26,876,22,51620
"Monticello CDP, Louisiana",2058,1975,83,4767,22,51645
"Montpelier village, Louisiana",272,195,77,390,22,51690
"Montz CDP, Louisiana",1234,1226,8,2074,22,51795
"Moonshine CDP, Louisiana",49,49,0,126,22,51800
"Mooringsport town, Louisiana",185,169,16,596,22,51830
"Moreauville village, Louisiana",363,339,24,850,22,51970
"Morgan City city, Louisiana",5048,4628,420,11373,22,52040
"Morganza village, Louisiana",294,244,50,569,22,52075
"Morrow CDP, Louisiana",12,12,0,155,22,52250
"Morse village, Louisiana",495,488,7,1111,22,52320
"Moss Bluff CDP, Louisiana",5477,5349,128,11582,22,52425
"Mound village, Louisiana",6,6,0,19,22,52565
"Mount Lebanon town, Louisiana",121,121,0,167,22,52740
"Napoleonville village, Louisiana",113,57,56,382,22,53370
"Natalbany CDP, Louisiana",1642,1431,211,3074,22,53475
"Natchez village, Louisiana",159,152,7,304,22,53510
"Natchitoches city, Louisiana",7262,6437,825,17908,22,53545
"Newellton town, Louisiana",344,326,18,896,22,53930
"New Iberia city, Louisiana",11589,10547,1042,28363,22,54035
"New Llano town, Louisiana",1020,861,159,2290,22,54175
"New Orleans city, Louisiana",190373,174333,16040,380408,22,55000
"New Orleans Station CDP, Louisiana",742,707,35,2900,22,55074
"New Roads city, Louisiana",1994,1834,160,4508,22,55105
"New Sarpy CDP, Louisiana",554,526,28,1140,22,55140
"Noble village, Louisiana",150,137,13,353,22,55420
"Norco CDP, Louisiana",1469,1425,44,2848,22,55525
"North Hodge village, Louisiana",173,166,7,506,22,55910
"North Vacherie CDP, Louisiana",739,689,50,1740,22,56170
"Norwood village, Louisiana",68,66,2,216,22,56295
"Oakdale city, Louisiana",2013,1804,209,6701,22,56540
"Oak Grove town, Louisiana",569,563,6,1531,22,56820
"Oak Hills Place CDP, Louisiana",3951,3880,71,8813,22,56855
"Oak Ridge village, Louisiana",47,47,0,89,22,57205
"Oberlin town, Louisiana",468,460,8,1676,22,57450
"Oil City town, Louisiana",459,400,59,1093,22,57590
"Old Jefferson CDP, Louisiana",4531,4337,194,8162,22,57705
"Olla town, Louisiana",420,390,30,1329,22,57905
"Opelousas city, Louisiana",5900,5251,649,15810,22,58045
"Oretta CDP, Louisiana",266,239,27,734,22,58150
"Ossun CDP, Louisiana",1520,1422,98,2545,22,58360
"Paincourtville CDP, Louisiana",747,704,43,1329,22,58745
"Palmetto village, Louisiana",65,65,0,177,22,58780
"Paradis CDP, Louisiana",446,446,0,651,22,58920
"Parks village, Louisiana",338,318,20,798,22,59165
"Patterson city, Louisiana",2291,2236,55,5868,22,59340
"Paulina CDP, Louisiana",1007,1007,0,2051,22,59375
"Pearl River town, Louisiana",1431,1365,66,2584,22,59445
"Perry CDP, Louisiana",609,563,46,1201,22,59795
"Pierre Part CDP, Louisiana",1388,1284,104,2447,22,60075
"Pine Prairie village, Louisiana",369,314,55,1414,22,60495
"Pineville city, Louisiana",6779,6564,215,14357,22,60530
"Pioneer village, Louisiana",251,249,2,489,22,60565
"Pitkin CDP, Louisiana",80,80,0,381,22,60600
"Plain Dealing town, Louisiana",302,272,30,853,22,60670
"Plaquemine city, Louisiana",2864,2687,177,6218,22,60880
"Plaucheville village, Louisiana",102,100,2,182,22,60985
"Pleasant Hill village, Louisiana",230,183,47,594,22,61055
"Pleasure Bend CDP, Louisiana",113,113,0,271,22,61160
"Pointe a la Hache CDP, Louisiana",231,231,0,331,22,61440
"Point Place CDP, Louisiana",189,173,16,613,22,61473
"Pollock town, Louisiana",227,226,1,519,22,61580
"Ponchatoula city, Louisiana",2558,2502,56,7805,22,61615
"Port Allen city, Louisiana",2446,2238,208,4956,22,61790
"Port Barre town, Louisiana",871,809,62,2181,22,61825
"Port Sulphur CDP, Louisiana",641,511,130,1593,22,62070
"Port Vincent village, Louisiana",325,323,2,560,22,62105
"Powhatan village, Louisiana",14,14,0,44,22,62245
"Poydras CDP, Louisiana",988,988,0,2513,22,62280
"Prairieville CDP, Louisiana",18533,18002,531,34215,22,62385
"Presquille CDP, Louisiana",892,715,177,2136,22,62510
"Prien CDP, Louisiana",4222,3949,273,8326,22,62647
"Prospect CDP, Louisiana",88,88,0,220,22,62733
"Provencal village, Louisiana",127,116,11,257,22,62770
"Quitman village, Louisiana",119,114,5,340,22,63120
"Raceland CDP, Louisiana",4846,4331,515,11094,22,63155
"Rayne city, Louisiana",3051,2702,349,7223,22,63645
"Rayville town, Louisiana",1069,935,134,3343,22,63680
"Red Chute CDP, Louisiana",3434,3221,213,7577,22,63855
"Reddell CDP, Louisiana",215,209,6,423,22,63890
"Reeves village, Louisiana",49,48,1,155,22,64100
"Reserve CDP, Louisiana",3855,3335,520,8012,22,64310
"Richmond village, Louisiana",150,149,1,509,22,64590
"Richwood town, Louisiana",724,637,87,3847,22,64660
"Ridgecrest town, Louisiana",248,224,24,855,22,64765
"Ringgold town, Louisiana",517,444,73,1686,22,64905
"Rio CDP, Louisiana",12,12,0,267,22,64975
"River Ridge CDP, Louisiana",6562,6364,198,13362,22,65150
"Roanoke CDP, Louisiana",67,44,23,311,22,65290
"Robeline village, Louisiana",28,24,4,123,22,65325
"Rock Hill CDP, Louisiana",117,117,0,288,22,65535
"Rodessa village, Louisiana",66,45,21,157,22,65710
"Romeville CDP, Louisiana",14,14,0,27,22,65850
"Rosedale village, Louisiana",701,692,9,1205,22,66060
"Roseland town, Louisiana",437,402,35,1237,22,66165
"Rosepine town, Louisiana",725,677,48,1740,22,66200
"Ruston city, Louisiana",10547,10216,331,22282,22,66655
"St. Francisville town, Louisiana",758,571,187,1724,22,67215
"St. Gabriel city, Louisiana",2486,2315,171,6526,22,67250
"St. James CDP, Louisiana",261,253,8,622,22,67355
"St. Joseph town, Louisiana",257,236,21,776,22,67495
"St. Martinville city, Louisiana",2579,2170,409,5447,22,67600
"St. Maurice CDP, Louisiana",36,36,0,330,22,67635
"St. Rose CDP, Louisiana",3562,3124,438,7469,22,67740
"Saline village, Louisiana",113,113,0,243,22,67880
"Sarepta town, Louisiana",342,308,34,755,22,68125
"Schriever CDP, Louisiana",2852,2669,183,5469,22,68300
"Scott city, Louisiana",4463,4221,242,8271,22,68475
"Shenandoah CDP, Louisiana",9885,9360,525,18561,22,69225
"Shongaloo village, Louisiana",44,39,5,114,22,69455
"Shreveport city, Louisiana",84133,76400,7733,186183,22,70000
"Sibley town, Louisiana",505,493,12,1323,22,70175
"Sicily Island village, Louisiana",131,127,4,429,22,70245
"Sikes village, Louisiana",50,50,0,268,22,70385
"Simmesport town, Louisiana",438,406,32,1308,22,70525
"Simpson village, Louisiana",185,172,13,389,22,70595
"Simsboro village, Louisiana",367,359,8,780,22,70630
"Singer CDP, Louisiana",114,114,0,354,22,70665
"Siracusaville CDP, Louisiana",110,110,0,369,22,70675
"Slaughter town, Louisiana",454,442,12,1055,22,70770
"Slidell city, Louisiana",13441,12745,696,28690,22,70805
"Sorrel CDP, Louisiana",171,171,0,537,22,71190
"Sorrento town, Louisiana",1058,1015,43,1919,22,71225
"South Mansfield village, Louisiana",285,192,93,584,22,71820
"South Vacherie CDP, Louisiana",1549,1503,46,3075,22,72092
"Spearsville village, Louisiana",103,103,0,167,22,72170
"Spokane CDP, Louisiana",231,231,0,471,22,72310
"Springfield town, Louisiana",193,172,21,464,22,72415
"Springhill city, Louisiana",1084,968,116,4740,22,72485
"Stanley village, Louisiana",46,46,0,110,22,72800
"Starks CDP, Louisiana",35,35,0,256,22,72975
"Start CDP, Louisiana",407,398,9,924,22,73010
"Sterlington town, Louisiana",936,929,7,2093,22,73255
"Stonewall town, Louisiana",1193,1183,10,2334,22,73395
"Sugartown CDP, Louisiana",0,0,0,0,22,73570
"Sulphur city, Louisiana",9279,8763,516,21286,22,73640
"Sun village, Louisiana",251,245,6,538,22,73955
"Sunset town, Louisiana",1296,1240,56,3006,22,74060
"Supreme CDP, Louisiana",236,231,5,597,22,74235
"Swartz CDP, Louisiana",2300,2291,9,4803,22,74340
"Taft CDP, Louisiana",34,0,34,87,22,74550
"Tallulah city, Louisiana",1996,1854,142,6290,22,74690
"Tangipahoa village, Louisiana",205,149,56,638,22,74760
"Terrytown CDP, Louisiana",13524,12408,1116,26105,22,75180
"Thibodaux city, Louisiana",7737,7295,442,15738,22,75425
"Tickfaw village, Louisiana",416,400,16,857,22,75670
"Timberlane CDP, Louisiana",5093,4538,555,10912,22,75740
"Triumph CDP, Louisiana",83,83,0,220,22,76440
"Trout CDP, Louisiana",139,139,0,168,22,76475
"Tullos town, Louisiana",125,118,7,288,22,76615
"Turkey Creek village, Louisiana",131,127,4,374,22,76685
"Union CDP, Louisiana",225,204,21,511,22,77035
"Urania town, Louisiana",208,193,15,1219,22,77490
"Varnado village, Louisiana",119,110,9,328,22,77910
"Venice CDP, Louisiana",84,62,22,194,22,78015
"Ventress CDP, Louisiana",487,487,0,1230,22,78050
"Vidalia town, Louisiana",1477,1307,170,3994,22,78470
"Vienna town, Louisiana",304,301,3,587,22,78540
"Vienna Bend CDP, Louisiana",906,792,114,1666,22,78545
"Village St. George CDP, Louisiana",4793,4624,169,8919,22,78680
"Ville Platte city, Louisiana",2830,2127,703,6364,22,78715
"Vinton town, Louisiana",1221,1204,17,3314,22,78820
"Violet CDP, Louisiana",2098,1927,171,4748,22,78855
"Vivian town, Louisiana",1437,1290,147,3086,22,78890
"Waggaman CDP, Louisiana",4966,4480,486,10706,22,79100
"Walker town, Louisiana",3107,3004,103,6359,22,79240
"Wallace CDP, Louisiana",820,724,96,1485,22,79275
"Wallace Ridge CDP, Louisiana",377,377,0,747,22,79310
"Washington town, Louisiana",341,341,0,819,22,79870
"Waterproof town, Louisiana",118,105,13,604,22,79940
"Watson CDP, Louisiana",570,499,71,1445,22,80010
"Welcome CDP, Louisiana",394,394,0,832,22,80360
"Welsh town, Louisiana",1341,1341,0,3336,22,80430
"Westlake city, Louisiana",2218,2195,23,4847,22,80815
"Westminster CDP, Louisiana",1739,1565,174,2907,22,80920
"West Monroe city, Louisiana",6328,5918,410,12987,22,80955
"Westwego city, Louisiana",3819,3628,191,8466,22,81165
"White Castle town, Louisiana",819,666,153,2394,22,81375
"Wilson village, Louisiana",178,178,0,715,22,82215
"Winnfield city, Louisiana",1701,1563,138,4124,22,82460
"Winnsboro city, Louisiana",1728,1522,206,4823,22,82495
"Wisner town, Louisiana",240,215,25,886,22,82565
"Woodmere CDP, Louisiana",5429,4932,497,11661,22,83002
"Woodworth town, Louisiana",1172,1130,42,2406,22,83125
"Youngsville city, Louisiana",7919,7732,187,15990,22,83335
"Zachary city, Louisiana",10808,10166,642,19401,22,83405
"Zwolle town, Louisiana",667,602,65,1860,22,83685
"Alfred CDP, Maine",437,400,37,850,23,00695
"Anson CDP, Maine",352,311,41,837,23,01360
"Ashland CDP, Maine",275,275,0,663,23,01675
"Auburn city, Maine",13071,12217,854,24038,23,02060
"Augusta city, Maine",9459,8727,732,18938,23,02100
"Bangor city, Maine",16192,15461,731,31705,23,02795
"Bar Harbor CDP, Maine",1177,1052,125,2154,23,02830
"Bath city, Maine",4577,4337,240,8775,23,03355
"Belfast city, Maine",2515,2411,104,6953,23,03950
"Berwick CDP, Maine",940,893,47,2050,23,04685
"Bethel CDP, Maine",230,215,15,561,23,04790
"Biddeford city, Maine",13166,12541,625,22438,23,04860
"Bingham CDP, Maine",307,276,31,625,23,04965
"Blaine CDP, Maine",181,173,8,254,23,05350
"Blue Hill CDP, Maine",510,510,0,950,23,05665
"Boothbay Harbor CDP, Maine",494,485,9,982,23,06085
"Bowdoinham CDP, Maine",368,366,2,766,23,06330
"Bradley CDP, Maine",474,466,8,884,23,06645
"Brewer city, Maine",4831,4700,131,9633,23,06925
"Bridgton CDP, Maine",642,588,54,1514,23,07135
"Brownville Junction CDP, Maine",131,107,24,476,23,08360
"Brunswick CDP, Maine",8606,8232,374,16725,23,08395
"Bucksport CDP, Maine",1150,1056,94,2947,23,08780
"Calais city, Maine",1482,1337,145,3078,23,09585
"Camden CDP, Maine",1594,1511,83,3644,23,09690
"Cape Neddick CDP, Maine",945,888,57,2462,23,10320
"Caribou city, Maine",3503,3434,69,7454,23,10565
"Casco CDP, Maine",554,551,3,771,23,11090
"Castine CDP, Maine",428,418,10,923,23,11230
"Chisholm CDP, Maine",790,740,50,1074,23,12770
"Clinton CDP, Maine",726,726,0,1436,23,13435
"Corinna CDP, Maine",302,260,42,556,23,14275
"Cornish CDP, Maine",704,700,4,1115,23,14450
"Cousins Island CDP, Maine",234,216,18,504,23,14800
"Cumberland Center CDP, Maine",1570,1495,75,2913,23,15500
"Damariscotta CDP, Maine",471,435,36,1267,23,16200
"Danforth CDP, Maine",204,173,31,474,23,16375
"Dexter CDP, Maine",952,907,45,1745,23,17495
"Dixfield CDP, Maine",681,668,13,1512,23,17705
"Dover-Foxcroft CDP, Maine",1148,1066,82,2836,23,18230
"Dunstan CDP, Maine",1055,1049,6,1722,23,18965
"Eagle Lake CDP, Maine",72,63,9,383,23,19385
"East Millinocket CDP, Maine",632,599,33,1541,23,21065
"Eastport city, Maine",470,457,13,1211,23,21730
"Ellsworth city, Maine",4513,4415,98,8478,23,23200
"Fairfield CDP, Maine",1445,1378,67,2647,23,24285
"Falmouth CDP, Maine",711,684,27,1620,23,24480
"Falmouth Foreside CDP, Maine",930,904,26,2022,23,24530
"Farmingdale CDP, Maine",1290,1264,26,2264,23,24635
"Farmington CDP, Maine",2167,2072,95,4318,23,24740
"Fort Fairfield CDP, Maine",657,567,90,1566,23,25580
"Fort Kent CDP, Maine",1110,1079,31,2515,23,25720
"Freeport CDP, Maine",1162,1038,124,1848,23,26490
"Fryeburg CDP, Maine",818,764,54,1503,23,26875
"Gardiner city, Maine",2873,2579,294,5994,23,27085
"Gorham CDP, Maine",4357,4179,178,7050,23,28205
"Grand Isle CDP, Maine",92,71,21,222,23,28555
"Gray CDP, Maine",504,504,0,786,23,28835
"Greene CDP, Maine",469,469,0,950,23,29220
"Greenville CDP, Maine",589,561,28,972,23,29500
"Guilford CDP, Maine",240,229,11,539,23,30060
"Hallowell city, Maine",1377,1365,12,2558,23,30550
"Hampden CDP, Maine",2362,2308,54,4466,23,30760
"Hartland CDP, Maine",272,265,7,603,23,31705
"Houlton CDP, Maine",2357,1919,438,4918,23,33945
"Howland CDP, Maine",442,398,44,1126,23,34225
"Island Falls CDP, Maine",139,121,18,342,23,35030
"Jonesport CDP, Maine",324,296,28,723,23,35975
"Kennebunk CDP, Maine",2920,2731,189,6000,23,36500
"Kennebunkport CDP, Maine",565,519,46,1318,23,36710
"Kezar Falls CDP, Maine",354,331,23,791,23,36885
"Kingfield CDP, Maine",304,293,11,601,23,36990
"Kittery CDP, Maine",2284,2240,44,5197,23,37235
"Kittery Point CDP, Maine",632,626,6,1017,23,37375
"Lake Arrowhead CDP, Maine",1619,1593,26,2896,23,37795
"Lewiston city, Maine",19010,17936,1074,37577,23,38740
"Limestone CDP, Maine",412,402,10,1165,23,39265
"Lincoln CDP, Maine",871,850,21,2521,23,39440
"Lisbon CDP, Maine",2029,1962,67,3470,23,40000
"Lisbon Falls CDP, Maine",2068,1987,81,4177,23,40105
"Little Falls CDP, Maine",557,557,0,891,23,40350
"Littlejohn Island CDP, Maine",51,51,0,58,23,40470
"Livermore Falls CDP, Maine",846,813,33,1765,23,40735
"Lubec CDP, Maine",140,132,8,297,23,41575
"Machias CDP, Maine",474,433,41,1331,23,41925
"Madawaska CDP, Maine",998,886,112,2726,23,42485
"Madison CDP, Maine",1081,1061,20,2100,23,42625
"Mapleton CDP, Maine",406,374,32,671,23,43220
"Mars Hill CDP, Maine",365,337,28,954,23,43675
"Mattawamkeag CDP, Maine",201,168,33,431,23,44235
"Mechanic Falls CDP, Maine",1097,1002,95,2286,23,44620
"Mexico CDP, Maine",730,714,16,1833,23,45250
"Milbridge CDP, Maine",175,150,25,481,23,45565
"Milford CDP, Maine",1197,1155,42,2270,23,45635
"Millinocket CDP, Maine",1562,1423,139,4136,23,45845
"Milo CDP, Maine",524,513,11,1409,23,45985
"Naples CDP, Maine",287,287,0,443,23,48050
"Newcastle CDP, Maine",406,388,18,680,23,48610
"Newport CDP, Maine",695,676,19,1485,23,49100
"Norridgewock CDP, Maine",574,574,0,1099,23,49800
"North Anson CDP, Maine",224,212,12,462,23,49975
"North Berwick CDP, Maine",956,949,7,1806,23,50290
"Northeast Harbor CDP, Maine",284,284,0,398,23,51095
"North Windham CDP, Maine",3288,3245,43,5525,23,53685
"Norway CDP, Maine",879,813,66,2698,23,53965
"Oakfield CDP, Maine",163,157,6,427,23,54350
"Oak Hill CDP, Maine",2709,2611,98,5400,23,54490
"Oakland CDP, Maine",1037,1030,7,2519,23,54525
"Old Orchard Beach CDP, Maine",5187,4897,290,9040,23,55120
"Old Town city, Maine",3905,3811,94,7458,23,55225
"Orono CDP, Maine",5293,4941,352,10116,23,55575
"Oxford CDP, Maine",509,420,89,1100,23,56240
"Patten CDP, Maine",116,113,3,380,23,57115
"Pittsfield CDP, Maine",1287,1266,21,3148,23,58970
"Portland city, Maine",41158,39502,1656,68280,23,60545
"Presque Isle city, Maine",4295,4121,174,8772,23,60825
"Randolph CDP, Maine",642,606,36,1522,23,61735
"Rangeley CDP, Maine",336,331,5,568,23,61805
"Richmond CDP, Maine",956,907,49,1835,23,62610
"Rockland city, Maine",3619,3383,236,6986,23,63590
"Rumford CDP, Maine",1613,1505,108,3922,23,64255
"Sabattus CDP, Maine",249,249,0,621,23,64535
"Saco city, Maine",12489,12352,137,20446,23,64675
"Sanford city, Maine",11625,11165,460,21986,23,65725
"Searsport CDP, Maine",829,714,115,1053,23,66600
"Skowhegan CDP, Maine",2679,2589,90,6270,23,68875
"South Berwick CDP, Maine",2045,1926,119,3453,23,69995
"South Eliot CDP, Maine",1911,1861,50,3686,23,70660
"South Paris CDP, Maine",971,944,27,2208,23,71780
"South Portland city, Maine",16595,16115,480,26656,23,71990
"Southwest Harbor CDP, Maine",136,108,28,526,23,72830
"South Windham CDP, Maine",205,187,18,834,23,72900
"Standish CDP, Maine",166,166,0,282,23,73635
"Steep Falls CDP, Maine",873,873,0,2087,23,73985
"Thomaston CDP, Maine",1096,1071,25,2101,23,76330
"Topsham CDP, Maine",3587,3395,192,6813,23,76925
"Turner CDP, Maine",401,354,47,541,23,77765
"Unity CDP, Maine",121,116,5,291,23,78220
"Van Buren CDP, Maine",560,551,9,1682,23,78535
"Vanceboro CDP, Maine",65,63,2,154,23,78640
"Veazie CDP, Maine",1000,969,31,1869,23,78815
"Waldoboro CDP, Maine",796,764,32,1553,23,79515
"Washburn CDP, Maine",327,301,26,875,23,80250
"Waterville city, Maine",7245,6922,323,15785,23,80740
"Westbrook city, Maine",12735,12371,364,20339,23,82105
"West Kennebunk CDP, Maine",643,551,92,1269,23,83330
"Wilton CDP, Maine",640,569,71,1599,23,85815
"Winslow CDP, Maine",2506,2446,60,5597,23,86480
"Winter Harbor CDP, Maine",76,76,0,315,23,86620
"Winterport CDP, Maine",500,500,0,1100,23,86725
"Winthrop CDP, Maine",1161,1090,71,2546,23,86935
"Wiscasset CDP, Maine",732,708,24,1207,23,87040
"Woodland CDP, Maine",493,481,12,1173,23,87250
"Yarmouth CDP, Maine",3468,3241,227,5937,23,87810
"York Harbor CDP, Maine",1503,1493,10,3640,23,88160
"Aberdeen city, Maryland",8406,8101,305,16422,24,00125
"Aberdeen Proving Ground CDP, Maryland",1259,1180,79,2703,24,00175
"Abingdon CDP, Maryland",3412,3279,133,5111,24,00200
"Accident town, Maryland",209,206,3,391,24,00225
"Accokeek CDP, Maryland",7490,6822,668,12745,24,00250
"Adamstown CDP, Maryland",1446,1405,41,2394,24,00350
"Adelphi CDP, Maryland",9784,9084,700,16944,24,00400
"Algonquin CDP, Maryland",510,469,41,1055,24,00712
"Allen CDP, Maryland",46,46,0,160,24,00800
"Andrews AFB CDP, Maryland",573,545,28,3099,24,01450
"Annapolis city, Maryland",21676,20748,928,40719,24,01600
"Annapolis Neck CDP, Maryland",6539,6412,127,12712,24,01635
"Antietam CDP, Maryland",18,18,0,60,24,01750
"Aquasco CDP, Maryland",327,317,10,701,24,01925
"Arbutus CDP, Maryland",11803,11083,720,20135,24,01975
"Arden on the Severn CDP, Maryland",747,712,35,1363,24,02025
"Arnold CDP, Maryland",13016,12576,440,24825,24,02275
"Ashton-Sandy Spring CDP, Maryland",2958,2862,96,5578,24,02762
"Aspen Hill CDP, Maryland",30852,28804,2048,54262,24,02825
"Baden CDP, Maryland",995,932,63,1902,24,03500
"Bagtown CDP, Maryland",274,267,7,521,24,03514
"Bakersville CDP, Maryland",0,0,0,0,24,03575
"Ballenger Creek CDP, Maryland",13384,12919,465,24325,24,03800
"Baltimore city, Maryland",295854,275370,20484,584548,24,04000
"Baltimore Highlands CDP, Maryland",4046,3802,244,8116,24,04050
"Barclay town, Maryland",101,101,0,175,24,04250
"Barnesville town, Maryland",74,74,0,186,24,04475
"Barrelville CDP, Maryland",30,30,0,64,24,04525
"Barton town, Maryland",226,178,48,606,24,04625
"Bartonsville CDP, Maryland",1372,1338,34,2373,24,04650
"Beaver Creek CDP, Maryland",209,209,0,422,24,05250
"Bel Air CDP, Maryland",741,728,13,1670,24,05525
"Bel Air town, Maryland",5685,5400,285,10630,24,05550
"Bel Air North CDP, Maryland",16539,16120,419,31308,24,05825
"Bel Air South CDP, Maryland",31209,30232,977,57109,24,05950
"Beltsville CDP, Maryland",9803,9032,771,19704,24,06400
"Benedict CDP, Maryland",0,0,0,147,24,06550
"Bensville CDP, Maryland",7289,6979,310,14202,24,06662
"Berlin town, Maryland",2386,2319,67,5056,24,06800
"Berwyn Heights town, Maryland",1755,1670,85,3312,24,06925
"Bethesda CDP, Maryland",35524,34372,1152,66316,24,07125
"Betterton town, Maryland",158,120,38,363,24,07200
"Bier CDP, Maryland",182,182,0,214,24,07285
"Big Pool CDP, Maryland",40,40,0,40,24,07375
"Big Spring CDP, Maryland",23,23,0,23,24,07400
"Bishopville CDP, Maryland",285,285,0,548,24,07625
"Bivalve CDP, Maryland",46,46,0,106,24,07675
"Bladensburg town, Maryland",4820,4100,720,9574,24,07850
"Bloomington CDP, Maryland",70,62,8,133,24,08050
"Boonsboro town, Maryland",1929,1862,67,3785,24,08625
"Bowie city, Maryland",34041,32294,1747,57922,24,08775
"Bowleys Quarters CDP, Maryland",4245,4152,93,6746,24,08800
"Bowling Green CDP, Maryland",604,570,34,1102,24,08850
"Bowmans Addition CDP, Maryland",418,380,38,690,24,08862
"Braddock Heights CDP, Maryland",1337,1292,45,2857,24,09100
"Brandywine CDP, Maryland",5798,5440,358,10088,24,09325
"Breathedsville CDP, Maryland",32,32,0,211,24,09400
"Brentwood town, Maryland",2153,2033,120,3782,24,09500
"Brock Hall CDP, Maryland",7173,6618,555,12529,24,10150
"Brookeville town, Maryland",99,99,0,164,24,10225
"Brooklyn Park CDP, Maryland",7543,7243,300,15902,24,10475
"Brookmont CDP, Maryland",2122,1991,131,3732,24,10500
"Brookview town, Maryland",21,21,0,42,24,10575
"Broomes Island CDP, Maryland",376,376,0,524,24,10650
"Brown Station CDP, Maryland",2328,2293,35,3648,24,10737
"Brownsville CDP, Maryland",12,12,0,12,24,10800
"Brunswick city, Maryland",4544,4278,266,7781,24,10900
"Bryans Road CDP, Maryland",4881,4433,448,8592,24,10925
"Bryantown CDP, Maryland",284,284,0,620,24,10950
"Buckeystown CDP, Maryland",471,455,16,1235,24,11050
"Burkittsville town, Maryland",82,71,11,143,24,11400
"Burnt Mills CDP, Maryland",2354,2080,274,4425,24,11550
"Burtonsville CDP, Maryland",6261,5979,282,10316,24,11750
"Butlertown CDP, Maryland",302,302,0,519,24,11900
"Cabin John CDP, Maryland",1139,1139,0,2196,24,12075
"California CDP, Maryland",8133,8037,96,13635,24,12150
"Callaway CDP, Maryland",689,689,0,1216,24,12175
"Calvert Beach CDP, Maryland",500,477,23,1026,24,12300
"Calverton CDP, Maryland",9220,8659,561,18324,24,12350
"Cambridge city, Maryland",6253,5803,450,13058,24,12400
"Camp Springs CDP, Maryland",13184,12596,588,23269,24,12600
"Cape St. Claire CDP, Maryland",4955,4666,289,9212,24,12912
"Capitol Heights town, Maryland",2152,2005,147,4033,24,13000
"Carlos CDP, Maryland",37,37,0,52,24,13225
"Carney CDP, Maryland",14519,13963,556,29352,24,13325
"Catonsville CDP, Maryland",21859,21043,816,42767,24,14125
"Cavetown CDP, Maryland",422,413,9,974,24,14225
"Cearfoss CDP, Maryland",43,43,0,147,24,14300
"Cecilton town, Maryland",511,449,62,878,24,14325
"Cedar Heights CDP, Maryland",966,943,23,1997,24,14550
"Cedarville CDP, Maryland",466,454,12,827,24,14800
"Centreville town, Maryland",2318,2264,54,4700,24,14950
"Chance CDP, Maryland",141,121,20,267,24,15075
"Charlestown town, Maryland",882,854,28,2050,24,15400
"Charlotte Hall CDP, Maryland",550,514,36,1410,24,15475
"Charlton CDP, Maryland",217,217,0,323,24,15500
"Chesapeake Beach town, Maryland",3188,3149,39,6358,24,15925
"Chesapeake City town, Maryland",406,388,18,801,24,15950
"Chesapeake Landing CDP, Maryland",185,185,0,496,24,16025
"Chesapeake Ranch Estates CDP, Maryland",5458,5313,145,10015,24,16050
"Chester CDP, Maryland",2459,2400,59,4456,24,16125
"Chestertown town, Maryland",2369,2276,93,5522,24,16225
"Cheverly town, Maryland",3571,3343,228,6132,24,16550
"Chevy Chase town, Maryland",1440,1388,52,2879,24,16620
"Chevy Chase CDP, Maryland",5082,4928,154,9789,24,16625
"Chevy Chase Section Five village, Maryland",454,451,3,796,24,16720
"Chevy Chase Section Three village, Maryland",447,444,3,1026,24,16730
"Chevy Chase View town, Maryland",529,525,4,1123,24,16775
"Chevy Chase Village town, Maryland",895,873,22,1885,24,16787
"Chewsville CDP, Maryland",165,165,0,262,24,16800
"Chillum CDP, Maryland",19573,18382,1191,35908,24,16875
"Choptank CDP, Maryland",69,69,0,89,24,17000
"Church Creek town, Maryland",48,47,1,90,24,17050
"Church Hill town, Maryland",543,541,2,1084,24,17100
"Clarksburg CDP, Maryland",15126,14415,711,28337,24,17350
"Clarysville CDP, Maryland",0,0,0,13,24,17475
"Clear Spring town, Maryland",224,221,3,411,24,17600
"Clinton CDP, Maryland",22567,21286,1281,40224,24,17900
"Cloverly CDP, Maryland",8768,8097,671,16436,24,18150
"Cobb Island CDP, Maryland",920,884,36,1298,24,18200
"Cockeysville CDP, Maryland",14172,13470,702,23246,24,18250
"Colesville CDP, Maryland",7032,6771,261,13704,24,18475
"College Park city, Maryland",17350,16193,1157,34416,24,18750
"Colmar Manor town, Maryland",896,826,70,1516,24,18850
"Columbia CDP, Maryland",60539,58092,2447,106600,24,19125
"Coral Hills CDP, Maryland",5859,5391,468,9415,24,19825
"Cordova CDP, Maryland",191,191,0,509,24,19900
"Corriganville CDP, Maryland",264,264,0,717,24,19975
"Cottage City town, Maryland",639,606,33,1115,24,20050
"Crellin CDP, Maryland",113,113,0,194,24,20500
"Cresaptown CDP, Maryland",738,738,0,4746,24,20525
"Crisfield city, Maryland",1182,1011,171,2445,24,20775
"Crofton CDP, Maryland",15852,15201,651,29358,24,20875
"Croom CDP, Maryland",1564,1442,122,2842,24,20925
"Crownsville CDP, Maryland",581,561,20,1363,24,21075
"Crumpton CDP, Maryland",179,148,31,360,24,21150
"Cumberland city, Maryland",7942,7220,722,19041,24,21325
"Damascus CDP, Maryland",9891,9560,331,16846,24,21475
"Dames Quarter CDP, Maryland",153,153,0,212,24,21550
"Danville CDP, Maryland",149,149,0,597,24,21675
"Dargan CDP, Maryland",109,77,32,189,24,21750
"Darlington CDP, Maryland",242,228,14,478,24,21800
"Darnestown CDP, Maryland",3876,3754,122,6672,24,21825
"Dawson CDP, Maryland",27,27,0,62,24,21925
"Deale CDP, Maryland",2421,2245,176,4706,24,22050
"Deal Island CDP, Maryland",84,84,0,286,24,22100
"Deer Park town, Maryland",165,150,15,337,24,22275
"Delmar town, Maryland",2277,2080,197,3897,24,22600
"Denton town, Maryland",2262,2099,163,4836,24,22725
"Derwood CDP, Maryland",952,889,63,1850,24,22775
"Detmold CDP, Maryland",0,0,0,99,24,22825
"District Heights city, Maryland",2789,2438,351,5905,24,23025
"Downsville CDP, Maryland",751,692,59,918,24,23500
"Drum Point CDP, Maryland",1487,1442,45,2979,24,23700
"Dundalk CDP, Maryland",31649,29476,2173,66321,24,23975
"Dunkirk CDP, Maryland",1221,1212,9,2277,24,24050
"Eagle Harbor town, Maryland",32,32,0,42,24,24200
"Eakles Mill CDP, Maryland",0,0,0,0,24,24250
"East New Market town, Maryland",184,182,2,389,24,24450
"Easton town, Maryland",8027,7907,120,17118,24,24475
"East Riverdale CDP, Maryland",9292,8548,744,18080,24,24650
"Eckhart Mines CDP, Maryland",216,196,20,514,24,24825
"Eden CDP, Maryland",368,330,38,1008,24,24850
"Edesville CDP, Maryland",26,18,8,33,24,24925
"Edgemere CDP, Maryland",4319,4184,135,8879,24,24950
"Edgemont CDP, Maryland",158,146,12,244,24,25000
"Edgewater CDP, Maryland",4952,4731,221,8928,24,25050
"Edgewood CDP, Maryland",14014,12988,1026,25116,24,25150
"Edmonston town, Maryland",923,828,95,1751,24,25425
"Eldersburg CDP, Maryland",16502,16072,430,30357,24,25575
"Eldorado town, Maryland",25,23,2,50,24,25600
"Elkridge CDP, Maryland",13864,13134,730,25251,24,25750
"Elkton town, Maryland",7614,7239,375,15830,24,25800
"Ellerslie CDP, Maryland",272,264,8,575,24,25925
"Ellicott City CDP, Maryland",37896,36629,1267,73589,24,26000
"Elliott CDP, Maryland",5,5,0,21,24,26025
"Emmitsburg town, Maryland",1487,1428,59,2818,24,26200
"Ernstville CDP, Maryland",20,20,0,20,24,26550
"Essex CDP, Maryland",21896,20583,1313,40842,24,26600
"Fairland CDP, Maryland",14872,13797,1075,25987,24,27250
"Fairlee CDP, Maryland",143,143,0,280,24,27325
"Fairmount CDP, Maryland",219,189,30,410,24,27375
"Fairmount Heights town, Maryland",786,730,56,1490,24,27400
"Fairplay CDP, Maryland",341,341,0,543,24,27425
"Fairview CDP, Maryland",0,0,0,0,24,27500
"Fairwood CDP, Maryland",4415,4326,89,7653,24,27580
"Fallston CDP, Maryland",5478,5435,43,9952,24,27700
"Federalsburg town, Maryland",1135,1051,84,2818,24,27900
"Ferndale CDP, Maryland",8910,8362,548,16669,24,28075
"Finzel CDP, Maryland",283,283,0,740,24,28275
"Fishing Creek CDP, Maryland",108,94,14,235,24,28300
"Flintstone CDP, Maryland",40,40,0,183,24,28425
"Flower Hill CDP, Maryland",7828,7297,531,14631,24,28512
"Forest Glen CDP, Maryland",3701,3480,221,6859,24,28640
"Forest Heights town, Maryland",1270,1113,157,2641,24,28725
"Forestville CDP, Maryland",5522,5127,395,10291,24,29000
"Fort Meade CDP, Maryland",2499,2384,115,10011,24,29400
"Fort Ritchie CDP, Maryland",0,0,0,0,24,29450
"Fort Washington CDP, Maryland",14351,13495,856,25825,24,29525
"Fountainhead-Orchard Hills CDP, Maryland",3048,2963,85,6198,24,29712
"Four Corners CDP, Maryland",4437,4338,99,7766,24,29790
"Franklin CDP, Maryland",31,31,0,166,24,30100
"Frederick city, Maryland",43710,41811,1899,78390,24,30325
"Frenchtown-Rumbly CDP, Maryland",0,0,0,8,24,30567
"Friendly CDP, Maryland",5888,5483,405,10639,24,30575
"Friendship CDP, Maryland",144,122,22,326,24,30650
"Friendship Heights Village CDP, Maryland",2500,2427,73,4315,24,30800
"Friendsville town, Maryland",202,195,7,411,24,30850
"Frostburg city, Maryland",3032,2810,222,7118,24,30900
"Fruitland city, Maryland",2764,2457,307,5603,24,30950
"Fulton CDP, Maryland",3017,2982,35,5435,24,31025
"Funkstown town, Maryland",449,430,19,861,24,31100
"Gaithersburg city, Maryland",40002,37782,2220,69016,24,31175
"Galena town, Maryland",484,484,0,697,24,31225
"Galestown town, Maryland",16,14,2,74,24,31250
"Galesville CDP, Maryland",572,556,16,1226,24,31275
"Gambrills CDP, Maryland",1536,1506,30,3111,24,31350
"Gapland CDP, Maryland",0,0,0,9,24,31400
"Garrett Park town, Maryland",427,413,14,816,24,31525
"Garretts Mill CDP, Maryland",167,167,0,314,24,31575
"Garrison CDP, Maryland",4835,4654,181,9764,24,31625
"Georgetown CDP, Maryland",28,28,0,50,24,31875
"Germantown CDP, Maryland",52745,50026,2719,90210,24,32025
"Gilmore CDP, Maryland",217,217,0,359,24,32175
"Girdletree CDP, Maryland",67,67,0,122,24,32250
"Glassmanor CDP, Maryland",9950,9281,669,17353,24,32350
"Glenarden city, Maryland",3325,3186,139,6335,24,32500
"Glen Burnie CDP, Maryland",40604,38920,1684,71427,24,32650
"Glen Echo town, Maryland",138,137,1,282,24,32900
"Glenmont CDP, Maryland",9798,9241,557,16632,24,33250
"Glenn Dale CDP, Maryland",8413,7806,607,15244,24,33400
"Golden Beach CDP, Maryland",1985,1944,41,3933,24,33850
"Goldsboro town, Maryland",82,82,0,211,24,33950
"Gorman CDP, Maryland",84,84,0,258,24,34150
"Graceham CDP, Maryland",128,128,0,203,24,34350
"Grahamtown CDP, Maryland",140,121,19,325,24,34425
"Grantsville town, Maryland",382,376,6,956,24,34525
"Grasonville CDP, Maryland",1810,1756,54,3332,24,34550
"Greenbelt city, Maryland",14524,13282,1242,24646,24,34775
"Greensboro town, Maryland",1151,1100,51,2780,24,35200
"Greensburg CDP, Maryland",40,40,0,117,24,35225
"Green Valley CDP, Maryland",6927,6673,254,12980,24,35412
"Hagerstown city, Maryland",19993,18447,1546,43374,24,36075
"Halfway CDP, Maryland",5211,5028,183,10221,24,36125
"Hampstead town, Maryland",3958,3684,274,6278,24,36500
"Hampton CDP, Maryland",2645,2622,23,5080,24,36512
"Hancock town, Maryland",676,648,28,1583,24,36600
"Havre de Grace city, Maryland",7663,7358,305,14743,24,37600
"Hebron town, Maryland",617,580,37,1127,24,37875
"Henderson town, Maryland",70,70,0,149,24,37925
"Herald Harbor CDP, Maryland",1562,1532,30,2690,24,38025
"Highfield-Cascade CDP, Maryland",595,579,16,1031,24,38437
"Highland CDP, Maryland",415,406,9,927,24,38475
"Highland Beach town, Maryland",31,31,0,62,24,38500
"Hillandale CDP, Maryland",3064,2823,241,5002,24,38850
"Hillcrest Heights CDP, Maryland",8837,7851,986,16478,24,38975
"Hillsboro town, Maryland",94,93,1,149,24,39175
"Honeygo CDP, Maryland",6209,5963,246,12045,24,40200
"Hughesville CDP, Maryland",1258,1242,16,2299,24,40700
"Huntingtown CDP, Maryland",1755,1714,41,2827,24,41025
"Hurlock town, Maryland",1078,1008,70,2284,24,41125
"Hutton CDP, Maryland",163,87,76,234,24,41175
"Hyattsville city, Maryland",12891,12526,365,20851,24,41250
"Ilchester CDP, Maryland",16287,15795,492,27300,24,41475
"Indian Head town, Maryland",2070,2025,45,3931,24,41500
"Indian Springs CDP, Maryland",0,0,0,11,24,41700
"Jarrettsville CDP, Maryland",1509,1395,114,2677,24,42325
"Jefferson CDP, Maryland",1498,1445,53,2742,24,42350
"Jennings CDP, Maryland",0,0,0,9,24,42450
"Jessup CDP, Maryland",2506,2396,110,9602,24,42550
"Jesterville CDP, Maryland",72,72,0,72,24,42575
"Joppatowne CDP, Maryland",7859,7455,404,13391,24,42875
"Jugtown CDP, Maryland",77,77,0,142,24,42950
"Keedysville town, Maryland",560,533,27,1172,24,43100
"Kemp Mill CDP, Maryland",7606,7309,297,14098,24,43200
"Kemps Mill CDP, Maryland",0,0,0,27,24,43280
"Kennedyville CDP, Maryland",260,260,0,456,24,43475
"Kensington town, Maryland",1110,1046,64,2241,24,43500
"Kent Narrows CDP, Maryland",246,246,0,578,24,43725
"Kettering CDP, Maryland",7307,6825,482,13873,24,43900
"Kingstown CDP, Maryland",839,828,11,1874,24,44325
"Kingsville CDP, Maryland",2317,2302,15,4652,24,44350
"Kitzmiller town, Maryland",115,88,27,224,24,44450
"Klondike CDP, Maryland",67,67,0,228,24,44525
"Konterra CDP, Maryland",1506,1391,115,3104,24,44715
"Lake Arbor CDP, Maryland",8948,8494,454,14901,24,44817
"Lake Shore CDP, Maryland",10404,9989,415,18872,24,44975
"Landover CDP, Maryland",12996,12218,778,24430,24,45325
"Landover Hills town, Maryland",1134,1006,128,2118,24,45400
"Langley Park CDP, Maryland",10757,9967,790,21778,24,45525
"Lanham CDP, Maryland",6125,5575,550,11662,24,45550
"Lansdowne CDP, Maryland",4686,4514,172,9254,24,45650
"La Plata town, Maryland",4824,4681,143,10283,24,45750
"Largo CDP, Maryland",7451,6818,633,11757,24,45825
"Laurel city, Maryland",17508,16481,1027,29581,24,45900
"La Vale CDP, Maryland",2311,2248,63,4351,24,46075
"Layhill CDP, Maryland",2972,2789,183,5157,24,46150
"Laytonsville town, Maryland",377,363,14,736,24,46250
"Leisure World CDP, Maryland",2025,1729,296,8975,24,46375
"Leitersburg CDP, Maryland",113,113,0,355,24,46400
"Leonardtown town, Maryland",1800,1774,26,4586,24,46475
"Lewistown CDP, Maryland",147,147,0,327,24,46650
"Lexington Park CDP, Maryland",7758,7442,316,13537,24,46725
"Libertytown CDP, Maryland",641,631,10,1275,24,46800
"Linganore CDP, Maryland",6584,6410,174,11870,24,47040
"Linthicum CDP, Maryland",5888,5749,139,10731,24,47125
"Lisbon CDP, Maryland",50,35,15,62,24,47250
"Little Orleans CDP, Maryland",15,15,0,64,24,47275
"Lochearn CDP, Maryland",13695,12860,835,27078,24,47450
"Loch Lynn Heights town, Maryland",258,244,14,476,24,47525
"Lonaconing town, Maryland",387,372,15,1071,24,47875
"Long Beach CDP, Maryland",1000,1000,0,1761,24,48025
"Luke town, Maryland",45,42,3,94,24,48775
"Lusby CDP, Maryland",1482,1436,46,2350,24,48800
"Lutherville CDP, Maryland",3731,3524,207,6595,24,48875
"McCoole CDP, Maryland",130,123,7,314,24,49325
"Madison CDP, Maryland",76,76,0,213,24,49700
"Manchester town, Maryland",3029,3001,28,5403,24,49950
"Mapleville CDP, Maryland",168,168,0,256,24,50375
"Mardela Springs town, Maryland",261,242,19,529,24,50525
"Marlboro Meadows CDP, Maryland",2052,1949,103,3757,24,50680
"Marlboro Village CDP, Maryland",5373,5078,295,9124,24,50685
"Marlow Heights CDP, Maryland",3360,2927,433,6254,24,50750
"Marlton CDP, Maryland",6197,5936,261,10168,24,50775
"Martin's Additions village, Maryland",505,502,3,993,24,50965
"Marydel town, Maryland",55,48,7,129,24,51025
"Maryland City CDP, Maryland",11191,10105,1086,18345,24,51075
"Maryland Park CDP, Maryland",279,264,15,660,24,51125
"Maugansville CDP, Maryland",1280,1189,91,2770,24,51425
"Mayo CDP, Maryland",4556,4302,254,8255,24,51575
"Mays Chapel CDP, Maryland",6606,6483,123,12059,24,51587
"Mechanicsville CDP, Maryland",984,946,38,1783,24,51800
"Melwood CDP, Maryland",1545,1464,81,3438,24,51940
"Mercersville CDP, Maryland",110,110,0,322,24,51945
"Middleburg CDP, Maryland",0,0,0,0,24,52225
"Middle River CDP, Maryland",16588,15782,806,31155,24,52300
"Middletown town, Maryland",2677,2618,59,4978,24,52425
"Midland town, Maryland",317,290,27,699,24,52475
"Midlothian CDP, Maryland",186,110,76,313,24,52525
"Milford Mill CDP, Maryland",18397,17094,1303,31513,24,52562
"Millington town, Maryland",334,319,15,623,24,52825
"Mitchellville CDP, Maryland",7067,6516,551,12103,24,52975
"Monrovia CDP, Maryland",1944,1931,13,2980,24,53100
"Montgomery Village CDP, Maryland",19471,18175,1296,34748,24,53325
"Morningside town, Maryland",550,483,67,1035,24,53625
"Moscow CDP, Maryland",145,145,0,229,24,53700
"Mount Aetna CDP, Maryland",316,312,4,444,24,53750
"Mountain Lake Park town, Maryland",1079,999,80,2117,24,53800
"Mount Airy town, Maryland",5403,5289,114,9667,24,53875
"Mount Briar CDP, Maryland",111,111,0,175,24,53925
"Mount Lena CDP, Maryland",179,179,0,343,24,54125
"Mount Rainier city, Maryland",5206,4976,230,8262,24,54275
"Mount Savage CDP, Maryland",320,254,66,582,24,54325
"Mount Vernon CDP, Maryland",510,510,0,824,24,54375
"Myersville town, Maryland",1156,1156,0,2493,24,54875
"Nanticoke CDP, Maryland",161,110,51,351,24,54925
"Nanticoke Acres CDP, Maryland",126,126,0,159,24,54930
"National CDP, Maryland",4,4,0,25,24,55000
"National Harbor CDP, Maryland",3223,3139,84,4268,24,55018
"Naval Academy CDP, Maryland",214,209,5,2016,24,55050
"Newark CDP, Maryland",159,159,0,277,24,55325
"New Carrollton city, Maryland",7702,6861,841,13580,24,55400
"New Market town, Maryland",827,798,29,1534,24,55650
"New Windsor town, Maryland",673,586,87,1304,24,55925
"Nikep CDP, Maryland",0,0,0,0,24,55950
"North Beach town, Maryland",1262,1049,213,2646,24,56300
"North Bethesda CDP, Maryland",28514,27598,916,49763,24,56337
"North Brentwood town, Maryland",438,408,30,766,24,56375
"North Chevy Chase village, Maryland",321,311,10,681,24,56400
"North East town, Maryland",2104,2006,98,4061,24,56450
"North Kensington CDP, Maryland",5060,4930,130,8473,24,56712
"North Laurel CDP, Maryland",13650,13235,415,24414,24,56725
"North Potomac CDP, Maryland",13232,12593,639,24692,24,56875
"Oakland town, Maryland",871,854,17,1995,24,57650
"Ocean CDP, Maryland",8,8,0,17,24,58215
"Ocean City town, Maryland",3885,3746,139,6879,24,58225
"Ocean Pines CDP, Maryland",4966,4693,273,12312,24,58275
"Odenton CDP, Maryland",24630,23834,796,45026,24,58300
"Oldtown CDP, Maryland",37,37,0,87,24,58775
"Olney CDP, Maryland",19319,18643,676,35522,24,58900
"Overlea CDP, Maryland",6989,6557,432,12794,24,59325
"Owings CDP, Maryland",1370,1351,19,2376,24,59375
"Owings Mills CDP, Maryland",20864,19673,1191,34999,24,59425
"Oxford town, Maryland",314,270,44,817,24,59450
"Oxon Hill CDP, Maryland",10667,9913,754,18526,24,59500
"Paramount-Long Meadow CDP, Maryland",1300,1237,63,2795,24,59787
"Parkville CDP, Maryland",17387,16390,997,30520,24,60275
"Parole CDP, Maryland",9849,9556,293,18527,24,60325
"Parsonsburg CDP, Maryland",91,91,0,200,24,60425
"Pasadena CDP, Maryland",19773,19000,773,32161,24,60475
"Pecktonville CDP, Maryland",18,18,0,121,24,60770
"Peppermill Village CDP, Maryland",2860,2581,279,5633,24,60950
"Perry Hall CDP, Maryland",15864,15527,337,29255,24,60975
"Perryman CDP, Maryland",1155,927,228,2403,24,61075
"Perryville town, Maryland",2289,2168,121,4398,24,61150
"Pikesville CDP, Maryland",16851,16058,793,34101,24,61400
"Pinesburg CDP, Maryland",314,302,12,511,24,61700
"Piney Point CDP, Maryland",467,415,52,1033,24,61875
"Pittsville town, Maryland",1107,1070,37,2205,24,62025
"Pleasant Grove CDP, Maryland",136,136,0,287,24,62100
"Pleasant Hills CDP, Maryland",1990,1940,50,3925,24,62175
"Pocomoke City city, Maryland",2090,1951,139,4318,24,62475
"Point of Rocks CDP, Maryland",1222,1178,44,2360,24,62575
"Pomfret CDP, Maryland",386,350,36,762,24,62675
"Pondsville CDP, Maryland",76,63,13,180,24,62775
"Poolesville town, Maryland",2948,2771,177,5686,24,62850
"Port Deposit town, Maryland",294,294,0,587,24,63075
"Port Tobacco Village town, Maryland",2,2,0,2,24,63225
"Potomac CDP, Maryland",23093,22122,971,46499,24,63300
"Potomac Heights CDP, Maryland",483,469,14,1166,24,63375
"Potomac Park CDP, Maryland",466,439,27,976,24,63425
"Powellville CDP, Maryland",74,74,0,140,24,63725
"Preston town, Maryland",417,414,3,816,24,63825
"Prince Frederick CDP, Maryland",1140,1025,115,2491,24,63950
"Princess Anne town, Maryland",1857,1818,39,3440,24,64000
"Pylesville CDP, Maryland",349,349,0,780,24,64375
"Quantico CDP, Maryland",110,110,0,176,24,64475
"Queen Anne CDP, Maryland",903,824,79,1516,24,64495
"Queen Anne town, Maryland",113,102,11,198,24,64500
"Queensland CDP, Maryland",1163,1140,23,2034,24,64568
"Queenstown town, Maryland",405,388,17,815,24,64600
"Randallstown CDP, Maryland",19881,18560,1321,36223,24,64950
"Rawlings CDP, Maryland",161,161,0,438,24,65150
"Redland CDP, Maryland",10087,9682,405,18346,24,65312
"Reid CDP, Maryland",36,36,0,99,24,65550
"Reisterstown CDP, Maryland",14654,12983,1671,27616,24,65600
"Ridgely town, Maryland",926,857,69,1727,24,66000
"Ringgold CDP, Maryland",41,41,0,79,24,66150
"Rising Sun town, Maryland",1357,1290,67,2756,24,66275
"Riva CDP, Maryland",2270,2195,75,4784,24,66400
"Riverdale Park town, Maryland",4122,3972,150,7284,24,66635
"Riverside CDP, Maryland",3888,3845,43,5924,24,66762
"Riviera Beach CDP, Maryland",6744,6396,348,12121,24,66850
"Robinwood CDP, Maryland",4205,4056,149,8002,24,67000
"Rock Hall town, Maryland",669,634,35,1456,24,67400
"Rock Point CDP, Maryland",22,22,0,84,24,67500
"Rockville city, Maryland",37302,35964,1338,67142,24,67675
"Rohrersville CDP, Maryland",65,65,0,203,24,67950
"Romancoke CDP, Maryland",912,812,100,1761,24,68265
"Rosaryville CDP, Maryland",6555,6076,479,12026,24,68300
"Rosedale CDP, Maryland",10762,9940,822,20058,24,68400
"Rosemont village, Maryland",127,124,3,298,24,68600
"Rossville CDP, Maryland",9559,9204,355,15503,24,68700
"Sabillasville CDP, Maryland",222,222,0,405,24,69200
"St. George Island CDP, Maryland",97,97,0,208,24,69425
"St. James CDP, Maryland",2156,2145,11,4106,24,69550
"St. Leonard CDP, Maryland",376,376,0,605,24,69675
"St. Michaels town, Maryland",685,633,52,1523,24,69825
"Salisbury city, Maryland",17127,15428,1699,32960,24,69925
"Sandy Hook CDP, Maryland",131,131,0,203,24,70175
"San Mar CDP, Maryland",124,95,29,353,24,70300
"Savage CDP, Maryland",4258,4048,210,7528,24,70475
"Scaggsville CDP, Maryland",5773,5516,257,10793,24,70525
"Seabrook CDP, Maryland",10923,10143,780,19369,24,70775
"Seat Pleasant city, Maryland",2423,1964,459,4544,24,70850
"Secretary town, Maryland",331,306,25,642,24,70900
"Severn CDP, Maryland",31042,29536,1506,56438,24,71150
"Severna Park CDP, Maryland",20561,19963,598,40452,24,71200
"Shady Side CDP, Maryland",2979,2841,138,4959,24,71450
"Shaft CDP, Maryland",169,154,15,281,24,71460
"Sharpsburg town, Maryland",417,414,3,722,24,71600
"Sharptown town, Maryland",444,417,27,754,24,71650
"Silver Hill CDP, Maryland",3474,3348,126,5455,24,72350
"Silver Spring CDP, Maryland",51043,48623,2420,81808,24,72450
"Smith Island CDP, Maryland",169,155,14,357,24,72887
"Smithsburg town, Maryland",1548,1496,52,3028,24,72900
"Snow Hill town, Maryland",1257,1126,131,2359,24,73075
"Solomons CDP, Maryland",654,654,0,2242,24,73325
"Somerset town, Maryland",508,505,3,1028,24,73350
"South Kensington CDP, Maryland",4249,4154,95,8371,24,73600
"South Laurel CDP, Maryland",16448,15570,878,28427,24,73650
"Spencerville CDP, Maryland",754,754,0,1277,24,74050
"Springdale CDP, Maryland",2828,2681,147,4950,24,74282
"Spring Gap CDP, Maryland",28,28,0,42,24,74350
"Spring Ridge CDP, Maryland",3462,3359,103,5691,24,74560
"Stevensville CDP, Maryland",4771,4546,225,8485,24,75025
"Still Pond CDP, Maryland",55,55,0,126,24,75150
"Stockton CDP, Maryland",19,19,0,75,24,75200
"Sudlersville town, Maryland",177,168,9,379,24,75650
"Suitland CDP, Maryland",14944,13859,1085,25839,24,75725
"Summerfield CDP, Maryland",9232,8621,611,15940,24,75810
"Swanton CDP, Maryland",0,0,0,0,24,76450
"Sykesville town, Maryland",2349,2309,40,4305,24,76550
"Takoma Park city, Maryland",9789,9290,499,17542,24,76650
"Tall Timbers CDP, Maryland",323,266,57,480,24,76675
"Taneytown city, Maryland",3252,3116,136,7234,24,76725
"Taylors Island CDP, Maryland",48,48,0,109,24,76925
"Temple Hills CDP, Maryland",4659,4110,549,8310,24,77100
"Templeville town, Maryland",86,72,14,182,24,77200
"Ten Mile Creek CDP, Maryland",285,256,29,1156,24,77262
"Thurmont town, Maryland",3616,3527,89,6313,24,77825
"Tilghman Island CDP, Maryland",367,362,5,826,24,77912
"Tilghmanton CDP, Maryland",220,140,80,463,24,77925
"Timonium CDP, Maryland",5556,5308,248,10793,24,78050
"Tolchester CDP, Maryland",280,269,11,456,24,78120
"Towson CDP, Maryland",30078,28702,1376,57617,24,78425
"Trappe town, Maryland",600,547,53,1019,24,78575
"Travilah CDP, Maryland",5702,5489,213,10846,24,78650
"Trego-Rohrersville Station CDP, Maryland",169,169,0,245,24,78705
"Tyaskin CDP, Maryland",54,54,0,108,24,79225
"Union Bridge town, Maryland",531,526,5,939,24,79350
"University Park town, Maryland",1332,1323,9,2610,24,79675
"Upper Marlboro town, Maryland",498,485,13,759,24,79875
"Urbana CDP, Maryland",7079,6775,304,13373,24,79900
"Vale Summit CDP, Maryland",89,89,0,105,24,80075
"Vienna town, Maryland",203,203,0,406,24,80600
"Waldorf CDP, Maryland",45783,43137,2646,81077,24,81175
"Walker Mill CDP, Maryland",5157,4846,311,9973,24,81250
"Walkersville town, Maryland",3645,3597,48,6239,24,81275
"Washington Grove town, Maryland",388,378,10,604,24,81675
"Waterview CDP, Maryland",0,0,0,0,24,81925
"West Denton CDP, Maryland",49,49,0,49,24,82625
"Westernport town, Maryland",821,771,50,1993,24,82750
"West Laurel CDP, Maryland",2510,2439,71,4332,24,83025
"Westminster city, Maryland",10332,9873,459,20099,24,83100
"West Ocean City CDP, Maryland",2986,2687,299,5246,24,83225
"Westphalia CDP, Maryland",7082,6586,496,11260,24,83290
"West Pocomoke CDP, Maryland",250,243,7,534,24,83337
"Whaleyville CDP, Maryland",88,88,0,116,24,83746
"Wheaton CDP, Maryland",29961,28178,1783,52775,24,83775
"Whitehaven CDP, Maryland",0,0,0,163,24,84225
"White Marsh CDP, Maryland",5580,5459,121,10337,24,84350
"White Oak CDP, Maryland",8401,7786,615,15489,24,84375
"Wildewood CDP, Maryland",3715,3643,72,7436,24,84784
"Willards town, Maryland",659,576,83,1161,24,84950
"Williamsport town, Maryland",923,885,38,1915,24,85100
"Williston CDP, Maryland",131,131,0,153,24,85175
"Wilson-Conococheague CDP, Maryland",871,845,26,1694,24,85395
"Woodland CDP, Maryland",29,29,0,42,24,86275
"Woodlawn CDP (Baltimore County), Maryland",21661,20485,1176,42239,24,86475
"Woodlawn CDP (Prince George's County), Maryland",4000,3505,495,7515,24,86525
"Woodmore CDP, Maryland",2751,2551,200,4375,24,86710
"Woodsboro town, Maryland",743,730,13,1240,24,86750
"Worton CDP, Maryland",97,97,0,105,24,87000
"Yarrowsburg CDP, Maryland",157,115,42,172,24,87150
"Zihlman CDP, Maryland",123,123,0,316,24,87275
"Abington CDP, Massachusetts",9958,9491,467,17003,25,00135
"Acushnet Center CDP, Massachusetts",1698,1565,133,3164,25,00530
"Adams CDP, Massachusetts",2786,2612,174,5722,25,00590
"Agawam Town city, Massachusetts",15528,14719,809,28606,25,00840
"Amesbury Town city, Massachusetts",10310,9867,443,17279,25,01260
"Amherst Town city, Massachusetts",15894,14412,1482,33389,25,01370
"Andover CDP, Massachusetts",5345,4962,383,9419,25,01430
"Arlington CDP, Massachusetts",27342,26368,974,45906,25,01640
"Athol CDP, Massachusetts",4634,4258,376,9148,25,02515
"Attleboro city, Massachusetts",26331,25185,1146,46384,25,02690
"Ayer CDP, Massachusetts",1670,1655,15,2969,25,03040
"Baldwinville CDP, Massachusetts",896,707,189,2286,25,03355
"Barnstable Town city, Massachusetts",28026,27164,862,48922,25,03690
"Barre CDP, Massachusetts",400,373,27,594,25,03705
"Belchertown CDP, Massachusetts",1443,1430,13,2648,25,04790
"Bellingham CDP, Massachusetts",2680,2402,278,4636,25,04965
"Belmont CDP, Massachusetts",14853,14153,700,26997,25,05105
"Beverly city, Massachusetts",23940,23152,788,42414,25,05595
"Blandford CDP, Massachusetts",178,178,0,349,25,06050
"Bliss Corner CDP, Massachusetts",2883,2871,12,5591,25,06170
"Boston city, Massachusetts",398636,372385,26251,665945,25,07000
"Bourne CDP, Massachusetts",638,638,0,1782,25,07140
"Boxford CDP, Massachusetts",1237,1168,69,2714,25,07385
"Braintree Town city, Massachusetts",22285,21406,879,38748,25,07740
"Brewster CDP, Massachusetts",708,658,50,1739,25,07945
"Bridgewater Town city, Massachusetts",15434,14692,742,28531,25,08130
"Brockton city, Massachusetts",56142,51560,4582,104713,25,09000
"Brookfield CDP, Massachusetts",583,567,16,948,25,09070
"Brookline CDP, Massachusetts",37266,35966,1300,62698,25,09210
"Burlington CDP, Massachusetts",14339,13841,498,26169,25,09875
"Buzzards Bay CDP, Massachusetts",1713,1672,41,2993,25,10015
"Cambridge city, Massachusetts",73356,70910,2446,117962,25,11000
"Cedar Crest CDP, Massachusetts",1459,1382,77,2460,25,11945
"Chatham CDP, Massachusetts",532,486,46,1637,25,12960
"Chelsea city, Massachusetts",21727,19786,1941,39890,25,13205
"Cheshire CDP, Massachusetts",236,236,0,547,25,13310
"Chester CDP, Massachusetts",372,358,14,795,25,13450
"Chicopee city, Massachusetts",28362,26626,1736,55441,25,13660
"Clinton CDP, Massachusetts",4641,4454,187,7361,25,14430
"Cochituate CDP, Massachusetts",3535,3441,94,6937,25,14570
"Cordaville CDP, Massachusetts",1673,1628,45,2884,25,15340
"Danvers CDP, Massachusetts",16906,16077,829,27910,25,16285
"Dedham CDP, Massachusetts",14869,14285,584,25150,25,16530
"Deerfield CDP, Massachusetts",310,287,23,486,25,16635
"Dennis CDP, Massachusetts",834,788,46,1898,25,16740
"Dennis Port CDP, Massachusetts",1715,1516,199,3300,25,16810
"Devens CDP, Massachusetts",489,484,5,1763,25,16840
"Dover CDP, Massachusetts",1222,1052,170,2512,25,17370
"Duxbury CDP, Massachusetts",1057,998,59,1761,25,17860
"East Brookfield CDP, Massachusetts",750,740,10,1345,25,18595
"East Dennis CDP, Massachusetts",1782,1695,87,3711,25,18840
"East Douglas CDP, Massachusetts",1354,1337,17,2562,25,18875
"East Falmouth CDP, Massachusetts",3363,3206,157,6558,25,18980
"Easthampton Town city, Massachusetts",8548,8089,459,16136,25,19370
"East Harwich CDP, Massachusetts",3187,3112,75,5693,25,19400
"East Pepperell CDP, Massachusetts",1127,1076,51,1999,25,20310
"East Sandwich CDP, Massachusetts",1664,1608,56,3787,25,20380
"Edgartown CDP, Massachusetts",357,357,0,610,25,21115
"Essex CDP, Massachusetts",1090,1078,12,1880,25,21815
"Everett city, Massachusetts",28284,26430,1854,48685,25,21990
"Fall River city, Massachusetts",46619,42720,3899,93638,25,23000
"Falmouth CDP, Massachusetts",1580,1519,61,3883,25,23070
"Fiskdale CDP, Massachusetts",1550,1416,134,2827,25,23840
"Fitchburg city, Massachusetts",22464,20745,1719,41621,25,23875
"Forestdale CDP, Massachusetts",2461,2408,53,3912,25,24190
"Foxborough CDP, Massachusetts",3324,3210,114,6312,25,24855
"Framingham city, Massachusetts",41071,39033,2038,71805,25,24960
"Franklin Town city, Massachusetts",19581,18526,1055,32777,25,25172
"Gardner city, Massachusetts",10151,9500,651,21090,25,25485
"Gloucester city, Massachusetts",16486,15532,954,29830,25,26150
"Granby CDP, Massachusetts",766,733,33,1176,25,26500
"Great Barrington CDP, Massachusetts",993,959,34,1890,25,26780
"Greenfield city, Massachusetts",8398,7948,450,17674,25,27060
"Green Harbor CDP, Massachusetts",497,435,62,1174,25,27130
"Groton CDP, Massachusetts",787,760,27,1472,25,27445
"Hanscom AFB CDP, Massachusetts",288,285,3,1784,25,28425
"Hanson CDP, Massachusetts",1064,1002,62,2087,25,28460
"Harwich Center CDP, Massachusetts",633,588,45,1419,25,29055
"Harwich Port CDP, Massachusetts",1093,1046,47,2252,25,29090
"Hatfield CDP, Massachusetts",753,742,11,1331,25,29230
"Haverhill city, Massachusetts",38041,35756,2285,67273,25,29405
"Hingham CDP, Massachusetts",2650,2537,113,5606,25,30175
"Holbrook CDP, Massachusetts",6446,6200,246,11338,25,30420
"Holland CDP, Massachusetts",803,778,25,1452,25,30630
"Holyoke city, Massachusetts",16614,15479,1135,38210,25,30840
"Hopedale CDP, Massachusetts",2323,2198,125,4137,25,30980
"Hopkinton CDP, Massachusetts",1858,1781,77,3298,25,31050
"Housatonic CDP, Massachusetts",758,758,0,985,25,31295
"Hudson CDP, Massachusetts",8557,8191,366,15496,25,31575
"Hull CDP, Massachusetts",6444,6188,256,10116,25,31680
"Huntington CDP, Massachusetts",458,442,16,865,25,31750
"Ipswich CDP, Massachusetts",2901,2821,80,4872,25,32275
"Kingston CDP, Massachusetts",3753,3667,86,6090,25,33185
"Lawrence city, Massachusetts",45922,41147,4775,88067,25,34550
"Lee CDP, Massachusetts",842,793,49,1507,25,34620
"Lenox CDP, Massachusetts",689,689,0,1999,25,34935
"Lenox Dale CDP, Massachusetts",180,109,71,255,25,35040
"Leominster city, Massachusetts",24296,22841,1455,43620,25,35075
"Lexington CDP, Massachusetts",16981,16350,631,34221,25,35250
"Littleton Common CDP, Massachusetts",1495,1359,136,2870,25,36020
"Longmeadow CDP, Massachusetts",7326,6850,476,15789,25,36335
"Lowell city, Massachusetts",62610,59027,3583,114737,25,37000
"Lunenburg CDP, Massachusetts",1002,978,24,2149,25,37385
"Lynn city, Massachusetts",53238,50211,3027,100653,25,37490
"Lynnfield CDP, Massachusetts",6835,6530,305,12925,25,37595
"Madaket CDP, Massachusetts",192,192,0,318,25,37735
"Malden city, Massachusetts",38386,35839,2547,65463,25,37875
"Mansfield Center CDP, Massachusetts",4402,4174,228,7690,25,38230
"Marblehead CDP, Massachusetts",11151,10787,364,20350,25,38435
"Marion Center CDP, Massachusetts",422,388,34,980,25,38575
"Marlborough city, Massachusetts",24234,22933,1301,41391,25,38715
"Marshfield CDP, Massachusetts",2580,2457,123,4868,25,38820
"Marshfield Hills CDP, Massachusetts",1361,1361,0,2458,25,38960
"Mashpee Neck CDP, Massachusetts",682,664,18,1270,25,39152
"Mattapoisett Center CDP, Massachusetts",1197,1150,47,2645,25,39485
"Maynard CDP, Massachusetts",6267,5996,271,10671,25,39660
"Medfield CDP, Massachusetts",3462,3272,190,6318,25,39730
"Medford city, Massachusetts",38983,37347,1636,61748,25,39835
"Melrose city, Massachusetts",16903,16244,659,29477,25,40115
"Methuen Town city, Massachusetts",29591,27711,1880,52812,25,40710
"Middleborough Center CDP, Massachusetts",4419,4257,162,7807,25,40885
"Milford CDP, Massachusetts",16049,15103,946,27569,25,41200
"Millers Falls CDP, Massachusetts",560,536,24,1061,25,41410
"Millis-Clicquot CDP, Massachusetts",2779,2728,51,4718,25,41532
"Milton CDP, Massachusetts",15411,14827,584,28450,25,41725
"Monomoscoy Island CDP, Massachusetts",68,68,0,123,25,41960
"Monson Center CDP, Massachusetts",877,731,146,1673,25,42180
"Monument Beach CDP, Massachusetts",1575,1541,34,3024,25,42670
"Nahant CDP, Massachusetts",1970,1887,83,3336,25,43615
"Nantucket CDP, Massachusetts",6011,5635,376,10479,25,43755
"Needham CDP, Massachusetts",16466,15606,860,31957,25,44140
"New Bedford city, Massachusetts",49938,46339,3599,100620,25,45000
"Newburyport city, Massachusetts",10029,9454,575,18356,25,45245
"New Seabury CDP, Massachusetts",244,233,11,738,25,45500
"Newton city, Massachusetts",47676,46004,1672,88453,25,45560
"North Adams city, Massachusetts",6433,6113,320,12937,25,46225
"Northampton city, Massachusetts",15150,14304,846,28245,25,46330
"North Attleborough Town city, Massachusetts",17938,16884,1054,30750,25,46598
"Northborough CDP, Massachusetts",3925,3769,156,6677,25,46785
"North Brookfield CDP, Massachusetts",1405,1377,28,2437,25,47100
"North Eastham CDP, Massachusetts",859,769,90,1971,25,47590
"North Falmouth CDP, Massachusetts",987,932,55,2318,25,47730
"Northfield CDP, Massachusetts",554,542,12,908,25,47800
"North Lakeville CDP, Massachusetts",1948,1886,62,3635,25,48220
"North Pembroke CDP, Massachusetts",1845,1816,29,3954,25,48710
"North Plymouth CDP, Massachusetts",2840,2325,515,4418,25,48780
"North Scituate CDP, Massachusetts",3163,2987,176,5675,25,49165
"North Seekonk CDP, Massachusetts",1547,1448,99,2726,25,49200
"Northwest Harwich CDP, Massachusetts",2030,1771,259,4076,25,49700
"North Westport CDP, Massachusetts",2484,2443,41,4660,25,49710
"Norton Center CDP, Massachusetts",1313,1259,54,2580,25,50005
"Norwood CDP, Massachusetts",18596,17925,671,31343,25,50285
"Oak Bluffs CDP, Massachusetts",606,583,23,1521,25,50425
"Ocean Bluff-Brant Rock CDP, Massachusetts",2827,2650,177,4637,25,50862
"Ocean Grove CDP, Massachusetts",1411,1307,104,2691,25,50880
"Onset CDP, Massachusetts",746,533,213,1326,25,51160
"Orange CDP, Massachusetts",1829,1592,237,3731,25,51230
"Orleans CDP, Massachusetts",767,767,0,1665,25,51405
"Oxford CDP, Massachusetts",2911,2863,48,5410,25,51790
"Palmer Town city, Massachusetts",6477,6202,275,12422,25,52144
"Peabody city, Massachusetts",28966,27678,1288,54204,25,52490
"Pepperell CDP, Massachusetts",1183,1105,78,2205,25,52770
"Petersham CDP, Massachusetts",147,145,2,275,25,53085
"Pinehurst CDP, Massachusetts",3586,3448,138,6426,25,53680
"Pittsfield city, Massachusetts",23646,21970,1676,43730,25,53960
"Plymouth CDP, Massachusetts",4754,4470,284,7649,25,54275
"Pocasset CDP, Massachusetts",1279,1267,12,2627,25,54450
"Popponesset CDP, Massachusetts",260,223,37,366,25,55070
"Popponesset Island CDP, Massachusetts",39,39,0,70,25,55090
"Provincetown CDP, Massachusetts",2144,1965,179,3433,25,55535
"Quincy city, Massachusetts",61688,57575,4113,100981,25,55745
"Randolph Town city, Massachusetts",19979,18329,1650,34691,25,56000
"Raynham Center CDP, Massachusetts",2743,2541,202,5074,25,56095
"Reading CDP, Massachusetts",13693,13315,378,25415,25,56165
"Revere city, Massachusetts",34598,32062,2536,60577,25,56585
"Rockport CDP, Massachusetts",2556,2362,194,4943,25,57845
"Rowley CDP, Massachusetts",1018,1018,0,1642,25,58370
"Russell CDP, Massachusetts",283,283,0,573,25,58615
"Rutland CDP, Massachusetts",855,837,18,1690,25,58790
"Sagamore CDP, Massachusetts",2656,2577,79,3966,25,58965
"Salem city, Massachusetts",26945,25595,1350,44541,25,59105
"Salisbury CDP, Massachusetts",3058,2962,96,5269,25,59210
"Sandwich CDP, Massachusetts",1525,1458,67,2948,25,59700
"Saugus CDP, Massachusetts",15852,15314,538,28566,25,60050
"Scituate CDP, Massachusetts",2518,2466,52,5442,25,60295
"Seabrook CDP, Massachusetts",366,366,0,595,25,60505
"Seconsett Island CDP, Massachusetts",53,45,8,137,25,60627
"Sharon CDP, Massachusetts",3087,2991,96,5983,25,60820
"Shelburne Falls CDP, Massachusetts",869,807,62,1699,25,61205
"Shirley CDP, Massachusetts",878,817,61,1359,25,61555
"Siasconset CDP, Massachusetts",26,26,0,115,25,61940
"Smith Mills CDP, Massachusetts",2627,2565,62,4556,25,62300
"Somerset CDP, Massachusetts",9636,9365,271,18266,25,62465
"Somerville city, Massachusetts",57585,55982,1603,80464,25,62535
"South Ashburnham CDP, Massachusetts",583,583,0,1049,25,62780
"Southbridge Town city, Massachusetts",9116,8278,838,17669,25,63345
"South Deerfield CDP, Massachusetts",1252,1179,73,1953,25,63620
"South Dennis CDP, Massachusetts",1678,1627,51,3101,25,63655
"South Duxbury CDP, Massachusetts",1872,1777,95,3409,25,63690
"South Lancaster CDP, Massachusetts",931,754,177,1642,25,64460
"South Yarmouth CDP, Massachusetts",6096,5662,434,11805,25,66035
"Spencer CDP, Massachusetts",3080,2838,242,5637,25,66070
"Springfield city, Massachusetts",69492,63428,6064,155305,25,67000
"Stoneham CDP, Massachusetts",13537,13096,441,22992,25,67700
"Sturbridge CDP, Massachusetts",1176,1176,0,2222,25,68120
"Swampscott CDP, Massachusetts",8578,8114,464,15125,25,68680
"Taunton city, Massachusetts",32082,30303,1779,59436,25,69170
"Teaticket CDP, Massachusetts",727,717,10,1561,25,69205
"The Pinehills CDP, Massachusetts",1776,1759,17,5127,25,69585
"Topsfield CDP, Massachusetts",1432,1344,88,2799,25,70115
"Townsend CDP, Massachusetts",553,535,18,1131,25,70325
"Turners Falls CDP, Massachusetts",2203,2140,63,3838,25,70815
"Upton CDP, Massachusetts",1538,1440,98,2596,25,71445
"Vineyard Haven CDP, Massachusetts",1336,1287,49,2367,25,71970
"Wakefield CDP, Massachusetts",15367,14747,620,27054,25,72250
"Walpole CDP, Massachusetts",3564,3448,116,6373,25,72460
"Waltham city, Massachusetts",39456,38237,1219,64711,25,72600
"Ware CDP, Massachusetts",3100,2719,381,6253,25,72845
"Wareham Center CDP, Massachusetts",1230,1170,60,2654,25,73020
"Warren CDP, Massachusetts",331,231,100,567,25,73055
"Watertown Town city, Massachusetts",22558,21263,1295,35181,25,73440
"Webster CDP, Massachusetts",6563,5919,644,12264,25,73930
"Wellesley CDP, Massachusetts",13360,12821,539,29862,25,74210
"Westborough CDP, Massachusetts",2616,2555,61,4381,25,75050
"West Brookfield CDP, Massachusetts",686,592,94,1532,25,75365
"West Chatham CDP, Massachusetts",728,683,45,1633,25,75505
"West Concord CDP, Massachusetts",2703,2567,136,6450,25,75680
"West Dennis CDP, Massachusetts",1490,1465,25,2732,25,75820
"West Falmouth CDP, Massachusetts",875,799,76,1793,25,75960
"Westfield city, Massachusetts",20130,19231,899,40794,25,76030
"West Springfield Town city, Massachusetts",16029,15096,933,28755,25,77890
"West Wareham CDP, Massachusetts",1163,1098,65,2605,25,78410
"West Warren CDP, Massachusetts",485,396,89,826,25,78445
"West Yarmouth CDP, Massachusetts",2760,2605,155,6098,25,78795
"Weweantic CDP, Massachusetts",879,769,110,1593,25,78850
"Weymouth Town city, Massachusetts",34034,32421,1613,57300,25,78972
"White Island Shores CDP, Massachusetts",1183,1119,64,2223,25,79390
"Whitinsville CDP, Massachusetts",4165,3963,202,7273,25,79495
"Wilbraham CDP, Massachusetts",1694,1629,65,3839,25,79705
"Williamstown CDP, Massachusetts",2401,2385,16,4498,25,79950
"Wilmington CDP, Massachusetts",13457,12863,594,23191,25,80195
"Winchendon CDP, Massachusetts",2204,2054,150,4461,25,80370
"Winchester CDP, Massachusetts",11729,11332,397,22809,25,80545
"Winthrop Town city, Massachusetts",11271,10678,593,19031,25,81005
"Woburn city, Massachusetts",24908,23070,1838,40992,25,81035
"Woods Hole CDP, Massachusetts",470,415,55,992,25,81245
"Worcester city, Massachusetts",107962,100829,7133,204191,25,82000
"Yarmouth Port CDP, Massachusetts",2839,2782,57,5971,25,82595
"Addison village, Michigan",266,247,19,632,26,00380
"Adrian city, Michigan",8860,8437,423,20607,26,00440
"Advance CDP, Michigan",161,158,3,371,26,00480
"Ahmeek village, Michigan",46,44,2,87,26,00620
"Akron village, Michigan",174,169,5,330,26,00700
"Alanson village, Michigan",429,377,52,862,26,00860
"Alba CDP, Michigan",255,255,0,430,26,00900
"Albion city, Michigan",3051,2656,395,7732,26,00980
"Alden CDP, Michigan",50,50,0,112,26,01060
"Algonac city, Michigan",2029,1907,122,4167,26,01180
"Allegan city, Michigan",2034,1979,55,5180,26,01260
"Allen village, Michigan",93,70,23,213,26,01300
"Allendale CDP, Michigan",15283,14138,1145,25206,26,01340
"Allen Park city, Michigan",14857,13966,891,28395,26,01380
"Alma city, Michigan",4516,4195,321,9436,26,01540
"Almont village, Michigan",1575,1440,135,2826,26,01660
"Alpena city, Michigan",4846,4415,431,10200,26,01740
"Alpha village, Michigan",100,94,6,210,26,01800
"Amasa CDP, Michigan",116,108,8,257,26,01960
"Ann Arbor city, Michigan",66108,63693,2415,122216,26,03000
"Applegate village, Michigan",126,115,11,233,26,03200
"Arcadia CDP, Michigan",44,44,0,149,26,03300
"Argentine CDP, Michigan",1090,1022,68,2451,26,03400
"Armada village, Michigan",927,898,29,2039,26,03520
"Ashley village, Michigan",229,214,15,475,26,03740
"Athens village, Michigan",576,562,14,1103,26,03880
"Atlanta CDP, Michigan",189,181,8,576,26,03920
"Atlantic Mine CDP, Michigan",267,257,10,552,26,03960
"Attica CDP, Michigan",523,510,13,1009,26,04020
"Auburn city, Michigan",1058,1029,29,1921,26,04080
"Auburn Hills city, Michigan",14874,14122,752,24593,26,04105
"Au Gres city, Michigan",373,292,81,930,26,04120
"Augusta village, Michigan",554,504,50,955,26,04160
"Au Sable CDP, Michigan",695,653,42,1667,26,04280
"Bad Axe city, Michigan",1296,1208,88,3025,26,04740
"Baldwin village, Michigan",267,250,17,1030,26,04940
"Bancroft village, Michigan",257,250,7,500,26,05080
"Bangor city, Michigan",927,865,62,2068,26,05140
"Baraga village, Michigan",451,431,20,2020,26,05320
"Barnes Lake CDP, Michigan",313,313,0,622,26,05466
"Baroda village, Michigan",519,496,23,896,26,05500
"Barryton village, Michigan",140,132,8,385,26,05580
"Barton Hills village, Michigan",169,166,3,444,26,05660
"Bath CDP, Michigan",1789,1704,85,3133,26,05880
"Battle Creek city, Michigan",25223,23297,1926,52469,26,05920
"Bay City city, Michigan",16019,15018,1001,32664,26,06020
"Bay Port CDP, Michigan",263,236,27,591,26,06120
"Bay Shore CDP, Michigan",304,297,7,533,26,06180
"Bay View CDP, Michigan",53,53,0,141,26,06260
"Beal City CDP, Michigan",173,166,7,294,26,06360
"Bear Lake CDP, Michigan",92,81,11,301,26,06430
"Bear Lake village, Michigan",119,106,13,247,26,06460
"Beaverton city, Michigan",472,437,35,1194,26,06660
"Beecher CDP, Michigan",3753,2913,840,9085,26,06820
"Beechwood CDP, Michigan",1713,1407,306,2803,26,06880
"Belding city, Michigan",2890,2658,232,5942,26,06900
"Bellaire village, Michigan",435,430,5,955,26,06980
"Belleville city, Michigan",1965,1797,168,3979,26,07020
"Bellevue village, Michigan",593,552,41,1281,26,07060
"Bendon CDP, Michigan",99,92,7,296,26,07220
"Benton Harbor city, Michigan",4342,3464,878,9101,26,07520
"Benton Heights CDP, Michigan",1604,1420,184,3763,26,07540
"Benzonia village, Michigan",358,328,30,679,26,07580
"Bergland CDP, Michigan",47,47,0,111,26,07620
"Berkley city, Michigan",9490,9203,287,15150,26,07660
"Berrien Springs village, Michigan",1057,956,101,2022,26,07860
"Bessemer city, Michigan",882,843,39,1708,26,07960
"Beulah village, Michigan",52,49,3,200,26,08100
"Beverly Hills village, Michigan",5468,5362,106,10550,26,08160
"Big Bay CDP, Michigan",92,92,0,468,26,08180
"Big Rapids city, Michigan",4333,4020,313,7915,26,08300
"Bingham Farms village, Michigan",500,484,16,1623,26,08460
"Birch Run village, Michigan",578,563,15,1180,26,08540
"Birmingham city, Michigan",11730,11243,487,21738,26,08640
"Blissfield village, Michigan",1820,1724,96,3214,26,09000
"Bloomfield Hills city, Michigan",1756,1679,77,4402,26,09180
"Bloomingdale village, Michigan",227,210,17,513,26,09220
"Boon CDP, Michigan",23,23,0,56,26,09560
"Boyne City city, Michigan",2085,1956,129,3821,26,09820
"Boyne Falls village, Michigan",159,153,6,341,26,09840
"Breckenridge village, Michigan",661,607,54,1413,26,10160
"Breedsville village, Michigan",114,111,3,300,26,10180
"Brethren CDP, Michigan",134,132,2,392,26,10300
"Bridgeport CDP, Michigan",2481,2349,132,6495,26,10440
"Bridgman city, Michigan",1115,1096,19,2378,26,10580
"Brighton city, Michigan",4120,4005,115,7486,26,10620
"Brimley CDP, Michigan",160,146,14,382,26,10680
"Britton village, Michigan",309,293,16,638,26,10760
"Bronson city, Michigan",988,975,13,1992,26,10860
"Brooklyn village, Michigan",366,358,8,943,26,11000
"Brown City city, Michigan",504,437,67,1131,26,11180
"Brownlee Park CDP, Michigan",862,843,19,1931,26,11200
"Bruce Crossing CDP, Michigan",56,52,4,257,26,11320
"Brutus CDP, Michigan",127,127,0,211,26,11380
"Buchanan city, Michigan",2279,2252,27,4276,26,11400
"Buckley village, Michigan",381,357,24,874,26,11480
"Buena Vista CDP, Michigan",2090,1799,291,6013,26,11555
"Burlington village, Michigan",105,99,6,233,26,11800
"Burr Oak village, Michigan",438,410,28,820,26,11920
"Burt CDP, Michigan",591,579,12,1271,26,12000
"Burton city, Michigan",14328,13315,1013,29568,26,12060
"Byron village, Michigan",316,301,15,604,26,12260
"Byron Center CDP, Michigan",3417,3342,75,6988,26,12280
"Caberfae CDP, Michigan",36,36,0,72,26,12290
"Cadillac city, Michigan",4553,4235,318,10400,26,12320
"Caledonia village, Michigan",1094,1086,8,1808,26,12480
"Calumet village, Michigan",299,241,58,719,26,12580
"Cambria CDP, Michigan",114,109,5,191,26,12680
"Camden village, Michigan",304,283,21,699,26,12760
"Canada Creek Ranch CDP, Michigan",87,82,5,314,26,12980
"Canadian Lakes CDP, Michigan",598,592,6,2578,26,13010
"Cannonsburg CDP, Michigan",103,103,0,196,26,13100
"Capac village, Michigan",996,916,80,1920,26,13140
"Carleton village, Michigan",1092,997,95,2655,26,13220
"Carney village, Michigan",103,92,11,204,26,13400
"Caro city, Michigan",1743,1563,180,4294,26,13420
"Carp Lake CDP, Michigan",132,121,11,422,26,13480
"Carson City city, Michigan",432,414,18,1006,26,13600
"Carsonville village, Michigan",194,176,18,400,26,13620
"Caseville city, Michigan",270,260,10,674,26,13760
"Casnovia village, Michigan",222,210,12,361,26,13820
"Caspian city, Michigan",257,234,23,611,26,13860
"Cass City village, Michigan",959,876,83,2274,26,13880
"Cassopolis village, Michigan",811,686,125,1750,26,13900
"Cedar CDP, Michigan",20,20,0,41,26,14020
"Cedar Springs city, Michigan",1921,1785,136,3646,26,14200
"Cement City village, Michigan",209,199,10,551,26,14260
"Center Line city, Michigan",4454,4167,287,8493,26,14320
"Central Lake village, Michigan",381,369,12,887,26,14400
"Centreville village, Michigan",498,444,54,1313,26,14460
"Charlevoix city, Michigan",1225,1167,58,2474,26,14780
"Charlotte city, Michigan",4430,4154,276,9273,26,14820
"Chassell CDP, Michigan",365,365,0,801,26,14900
"Chatham village, Michigan",51,45,6,116,26,14940
"Cheboygan city, Michigan",1940,1755,185,4782,26,15000
"Chelsea city, Michigan",2530,2496,34,5440,26,15020
"Chesaning village, Michigan",1101,1011,90,2450,26,15140
"Chums Corner CDP, Michigan",356,342,14,831,26,15715
"Clare city, Michigan",1442,1346,96,3367,26,15920
"Clarksville village, Michigan",196,189,7,361,26,16140
"Clawson city, Michigan",6867,6577,290,11388,26,16160
"Clayton village, Michigan",92,89,3,204,26,16280
"Clifford village, Michigan",129,116,13,269,26,16420
"Climax village, Michigan",372,286,86,797,26,16440
"Clinton village, Michigan",1754,1624,130,2929,26,16480
"Clio city, Michigan",1078,1000,78,2275,26,16620
"Coldwater city, Michigan",5537,5324,213,13704,26,17020
"Coleman city, Michigan",429,407,22,1012,26,17100
"Coloma city, Michigan",597,572,25,1171,26,17320
"Colon village, Michigan",639,594,45,1391,26,17360
"Columbiaville village, Michigan",396,339,57,774,26,17460
"Comstock Northwest CDP, Michigan",3067,2976,91,5131,26,17690
"Comstock Park CDP, Michigan",5629,5406,223,10379,26,17700
"Concord village, Michigan",550,527,23,1177,26,17740
"Constantine village, Michigan",1055,1013,42,2214,26,17840
"Conway CDP, Michigan",20,13,7,149,26,17900
"Coopersville city, Michigan",2458,2274,184,4804,26,18020
"Copemish village, Michigan",94,85,9,191,26,18040
"Copper City village, Michigan",97,65,32,229,26,18080
"Copper Harbor CDP, Michigan",27,27,0,100,26,18100
"Corunna city, Michigan",1247,1188,59,3057,26,18300
"Covington CDP, Michigan",49,49,0,109,26,18580
"Cross Village CDP, Michigan",17,16,1,55,26,18880
"Croswell city, Michigan",1314,1172,142,2617,26,18920
"Crystal CDP, Michigan",213,202,11,909,26,19060
"Crystal Downs Country Club CDP, Michigan",20,20,0,61,26,19135
"Crystal Falls city, Michigan",655,636,19,1773,26,19140
"Crystal Mountain CDP, Michigan",51,51,0,130,26,19195
"Custer village, Michigan",152,147,5,302,26,19420
"Cutlerville CDP, Michigan",10610,10133,477,19281,26,19500
"Daggett village, Michigan",79,77,2,200,26,19560
"Dansville village, Michigan",288,270,18,530,26,19780
"Davison city, Michigan",2360,2167,193,5114,26,19880
"Dearborn city, Michigan",46222,43072,3150,108414,26,21000
"Dearborn Heights city, Michigan",27299,25053,2246,62474,26,21020
"Decatur village, Michigan",807,751,56,1886,26,21040
"Deckerville village, Michigan",483,423,60,1059,26,21100
"Deerfield village, Michigan",507,489,18,917,26,21180
"Delton CDP, Michigan",263,263,0,562,26,21560
"De Tour Village village, Michigan",76,73,3,226,26,21780
"Detroit city, Michigan",271897,232004,39893,636787,26,22000
"Detroit Beach CDP, Michigan",1131,1115,16,2211,26,22040
"DeWitt city, Michigan",2617,2504,113,4779,26,22120
"Dexter city, Michigan",2328,2264,64,4505,26,22160
"Dimondale village, Michigan",846,829,17,1619,26,22380
"Dodgeville CDP, Michigan",227,227,0,463,26,22500
"Dollar Bay CDP, Michigan",558,543,15,1184,26,22520
"Dorr CDP, Michigan",1847,1805,42,3952,26,22660
"Douglas city, Michigan",516,508,8,1136,26,22740
"Dowagiac city, Michigan",2829,2516,313,5680,26,22880
"Dowling CDP, Michigan",144,137,7,329,26,22900
"Dryden village, Michigan",488,437,51,1218,26,23140
"Dundee village, Michigan",3193,2953,240,5408,26,23380
"Durand city, Michigan",1770,1690,80,3495,26,23500
"Eagle village, Michigan",62,62,0,100,26,23560
"Eagle Harbor CDP, Michigan",33,33,0,134,26,23600
"Eagle River CDP, Michigan",19,14,5,63,26,23740
"East Grand Rapids city, Michigan",5768,5658,110,11385,26,23980
"East Jordan city, Michigan",1171,1127,44,1876,26,24020
"Eastlake village, Michigan",129,126,3,281,26,24060
"East Lansing city, Michigan",23580,21998,1582,45403,26,24120
"Eastpointe city, Michigan",16611,14600,2011,34087,26,24290
"Eastport CDP, Michigan",118,106,12,351,26,24300
"East Tawas city, Michigan",1050,943,107,2677,26,24420
"Eastwood CDP, Michigan",3752,3453,299,6497,26,24500
"Eaton Rapids city, Michigan",2610,2537,73,5201,26,24540
"Eau Claire village, Michigan",319,310,9,604,26,24580
"Ecorse city, Michigan",3638,3294,344,9292,26,24740
"Edgemont Park CDP, Michigan",1368,1273,95,2444,26,24880
"Edmore village, Michigan",576,547,29,1474,26,25000
"Edwardsburg village, Michigan",683,646,37,1265,26,25040
"Elberta village, Michigan",75,72,3,225,26,25180
"Elk Rapids village, Michigan",748,744,4,1568,26,25320
"Elkton village, Michigan",330,320,10,746,26,25360
"Ellsworth village, Michigan",196,188,8,332,26,25420
"Elm Hall CDP, Michigan",67,61,6,201,26,25580
"Elsie village, Michigan",471,353,118,1000,26,25780
"Emmett village, Michigan",138,130,8,244,26,25940
"Empire village, Michigan",150,148,2,392,26,25980
"Escanaba city, Michigan",5252,4873,379,12403,26,26360
"Essexville city, Michigan",1537,1492,45,3372,26,26420
"Estral Beach village, Michigan",203,198,5,413,26,26460
"Eureka CDP, Michigan",61,61,0,103,26,26500
"Evart city, Michigan",702,619,83,1739,26,26640
"Ewen CDP, Michigan",123,123,0,303,26,26820
"Fairgrove village, Michigan",185,180,5,501,26,27080
"Fair Plain CDP, Michigan",3525,2802,723,6882,26,27160
"Falmouth CDP, Michigan",107,101,6,253,26,27320
"Farmington city, Michigan",6519,6322,197,11486,26,27380
"Farmington Hills city, Michigan",47512,45241,2271,83562,26,27440
"Farwell village, Michigan",411,384,27,1033,26,27500
"Fennville city, Michigan",885,843,42,1876,26,27740
"Fenton city, Michigan",6569,6262,307,11967,26,27760
"Ferndale city, Michigan",14118,13598,520,19264,26,27880
"Ferrysburg city, Michigan",1423,1391,32,2959,26,27960
"Fife Lake village, Michigan",182,177,5,338,26,28000
"Filer City CDP, Michigan",117,109,8,172,26,28060
"Flat Rock city, Michigan",5235,4835,400,10448,26,28360
"Flint city, Michigan",35172,28981,6191,81863,26,29000
"Flushing city, Michigan",3934,3673,261,8349,26,29200
"Forest Hills CDP, Michigan",14272,13986,286,28425,26,29580
"Forestville village, Michigan",33,33,0,132,26,29660
"Fostoria CDP, Michigan",571,530,41,1023,26,29920
"Fountain village, Michigan",81,74,7,214,26,29940
"Fowler village, Michigan",582,582,0,1303,26,30040
"Fowlerville village, Michigan",1405,1332,73,2951,26,30060
"Frankenmuth city, Michigan",2463,2323,140,5064,26,30200
"Frankfort city, Michigan",324,296,28,1104,26,30260
"Franklin village, Michigan",1384,1357,27,2653,26,30340
"Fraser city, Michigan",7939,7555,384,14668,26,30420
"Freeland CDP, Michigan",3137,3065,72,7357,26,30540
"Freeport village, Michigan",352,339,13,713,26,30580
"Free Soil village, Michigan",43,42,1,103,26,30600
"Fremont city, Michigan",2051,1986,65,4510,26,30700
"Fruitport village, Michigan",660,621,39,1388,26,31000
"Fulton CDP, Michigan",59,54,5,137,26,31120
"Gaastra city, Michigan",111,104,7,268,26,31160
"Gagetown village, Michigan",128,119,9,320,26,31180
"Gaines village, Michigan",202,188,14,432,26,31200
"Galesburg city, Michigan",895,842,53,2069,26,31260
"Galien village, Michigan",272,260,12,490,26,31300
"Garden village, Michigan",73,70,3,169,26,31380
"Garden City city, Michigan",14556,13435,1121,27203,26,31420
"Gaylord city, Michigan",1937,1882,55,4261,26,31720
"Gibraltar city, Michigan",2592,2459,133,4950,26,32020
"Gladstone city, Michigan",2314,2227,87,5231,26,32300
"Gladwin city, Michigan",1294,1180,114,3066,26,32320
"Glen Arbor CDP, Michigan",113,113,0,271,26,32360
"Gobles city, Michigan",311,267,44,665,26,32640
"Goodrich village, Michigan",1004,914,90,1991,26,32980
"Grand Beach village, Michigan",122,119,3,377,26,33260
"Grand Blanc city, Michigan",3909,3681,228,8034,26,33280
"Grand Haven city, Michigan",5384,5108,276,10961,26,33340
"Grand Ledge city, Michigan",4079,3859,220,7795,26,33420
"Grand Marais CDP, Michigan",73,73,0,256,26,33440
"Grand Rapids city, Michigan",109903,103778,6125,198096,26,34000
"Grandville city, Michigan",9255,9130,125,16017,26,34160
"Grant city, Michigan",508,448,60,1347,26,34360
"Grass Lake village, Michigan",677,661,16,1222,26,34480
"Grawn CDP, Michigan",509,509,0,852,26,34620
"Grayling city, Michigan",572,532,40,1758,26,34640
"Greenland CDP, Michigan",80,76,4,129,26,34980
"Greenville city, Michigan",4175,3934,241,8866,26,35100
"Greilickville CDP, Michigan",503,493,10,1467,26,35300
"Grosse Pointe city, Michigan",2728,2620,108,5621,26,35480
"Grosse Pointe Farms city, Michigan",5289,5148,141,10018,26,35520
"Grosse Pointe Park city, Michigan",6904,6742,162,11513,26,35540
"Grosse Pointe Woods city, Michigan",8846,8316,530,16338,26,35580
"Gwinn CDP, Michigan",481,463,18,1370,26,35760
"Hamtramck city, Michigan",9092,8025,1067,27842,26,36280
"Hancock city, Michigan",2445,2385,60,4526,26,36300
"Hanover village, Michigan",203,197,6,397,26,36380
"Harbor Beach city, Michigan",654,620,34,1744,26,36460
"Harbor Springs city, Michigan",410,399,11,1091,26,36560
"Hardwood Acres CDP, Michigan",282,282,0,561,26,36585
"Haring CDP, Michigan",156,156,0,325,26,36590
"Harper Woods city, Michigan",7704,7121,583,15296,26,36700
"Harrietta village, Michigan",93,93,0,210,26,36720
"Harrison city, Michigan",650,605,45,2311,26,36800
"Harrisville city, Michigan",170,165,5,500,26,36860
"Hart city, Michigan",997,967,30,2173,26,36920
"Hartford city, Michigan",1064,950,114,2565,26,36960
"Hartland CDP, Michigan",416,406,10,725,26,37020
"Harvey CDP, Michigan",1752,1685,67,3335,26,37080
"Haslett CDP, Michigan",10287,10007,280,19091,26,37100
"Hastings city, Michigan",3600,3366,234,7504,26,37120
"Hazel Park city, Michigan",8725,8203,522,15065,26,37420
"Hemlock CDP, Michigan",804,804,0,1226,26,37600
"Henderson CDP, Michigan",167,161,6,288,26,37620
"Hermansville CDP, Michigan",230,202,28,611,26,37760
"Hersey village, Michigan",162,141,21,356,26,37820
"Hesperia village, Michigan",339,323,16,941,26,37860
"Hickory Corners CDP, Michigan",93,93,0,155,26,37960
"Highland Park city, Michigan",3698,3024,674,9032,26,38180
"Hillman village, Michigan",294,276,18,729,26,38380
"Hillsdale city, Michigan",3974,3830,144,8005,26,38460
"Holland city, Michigan",18264,17841,423,34186,26,38640
"Holly village, Michigan",3110,2870,240,5997,26,38700
"Holt CDP, Michigan",14025,13260,765,25374,26,38780
"Homer village, Michigan",695,647,48,1663,26,38920
"Honor village, Michigan",58,58,0,149,26,39080
"Hopkins village, Michigan",379,366,13,765,26,39180
"Horton Bay CDP, Michigan",159,155,4,379,26,39340
"Houghton city, Michigan",4000,3526,474,8303,26,39360
"Houghton Lake CDP, Michigan",2178,2066,112,5601,26,39400
"Howard City village, Michigan",866,853,13,1836,26,39500
"Howell city, Michigan",5661,5410,251,10067,26,39540
"Hubbard Lake CDP, Michigan",219,201,18,906,26,39634
"Hubbardston village, Michigan",170,146,24,419,26,39660
"Hubbell CDP, Michigan",421,421,0,769,26,39680
"Hudson city, Michigan",1143,1064,79,2480,26,39720
"Hudsonville city, Michigan",3838,3607,231,7633,26,39800
"Huntington Woods city, Michigan",3680,3611,69,6365,26,40000
"Hurontown CDP, Michigan",185,185,0,247,26,40160
"Ida CDP, Michigan",363,363,0,686,26,40240
"Imlay City city, Michigan",1912,1841,71,3698,26,40320
"Indian River CDP, Michigan",988,947,41,2076,26,40480
"Inkster city, Michigan",10958,9676,1282,25839,26,40680
"Interlochen CDP, Michigan",195,195,0,541,26,40800
"Ionia city, Michigan",5349,4978,371,13081,26,40860
"Iron Mountain city, Michigan",3532,3367,165,7522,26,40960
"Iron River city, Michigan",1511,1447,64,2995,26,40980
"Ironton CDP, Michigan",78,78,0,172,26,41040
"Ironwood city, Michigan",2294,2047,247,5088,26,41060
"Ishpeming city, Michigan",3095,2856,239,6191,26,41220
"Ithaca city, Michigan",1596,1583,13,2840,26,41340
"Jackson city, Michigan",14954,13330,1624,31420,26,41420
"Jasper CDP, Michigan",208,187,21,344,26,41540
"Jenison CDP, Michigan",8367,8194,173,17314,26,41680
"Jennings CDP, Michigan",85,85,0,202,26,41720
"Jonesville city, Michigan",912,859,53,2304,26,41920
"Kalamazoo city, Michigan",40294,37039,3255,73342,26,42160
"Kaleva village, Michigan",152,138,14,487,26,42240
"Kalkaska village, Michigan",1084,1035,49,2563,26,42260
"Keego Harbor city, Michigan",1693,1629,64,2771,26,42460
"Kent City village, Michigan",756,737,19,1379,26,42780
"Kentwood city, Michigan",29932,28578,1354,54042,26,42820
"Kincheloe CDP, Michigan",1474,1088,386,3290,26,43180
"Kinde village, Michigan",162,158,4,398,26,43220
"Kingsford city, Michigan",2556,2463,93,5127,26,43300
"Kingsley village, Michigan",646,629,17,1792,26,43340
"Kingston village, Michigan",175,161,14,352,26,43380
"K. I. Sawyer CDP, Michigan",1184,1128,56,2833,26,43558
"Laingsburg city, Michigan",671,649,22,1584,26,44200
"Lake Angelus city, Michigan",142,135,7,287,26,44440
"Lake Ann village, Michigan",169,160,9,423,26,44460
"Lake City city, Michigan",338,315,23,702,26,44480
"Lake Fenton CDP, Michigan",2522,2422,100,6316,26,44520
"Lake Gogebic CDP, Michigan",21,21,0,117,26,44620
"Lake Isabella village, Michigan",637,622,15,1550,26,44715
"Lake LeAnn CDP, Michigan",578,562,16,1285,26,44752
"Lake Leelanau CDP, Michigan",60,60,0,165,26,44760
"Lake Linden village, Michigan",617,555,62,1183,26,44780
"Lake Michigan Beach CDP, Michigan",488,488,0,918,26,44820
"Lake Odessa village, Michigan",1084,1023,61,2129,26,44880
"Lake Orion village, Michigan",1662,1619,43,2915,26,44940
"Lakeport CDP, Michigan",323,303,20,798,26,45000
"Lakes of the North CDP, Michigan",423,406,17,1031,26,45144
"Lake Victoria CDP, Michigan",607,581,26,950,26,45190
"Lakeview village, Michigan",390,334,56,1027,26,45240
"Lakewood Club village, Michigan",684,645,39,1342,26,45340
"Lambertville CDP, Michigan",5166,5028,138,9846,26,45420
"Lamont CDP, Michigan",589,584,5,1064,26,45440
"L'Anse village, Michigan",842,784,58,1942,26,45540
"Lansing city, Michigan",60783,55744,5039,112986,26,46000
"Lapeer city, Michigan",3591,3436,155,9034,26,46040
"Lathrup Village city, Michigan",2226,2058,168,4076,26,46320
"Laurium village, Michigan",832,810,22,1669,26,46360
"Lawrence village, Michigan",464,425,39,1007,26,46440
"Lawton village, Michigan",839,752,87,1869,26,46500
"Leland CDP, Michigan",121,121,0,352,26,46800
"Lennon village, Michigan",187,171,16,384,26,46880
"Leonard village, Michigan",145,136,9,323,26,46940
"Le Roy village, Michigan",92,90,2,213,26,47100
"Leslie city, Michigan",1075,1028,47,2154,26,47180
"Level Park-Oak Park CDP, Michigan",1600,1548,52,3364,26,47230
"Levering CDP, Michigan",26,24,2,52,26,47240
"Lewiston CDP, Michigan",450,397,53,869,26,47260
"Lexington village, Michigan",594,583,11,1329,26,47280
"Lincoln village, Michigan",90,82,8,233,26,47560
"Lincoln Park city, Michigan",18657,17364,1293,39807,26,47800
"Linden city, Michigan",1861,1681,180,4125,26,47820
"Litchfield city, Michigan",650,631,19,1195,26,47980
"Livonia city, Michigan",50563,48020,2543,94928,26,49000
"Loomis CDP, Michigan",155,149,6,217,26,49400
"Lost Lake Woods CDP, Michigan",73,70,3,345,26,49450
"Lowell city, Michigan",1885,1847,38,4127,26,49540
"Ludington city, Michigan",3134,3006,128,7691,26,49640
"Luna Pier city, Michigan",484,451,33,1225,26,49700
"Lupton CDP, Michigan",95,85,10,277,26,49720
"Luther village, Michigan",118,108,10,269,26,49740
"Lyons village, Michigan",510,433,77,1009,26,49900
"McBain city, Michigan",365,328,37,747,26,49980
"McBride village, Michigan",81,81,0,192,26,50000
"Mackinac Island city, Michigan",609,557,52,836,26,50280
"Mackinaw City village, Michigan",327,238,89,655,26,50320
"Madison Heights city, Michigan",16861,16255,606,28521,26,50560
"Mancelona village, Michigan",825,729,96,1622,26,50620
"Manchester village, Michigan",1341,1321,20,2261,26,50660
"Manistee city, Michigan",2724,2526,198,6248,26,50720
"Manistee Lake CDP, Michigan",130,130,0,366,26,50755
"Manistique city, Michigan",1406,1285,121,2838,26,50760
"Manitou Beach-Devils Lake CDP, Michigan",993,981,12,1807,26,50830
"Manton city, Michigan",581,550,31,1322,26,50880
"Maple City CDP, Michigan",92,92,0,164,26,50920
"Maple Grove CDP, Michigan",137,137,0,165,26,50970
"Maple Rapids village, Michigan",344,341,3,764,26,51200
"Marcellus village, Michigan",587,556,31,1203,26,51460
"Marenisco CDP, Michigan",77,77,0,249,26,51540
"Marine City city, Michigan",2175,1993,182,4068,26,51600
"Marion village, Michigan",236,199,37,653,26,51660
"Marlette city, Michigan",808,725,83,1797,26,51820
"Marquette city, Michigan",11970,11264,706,20673,26,51900
"Marshall city, Michigan",3645,3381,264,6806,26,51940
"Martin village, Michigan",252,244,8,530,26,51980
"Marysville city, Michigan",4955,4729,226,9973,26,52080
"Mason city, Michigan",4081,3919,162,8284,26,52180
"Mass City CDP, Michigan",74,70,4,179,26,52280
"Mattawan village, Michigan",1505,1390,115,2566,26,52380
"Maybee village, Michigan",364,351,13,660,26,52440
"Mayville village, Michigan",496,455,41,1167,26,52540
"Mears CDP, Michigan",145,133,12,253,26,52720
"Mecosta village, Michigan",216,193,23,505,26,52760
"Melvin village, Michigan",85,76,9,188,26,52920
"Melvindale city, Michigan",5367,4766,601,12639,26,52940
"Memphis city, Michigan",585,553,32,1150,26,52960
"Mendon village, Michigan",428,399,29,811,26,52980
"Menominee city, Michigan",4315,4139,176,8429,26,53020
"Merrill village, Michigan",371,274,97,898,26,53180
"Mesick village, Michigan",147,133,14,390,26,53320
"Metamora village, Michigan",333,324,9,619,26,53340
"Michiana village, Michigan",156,151,5,285,26,53500
"Michigamme CDP, Michigan",86,71,15,226,26,53520
"Michigan Center CDP, Michigan",2518,2303,215,4906,26,53580
"Middletown CDP, Michigan",385,368,17,720,26,53730
"Middleville village, Michigan",2258,2244,14,4259,26,53760
"Midland city, Michigan",20324,19414,910,42404,26,53780
"Milan city, Michigan",3586,3353,233,6153,26,53920
"Milford village, Michigan",3225,3128,97,6483,26,53960
"Millburg CDP, Michigan",293,269,24,481,26,54025
"Millersburg village, Michigan",52,49,3,162,26,54120
"Millers Lake CDP, Michigan",174,174,0,451,26,54132
"Millington village, Michigan",523,509,14,1097,26,54220
"Minden City village, Michigan",102,96,6,203,26,54560
"Mio CDP, Michigan",638,539,99,1358,26,54660
"Mohawk CDP, Michigan",103,102,1,234,26,54820
"Monroe city, Michigan",9525,8785,740,20400,26,55020
"Montague city, Michigan",1154,1134,20,2514,26,55100
"Montgomery village, Michigan",135,134,1,327,26,55220
"Montrose city, Michigan",778,759,19,1958,26,55280
"Morenci city, Michigan",1003,949,54,1998,26,55500
"Morley village, Michigan",263,216,47,649,26,55540
"Morrice village, Michigan",816,767,49,1665,26,55560
"Mount Clemens city, Michigan",7658,7119,539,15679,26,55820
"Mount Morris city, Michigan",1376,1121,255,3147,26,55960
"Mount Pleasant city, Michigan",12022,10884,1138,21826,26,56020
"Muir village, Michigan",292,265,27,591,26,56080
"Mulliken village, Michigan",294,280,14,525,26,56140
"Munising city, Michigan",852,817,35,2003,26,56200
"Muskegon city, Michigan",15981,14320,1661,38286,26,56320
"Muskegon Heights city, Michigan",4167,3312,855,9954,26,56360
"Napoleon CDP, Michigan",525,451,74,929,26,56620
"Nashville village, Michigan",719,689,30,1440,26,56680
"Naubinway CDP, Michigan",42,42,0,75,26,56760
"Negaunee city, Michigan",2226,2167,59,4650,26,56860
"Nessen City CDP, Michigan",32,28,4,90,26,56960
"Newaygo city, Michigan",1127,1060,67,2458,26,57080
"New Baltimore city, Michigan",6304,6035,269,12104,26,57100
"Newberry village, Michigan",373,356,17,1138,26,57140
"New Buffalo city, Michigan",781,771,10,1362,26,57220
"New Era village, Michigan",240,236,4,441,26,57280
"New Haven village, Michigan",2573,2376,197,6200,26,57380
"New Lothrop village, Michigan",310,292,18,621,26,57520
"New Troy CDP, Michigan",238,238,0,367,26,57660
"Niles city, Michigan",6109,5370,739,11871,26,57760
"North Adams village, Michigan",245,240,5,510,26,57920
"North Branch village, Michigan",472,440,32,999,26,58080
"North Muskegon city, Michigan",2099,2069,30,4076,26,58640
"Northport village, Michigan",157,153,4,427,26,58740
"Northview CDP, Michigan",8871,8374,497,15428,26,58945
"Northville city, Michigan",3375,3261,114,6088,26,58980
"Norton Shores city, Michigan",12140,11509,631,24984,26,59140
"Norway city, Michigan",1409,1377,32,2832,26,59220
"Norwood CDP, Michigan",96,90,6,156,26,59320
"Novi city, Michigan",35709,34188,1521,65870,26,59440
"Nunica CDP, Michigan",141,141,0,200,26,59520
"Oak Hill CDP, Michigan",271,247,24,511,26,59740
"Oakley village, Michigan",116,113,3,270,26,59860
"Oak Park city, Michigan",16553,14909,1644,29495,26,59920
"Oden CDP, Michigan",175,175,0,315,26,60180
"Okemos CDP, Michigan",13490,13038,452,25549,26,60340
"Olivet city, Michigan",777,672,105,1596,26,60580
"Omena CDP, Michigan",52,52,0,250,26,60640
"Omer city, Michigan",111,96,15,245,26,60660
"Onaway city, Michigan",328,283,45,813,26,60680
"Onekama village, Michigan",166,166,0,347,26,60740
"Onsted village, Michigan",588,537,51,1147,26,60840
"Ontonagon village, Michigan",437,419,18,1290,26,60860
"Orchard Lake Village city, Michigan",1171,1129,42,2342,26,61020
"Ortonville village, Michigan",671,629,42,1271,26,61220
"Oscoda CDP, Michigan",338,308,30,918,26,61320
"Ossineke CDP, Michigan",421,365,56,852,26,61500
"Otisville village, Michigan",400,391,9,910,26,61600
"Otsego city, Michigan",1888,1740,148,4083,26,61620
"Otter Lake village, Michigan",182,177,5,361,26,61760
"Ovid city, Michigan",656,651,5,1445,26,61860
"Owendale village, Michigan",115,115,0,271,26,61920
"Owosso city, Michigan",7739,7388,351,14678,26,61940
"Oxford village, Michigan",2072,1878,194,3487,26,62020
"Painesdale CDP, Michigan",133,133,0,330,26,62120
"Palmer CDP, Michigan",197,189,8,378,26,62180
"Palo CDP, Michigan",156,152,4,407,26,62260
"Parchment city, Michigan",1194,1094,100,2041,26,62340
"Paris CDP, Michigan",108,108,0,279,26,62400
"Parkdale CDP, Michigan",217,209,8,660,26,62500
"Parma village, Michigan",317,284,33,663,26,62740
"Paw Paw village, Michigan",1360,1270,90,3318,26,62980
"Paw Paw Lake CDP, Michigan",1555,1459,96,3643,26,63020
"Pearl Beach CDP, Michigan",2287,2189,98,5159,26,63200
"Peck village, Michigan",222,206,16,553,26,63260
"Pelkie CDP, Michigan",19,19,0,38,26,63280
"Pellston village, Michigan",420,404,16,759,26,63300
"Pentwater village, Michigan",278,255,23,830,26,63540
"Perrinton village, Michigan",214,193,21,517,26,63660
"Perry city, Michigan",1159,1129,30,2281,26,63700
"Petersburg city, Michigan",638,614,24,1148,26,63800
"Petoskey city, Michigan",3448,3408,40,5859,26,63820
"Pewamo village, Michigan",218,210,8,490,26,63900
"Pierson village, Michigan",50,49,1,133,26,64020
"Pigeon village, Michigan",448,442,6,1100,26,64060
"Pilgrim CDP, Michigan",0,0,0,0,26,64100
"Pinckney village, Michigan",1169,1103,66,1950,26,64140
"Pinconning city, Michigan",479,458,21,1354,26,64160
"Pittsford CDP, Michigan",416,416,0,656,26,64600
"Plainwell city, Michigan",1784,1681,103,3763,26,64740
"Pleasant Ridge city, Michigan",1528,1426,102,2609,26,64900
"Plymouth city, Michigan",5306,5139,167,9300,26,65060
"Ponshewaing CDP, Michigan",51,51,0,82,26,65420
"Pontiac city, Michigan",28929,26178,2751,61965,26,65440
"Portage city, Michigan",27016,25375,1641,48936,26,65560
"Port Austin village, Michigan",328,301,27,667,26,65680
"Port Hope village, Michigan",95,78,17,272,26,65800
"Port Huron city, Michigan",13787,12511,1276,28881,26,65820
"Portland city, Michigan",1930,1888,42,3816,26,65860
"Port Sanilac village, Michigan",304,294,10,792,26,65900
"Posen village, Michigan",95,85,10,237,26,66000
"Potterville city, Michigan",1462,1419,43,3036,26,66100
"Powers village, Michigan",98,93,5,364,26,66140
"Prescott village, Michigan",135,116,19,388,26,66300
"Presque Isle Harbor CDP, Michigan",227,227,0,715,26,66343
"Prudenville CDP, Michigan",669,616,53,1412,26,66400
"Quincy village, Michigan",653,604,49,1303,26,66640
"Quinnesec CDP, Michigan",881,856,25,1262,26,66720
"Ramsay CDP, Michigan",132,132,0,272,26,66980
"Rapid City CDP, Michigan",497,472,25,1196,26,67140
"Rapid River CDP, Michigan",148,142,6,305,26,67160
"Ravenna village, Michigan",757,732,25,1437,26,67280
"Reading city, Michigan",461,441,20,1207,26,67500
"Reed City city, Michigan",1023,932,91,2481,26,67820
"Reese village, Michigan",736,650,86,1300,26,67900
"Republic CDP, Michigan",163,135,28,532,26,67980
"Richland village, Michigan",383,373,10,979,26,68240
"Richmond city, Michigan",2920,2741,179,5852,26,68380
"Riverdale CDP, Michigan",141,126,15,223,26,68720
"River Rouge city, Michigan",2823,2460,363,7200,26,68760
"Riverview city, Michigan",5881,5692,189,12390,26,68880
"Robin Glen-Indiantown CDP, Michigan",282,265,17,634,26,68990
"Rochester city, Michigan",6922,6645,277,12978,26,69020
"Rochester Hills city, Michigan",39142,37617,1525,76041,26,69035
"Rock CDP, Michigan",99,89,10,184,26,69060
"Rockford city, Michigan",3636,3330,306,6144,26,69080
"Rockland CDP, Michigan",66,66,0,194,26,69120
"Rockwood city, Michigan",1524,1474,50,3232,26,69180
"Rogers City city, Michigan",1157,1120,37,2866,26,69260
"Romeo village, Michigan",1854,1810,44,3727,26,69400
"Romulus city, Michigan",12020,10840,1180,25055,26,69420
"Roosevelt Park city, Michigan",2363,2198,165,4139,26,69520
"Roscommon village, Michigan",360,357,3,1123,26,69540
"Rosebush village, Michigan",190,166,24,406,26,69640
"Rose City city, Michigan",260,216,44,573,26,69680
"Roseville city, Michigan",25367,23358,2009,47476,26,69800
"Rothbury village, Michigan",159,155,4,355,26,69880
"Royal Oak city, Michigan",37975,36850,1125,58053,26,70040
"Ruby CDP, Michigan",358,358,0,721,26,70160
"Saginaw city, Michigan",18164,16039,2125,44316,26,70520
"St. Charles village, Michigan",880,839,41,2020,26,70640
"St. Clair city, Michigan",2763,2613,150,5496,26,70680
"St. Clair Shores city, Michigan",31829,30348,1481,58656,26,70760
"St. Helen CDP, Michigan",897,805,92,2822,26,70800
"St. Ignace city, Michigan",1030,991,39,2233,26,70840
"St. James CDP, Michigan",76,60,16,226,26,70900
"St. Johns city, Michigan",3741,3640,101,7711,26,70940
"St. Joseph city, Michigan",4203,4145,58,7852,26,70960
"St. Louis city, Michigan",1339,1257,82,6932,26,71000
"Saline city, Michigan",4568,4307,261,8973,26,71140
"Sand Lake CDP, Michigan",397,385,12,1178,26,71340
"Sand Lake village, Michigan",200,195,5,492,26,71360
"Sandusky city, Michigan",1300,1245,55,2711,26,71540
"Sanford village, Michigan",421,413,8,757,26,71560
"Saranac village, Michigan",1143,1122,21,1946,26,71660
"Saugatuck city, Michigan",347,339,8,751,26,71700
"Sault Ste. Marie city, Michigan",6972,6451,521,13409,26,71740
"Schoolcraft village, Michigan",788,773,15,1409,26,71860
"Scotts CDP, Michigan",98,98,0,182,26,72060
"Scottville city, Michigan",716,690,26,1512,26,72080
"Sebewaing village, Michigan",870,795,75,1951,26,72180
"Shaftsburg CDP, Michigan",307,296,11,418,26,72700
"Shelby village, Michigan",1171,1122,49,2520,26,72840
"Shepherd village, Michigan",718,709,9,1415,26,72960
"Sheridan village, Michigan",330,324,6,867,26,73100
"Sherwood village, Michigan",156,135,21,448,26,73420
"Shields CDP, Michigan",3502,3363,139,7444,26,73560
"Shoreham village, Michigan",477,473,4,921,26,73660
"Shorewood-Tower Hills-Harbert CDP, Michigan",689,679,10,1501,26,73730
"Skanee CDP, Michigan",39,39,0,95,26,74120
"Skidway Lake CDP, Michigan",898,762,136,2880,26,74200
"Snover CDP, Michigan",100,93,7,260,26,74380
"South Boardman CDP, Michigan",314,306,8,613,26,74740
"Southfield city, Michigan",38778,36263,2515,76107,26,74900
"Southgate city, Michigan",15208,14485,723,29948,26,74960
"South Gull Lake CDP, Michigan",879,868,11,1585,26,74975
"South Haven city, Michigan",1647,1585,62,3999,26,74980
"South Lyon city, Michigan",6752,6509,243,11788,26,75100
"South Monroe CDP, Michigan",3076,2739,337,6658,26,75140
"South Range village, Michigan",233,230,3,509,26,75220
"South Rockwood village, Michigan",1057,1019,38,2032,26,75280
"Sparta village, Michigan",2026,1953,73,4247,26,75420
"Spring Arbor CDP, Michigan",1342,1287,55,2410,26,75620
"Springfield city, Michigan",2404,2127,277,5268,26,75700
"Spring Lake village, Michigan",1402,1341,61,2530,26,75820
"Springport village, Michigan",411,354,57,921,26,75860
"Standish city, Michigan",793,716,77,1552,26,76120
"Stanton city, Michigan",434,406,28,1293,26,76220
"Stanwood village, Michigan",73,66,7,151,26,76240
"Stephenson city, Michigan",400,392,8,933,26,76380
"Sterling village, Michigan",239,217,22,482,26,76420
"Sterling Heights city, Michigan",68593,64548,4045,133744,26,76460
"Stevensville village, Michigan",628,604,24,1126,26,76500
"Stockbridge village, Michigan",621,570,51,1259,26,76560
"Stony Point CDP, Michigan",814,759,55,1875,26,76720
"Stronach CDP, Michigan",96,96,0,192,26,76820
"Sturgis city, Michigan",5581,5217,364,11050,26,76960
"Sunfield village, Michigan",319,279,40,647,26,77420
"Suttons Bay village, Michigan",226,218,8,642,26,77600
"Swartz Creek city, Michigan",2675,2650,25,5865,26,77700
"Sylvan Lake city, Michigan",989,944,45,1729,26,77860
"Tawas City city, Michigan",790,714,76,1749,26,78140
"Taylor city, Michigan",31181,28889,2292,62937,26,79000
"Tecumseh city, Michigan",4418,4118,300,8678,26,79120
"Tekonsha village, Michigan",324,290,34,685,26,79160
"Temperance CDP, Michigan",4206,4094,112,9121,26,79240
"Thompsonville village, Michigan",237,230,7,452,26,79600
"Three Lakes CDP, Michigan",103,99,4,198,26,79680
"Three Oaks village, Michigan",684,652,32,1207,26,79720
"Three Rivers city, Michigan",3979,3638,341,7923,26,79760
"Tower CDP, Michigan",145,125,20,313,26,80200
"Traverse City city, Michigan",8307,7866,441,15468,26,80340
"Trenton city, Michigan",8846,8552,294,18420,26,80420
"Trimountain CDP, Michigan",80,80,0,201,26,80480
"Trowbridge Park CDP, Michigan",1040,987,53,2153,26,80660
"Troy city, Michigan",46034,44252,1782,87170,26,80700
"Trufant CDP, Michigan",307,307,0,544,26,80720
"Turner village, Michigan",25,24,1,74,26,80820
"Tustin village, Michigan",108,107,1,206,26,80960
"Twining village, Michigan",75,73,2,222,26,81020
"Twin Lake CDP, Michigan",1025,809,216,1885,26,81040
"Ubly village, Michigan",387,350,37,824,26,81200
"Union City village, Michigan",892,837,55,1826,26,81360
"Unionville village, Michigan",297,291,6,595,26,81420
"Utica city, Michigan",2650,2539,111,5195,26,81540
"Vandalia village, Michigan",185,176,9,389,26,81680
"Vanderbilt village, Michigan",255,239,16,495,26,81700
"Vandercook Lake CDP, Michigan",1960,1923,37,4635,26,81740
"Vassar city, Michigan",1345,1182,163,2718,26,81840
"Vermontville village, Michigan",345,324,21,717,26,81960
"Vernon village, Michigan",353,353,0,624,26,82020
"Vicksburg village, Michigan",2152,2102,50,3757,26,82300
"Village of Clarkston city, Michigan",399,385,14,775,26,82450
"Village of Grosse Pointe Shores city, Michigan",1111,1099,12,2610,26,82453
"Vineyard Lake CDP, Michigan",602,602,0,918,26,82490
"Wacousta CDP, Michigan",841,810,31,1788,26,82680
"Wakefield city, Michigan",669,655,14,1554,26,82780
"Waldron village, Michigan",308,284,24,605,26,82880
"Walker city, Michigan",14503,14003,500,25175,26,82960
"Walkerville village, Michigan",75,75,0,212,26,83020
"Walled Lake city, Michigan",4398,4291,107,7262,26,83060
"Walloon Lake CDP, Michigan",163,161,2,308,26,83140
"Warren city, Michigan",71752,66419,5333,138588,26,84000
"Watersmeet CDP, Michigan",119,119,0,243,26,84360
"Watervliet city, Michigan",868,825,43,1883,26,84500
"Waverly CDP, Michigan",13716,12918,798,23723,26,84800
"Wayland city, Michigan",2525,2450,75,4411,26,84880
"Wayne city, Michigan",8839,8027,812,17568,26,84940
"Webberville village, Michigan",619,572,47,1338,26,85080
"Wedgewood CDP, Michigan",98,98,0,250,26,85110
"Weidman CDP, Michigan",484,469,15,1293,26,85140
"Wellston CDP, Michigan",75,75,0,224,26,85300
"West Branch city, Michigan",804,750,54,2198,26,85580
"West Ishpeming CDP, Michigan",1273,1206,67,2713,26,85700
"Westland city, Michigan",43045,40814,2231,84806,26,86000
"West Monroe CDP, Michigan",1516,1314,202,2888,26,86050
"Westphalia village, Michigan",379,372,7,952,26,86120
"Westwood CDP, Michigan",5183,4993,190,9022,26,86380
"White Cloud city, Michigan",416,408,8,1197,26,86680
"Whitehall city, Michigan",1242,1216,26,2935,26,86780
"White Pigeon village, Michigan",739,692,47,1544,26,86920
"White Pine CDP, Michigan",119,118,1,415,26,86960
"Whitmore Lake CDP, Michigan",4559,4440,119,7911,26,87060
"Whittemore city, Michigan",140,125,15,433,26,87140
"Williamston city, Michigan",2048,1960,88,3810,26,87420
"Winn CDP, Michigan",195,183,12,268,26,87920
"Wixom city, Michigan",11200,10897,303,17007,26,88140
"Wolf Lake CDP, Michigan",2001,1785,216,4128,26,88220
"Wolverine village, Michigan",96,93,3,205,26,88240
"Wolverine Lake village, Michigan",2573,2490,83,4493,26,88260
"Woodhaven city, Michigan",6181,5872,309,12867,26,88380
"Woodland village, Michigan",207,173,34,479,26,88420
"Woodland Beach CDP, Michigan",1215,1153,62,2598,26,88480
"Wyandotte city, Michigan",12569,12049,520,24857,26,88900
"Wyoming city, Michigan",42986,41011,1975,76732,26,88940
"Yale city, Michigan",862,729,133,2050,26,89000
"Ypsilanti city, Michigan",11399,10473,926,20204,26,89140
"Zeba CDP, Michigan",112,112,0,382,26,89240
"Zeeland city, Michigan",3005,2921,84,5701,26,89260
"Zilwaukee city, Michigan",966,911,55,1673,26,89320
"Ada city, Minnesota",895,830,65,1828,27,00172
"Adams city, Minnesota",371,338,33,765,27,00190
"Adrian city, Minnesota",588,579,9,1209,27,00262
"Afton city, Minnesota",1375,1343,32,2951,27,00316
"Aitkin city, Minnesota",775,739,36,2153,27,00460
"Akeley city, Minnesota",126,119,7,363,27,00496
"Albany city, Minnesota",1334,1325,9,2795,27,00622
"Alberta city, Minnesota",70,70,0,101,27,00676
"Albert Lea city, Minnesota",8582,8143,439,18434,27,00694
"Albertville city, Minnesota",5098,5098,0,7883,27,00730
"Alden city, Minnesota",424,391,33,633,27,00838
"Aldrich city, Minnesota",20,19,1,38,27,00892
"Alexandria city, Minnesota",7638,7330,308,14400,27,00928
"Alpha city, Minnesota",92,92,0,114,27,01162
"Altura city, Minnesota",224,220,4,414,27,01234
"Alvarado city, Minnesota",146,143,3,280,27,01252
"Amboy city, Minnesota",271,256,15,507,27,01324
"Andover city, Minnesota",18242,17772,470,32639,27,01486
"Angle Inlet CDP, Minnesota",0,0,0,0,27,01558
"Annandale city, Minnesota",1521,1435,86,3351,27,01684
"Anoka city, Minnesota",9028,8559,469,17892,27,01720
"Appleton city, Minnesota",543,522,21,1346,27,01864
"Apple Valley city, Minnesota",30273,28990,1283,55594,27,01900
"Arco city, Minnesota",30,30,0,64,27,01972
"Arden Hills city, Minnesota",5019,4803,216,9805,27,02026
"Argyle city, Minnesota",333,333,0,610,27,02134
"Arlington city, Minnesota",1168,1137,31,2428,27,02152
"Ashby city, Minnesota",184,179,5,398,27,02422
"Askov city, Minnesota",156,133,23,342,27,02548
"Atwater city, Minnesota",661,604,57,1210,27,02692
"Audubon city, Minnesota",268,258,10,410,27,02728
"Aurora city, Minnesota",568,529,39,1775,27,02872
"Austin city, Minnesota",12758,12308,450,26156,27,02908
"Avoca city, Minnesota",44,41,3,103,27,03052
"Avon city, Minnesota",816,794,22,1410,27,03070
"Babbitt city, Minnesota",649,622,27,1377,27,03106
"Backus city, Minnesota",132,130,2,320,27,03124
"Badger city, Minnesota",239,220,19,434,27,03160
"Bagley city, Minnesota",544,511,33,1194,27,03196
"Baker CDP, Minnesota",28,28,0,47,27,03214
"Balaton city, Minnesota",273,252,21,548,27,03250
"Ball Club CDP, Minnesota",36,33,3,119,27,03376
"Barnesville city, Minnesota",1489,1470,19,2773,27,03574
"Barnum city, Minnesota",248,230,18,491,27,03628
"Barrett city, Minnesota",168,162,6,352,27,03682
"Barry city, Minnesota",6,6,0,15,27,03718
"Battle Lake city, Minnesota",290,266,24,744,27,03970
"Baudette city, Minnesota",617,617,0,1129,27,04024
"Baxter city, Minnesota",4292,4165,127,8668,27,04042
"Bayport city, Minnesota",1468,1433,35,3902,27,04114
"Beardsley city, Minnesota",129,122,7,241,27,04204
"Beaulieu CDP, Minnesota",25,22,3,47,27,04348
"Beaver Bay city, Minnesota",29,29,0,81,27,04456
"Beaver Creek city, Minnesota",145,145,0,266,27,04492
"Becker city, Minnesota",2741,2725,16,4897,27,04618
"Bejou city, Minnesota",47,45,2,91,27,04672
"Belgrade city, Minnesota",429,421,8,846,27,04762
"Bellechester city, Minnesota",114,89,25,199,27,04798
"Belle Plaine city, Minnesota",3998,3970,28,7363,27,04834
"Bellingham city, Minnesota",79,78,1,183,27,04960
"Beltrami city, Minnesota",55,52,3,80,27,05014
"Belview city, Minnesota",158,146,12,359,27,05050
"Bemidji city, Minnesota",8036,7699,337,15441,27,05068
"Bena city, Minnesota",43,34,9,146,27,05104
"Benson city, Minnesota",1641,1600,41,3453,27,05212
"Bertha city, Minnesota",209,185,24,477,27,05482
"Bethel city, Minnesota",299,284,15,470,27,05554
"Bigelow city, Minnesota",138,127,11,261,27,05644
"Big Falls city, Minnesota",88,76,12,153,27,05680
"Bigfork city, Minnesota",91,91,0,353,27,05698
"Big Lake CDP, Minnesota",166,153,13,383,27,05744
"Big Lake city, Minnesota",7225,6993,232,11857,27,05752
"Bingham Lake city, Minnesota",64,60,4,125,27,05896
"Birchwood Village city, Minnesota",603,593,10,1069,27,06058
"Bird Island city, Minnesota",568,557,11,1055,27,06076
"Biscay city, Minnesota",140,137,3,195,27,06112
"Biwabik city, Minnesota",442,430,12,764,27,06148
"Blackduck city, Minnesota",317,300,17,675,27,06256
"Blaine city, Minnesota",38428,36749,1679,70047,27,06382
"Blomkest city, Minnesota",111,111,0,174,27,06490
"Blooming Prairie city, Minnesota",1032,1008,24,2110,27,06580
"Bloomington city, Minnesota",50831,48589,2242,89244,27,06616
"Blue Earth city, Minnesota",1716,1641,75,3181,27,06688
"Bluffton city, Minnesota",116,116,0,253,27,06778
"Bock city, Minnesota",28,23,5,45,27,06814
"Borup city, Minnesota",40,40,0,154,27,07030
"Bovey city, Minnesota",412,412,0,791,27,07048
"Bowlus city, Minnesota",156,152,4,248,27,07066
"Boyd city, Minnesota",94,91,3,187,27,07138
"Boy River city, Minnesota",2,2,0,3,27,07174
"Braham city, Minnesota",794,729,65,1680,27,07282
"Brainerd city, Minnesota",7346,6802,544,14412,27,07300
"Brandon city, Minnesota",324,305,19,573,27,07336
"Breckenridge city, Minnesota",1761,1629,132,3390,27,07462
"Breezy Point city, Minnesota",1217,1167,50,2605,27,07516
"Brewster city, Minnesota",301,286,15,536,27,07660
"Bricelyn city, Minnesota",155,150,5,367,27,07678
"Brooklyn Center city, Minnesota",17567,16544,1023,33109,27,07948
"Brooklyn Park city, Minnesota",47517,45768,1749,84951,27,07966
"Brook Park city, Minnesota",68,67,1,136,27,07984
"Brooks city, Minnesota",52,52,0,113,27,08038
"Brookston city, Minnesota",41,35,6,99,27,08056
"Brooten city, Minnesota",319,300,19,578,27,08092
"Browerville city, Minnesota",416,369,47,899,27,08110
"Brownsdale city, Minnesota",469,446,23,797,27,08164
"Browns Valley city, Minnesota",255,236,19,503,27,08200
"Brownsville city, Minnesota",319,310,9,661,27,08218
"Brownton city, Minnesota",286,273,13,544,27,08254
"Bruno city, Minnesota",17,17,0,45,27,08290
"Buckman city, Minnesota",165,153,12,294,27,08416
"Buffalo city, Minnesota",8746,8409,337,16288,27,08452
"Buffalo Lake city, Minnesota",210,197,13,568,27,08488
"Buhl city, Minnesota",525,499,26,1028,27,08524
"Burnsville city, Minnesota",36715,35045,1670,64075,27,08794
"Burtrum city, Minnesota",46,42,4,83,27,08902
"Butterfield city, Minnesota",280,231,49,527,27,08992
"Byron city, Minnesota",3491,3334,157,6373,27,09154
"Caledonia city, Minnesota",1611,1588,23,2832,27,09226
"Callaway city, Minnesota",135,126,9,221,27,09280
"Calumet city, Minnesota",113,97,16,266,27,09316
"Cambridge city, Minnesota",4916,4781,135,9726,27,09370
"Campbell city, Minnesota",67,62,5,181,27,09496
"Canby city, Minnesota",678,635,43,1479,27,09604
"Cannon Falls city, Minnesota",2354,2316,38,4214,27,09730
"Canton city, Minnesota",258,239,19,463,27,09802
"Carlos city, Minnesota",263,251,12,426,27,09964
"Carlton city, Minnesota",409,356,53,955,27,10018
"Carver city, Minnesota",3182,3007,175,5656,27,10144
"Cass Lake city, Minnesota",233,196,37,505,27,10252
"Cedar Mills city, Minnesota",19,19,0,29,27,10468
"Center City city, Minnesota",317,288,29,624,27,10576
"Centerville city, Minnesota",2264,2251,13,3916,27,10648
"Ceylon city, Minnesota",136,116,20,272,27,10792
"Champlin city, Minnesota",14036,13623,413,23666,27,10846
"Chandler city, Minnesota",205,189,16,359,27,10900
"Chanhassen city, Minnesota",13924,13439,485,25868,27,10918
"Chaska city, Minnesota",15874,15502,372,27764,27,10972
"Chatfield city, Minnesota",1560,1530,30,2758,27,11008
"Chickamaw Beach city, Minnesota",86,84,2,214,27,11296
"Chisago City city, Minnesota",2747,2636,111,5576,27,11350
"Chisholm city, Minnesota",2010,1896,114,4759,27,11386
"Chokio city, Minnesota",209,207,2,412,27,11440
"Circle Pines city, Minnesota",3072,2954,118,4996,27,11494
"Clara City city, Minnesota",777,747,30,1599,27,11548
"Claremont city, Minnesota",251,243,8,552,27,11566
"Clarissa city, Minnesota",258,238,20,676,27,11602
"Clarkfield city, Minnesota",442,428,14,980,27,11656
"Clarks Grove city, Minnesota",385,365,20,738,27,11674
"Clearbrook city, Minnesota",264,252,12,689,27,11746
"Clear Lake city, Minnesota",443,416,27,698,27,11764
"Clearwater city, Minnesota",941,907,34,1734,27,11800
"Clements city, Minnesota",57,57,0,142,27,11836
"Cleveland city, Minnesota",366,359,7,719,27,11872
"Climax city, Minnesota",81,79,2,169,27,11962
"Clinton city, Minnesota",163,160,3,284,27,11980
"Clitherall city, Minnesota",53,53,0,108,27,12088
"Clontarf city, Minnesota",44,44,0,71,27,12124
"Cloquet city, Minnesota",6402,6091,311,12559,27,12160
"Coates city, Minnesota",77,74,3,120,27,12376
"Cobden city, Minnesota",13,13,0,19,27,12394
"Cohasset city, Minnesota",1251,1124,127,2683,27,12412
"Cokato city, Minnesota",1238,1210,28,2771,27,12430
"Cold Spring city, Minnesota",2301,2220,81,4180,27,12484
"Coleraine city, Minnesota",899,866,33,1865,27,12502
"Cologne city, Minnesota",1296,1244,52,2086,27,12664
"Columbia Heights city, Minnesota",12353,11715,638,21822,27,12700
"Columbus city, Minnesota",2487,2435,52,4180,27,12718
"Comfrey city, Minnesota",177,176,1,370,27,12772
"Comstock city, Minnesota",43,39,4,75,27,12862
"Conger city, Minnesota",63,61,2,106,27,12952
"Cook city, Minnesota",196,183,13,459,27,13006
"Coon Rapids city, Minnesota",36026,34498,1528,63296,27,13114
"Corcoran city, Minnesota",3373,3319,54,6549,27,13168
"Correll city, Minnesota",9,9,0,20,27,13384
"Cosmos city, Minnesota",328,320,8,534,27,13420
"Cottage Grove city, Minnesota",21923,21322,601,39274,27,13456
"Cottonwood city, Minnesota",629,608,21,1150,27,13564
"Courtland city, Minnesota",469,465,4,800,27,13582
"Credit River city, Minnesota",3145,3082,63,5508,27,13708
"Cromwell city, Minnesota",99,99,0,366,27,13780
"Crookston city, Minnesota",3812,3678,134,7472,27,13870
"Crosby city, Minnesota",989,936,53,2519,27,13924
"Crosslake city, Minnesota",1026,1001,25,2457,27,13978
"Crown College CDP, Minnesota",309,308,1,433,27,14054
"Crystal city, Minnesota",13525,13178,347,22954,27,14158
"Currie city, Minnesota",72,68,4,200,27,14320
"Cuyuna city, Minnesota",119,112,7,247,27,14428
"Cyrus city, Minnesota",184,174,10,304,27,14446
"Dakota city, Minnesota",165,158,7,277,27,14518
"Dalton city, Minnesota",190,172,18,295,27,14626
"Danube city, Minnesota",224,223,1,458,27,14716
"Danvers city, Minnesota",82,73,9,142,27,14734
"Darfur city, Minnesota",49,49,0,80,27,14770
"Darwin city, Minnesota",200,187,13,377,27,14842
"Dassel city, Minnesota",666,663,3,1341,27,14878
"Dawson city, Minnesota",711,678,33,1369,27,14968
"Dayton city, Minnesota",4455,4355,100,7745,27,15022
"Deephaven city, Minnesota",1827,1801,26,3852,27,15148
"Deer Creek city, Minnesota",119,110,9,253,27,15184
"Deer River city, Minnesota",342,333,9,908,27,15310
"Deerwood city, Minnesota",264,249,15,630,27,15346
"De Graff city, Minnesota",48,44,4,75,27,15418
"Delano city, Minnesota",3630,3600,30,6539,27,15454
"Delavan city, Minnesota",128,126,2,212,27,15472
"Delhi city, Minnesota",25,24,1,38,27,15544
"Dellwood city, Minnesota",597,582,15,1228,27,15616
"Denham city, Minnesota",9,7,2,25,27,15670
"Dennison city, Minnesota",102,98,4,216,27,15706
"Dent city, Minnesota",121,113,8,244,27,15724
"Detroit Lakes city, Minnesota",4866,4635,231,9966,27,15832
"Dexter city, Minnesota",196,190,6,324,27,15886
"Dilworth city, Minnesota",2712,2683,29,4621,27,15976
"Dodge Center city, Minnesota",1685,1620,65,2831,27,15994
"Donaldson city, Minnesota",9,9,0,9,27,16030
"Donnelly city, Minnesota",128,127,1,237,27,16084
"Doran city, Minnesota",12,12,0,18,27,16156
"Dover city, Minnesota",465,438,27,836,27,16264
"Dovray city, Minnesota",22,21,1,45,27,16300
"Dresbach CDP, Minnesota",129,121,8,259,27,16390
"Duluth city, Minnesota",47225,44927,2298,86772,27,17000
"Dumont city, Minnesota",96,94,2,139,27,17090
"Dundas city, Minnesota",1029,904,125,1716,27,17126
"Dundee city, Minnesota",42,35,7,85,27,17144
"Dunnell city, Minnesota",180,104,76,270,27,17180
"Eagan city, Minnesota",40760,39086,1674,68262,27,17288
"Eagle Bend city, Minnesota",262,259,3,647,27,17342
"Eagle Lake city, Minnesota",1813,1752,61,3229,27,17378
"East Bethel city, Minnesota",7229,6961,268,11901,27,17486
"East Grand Forks city, Minnesota",4825,4666,159,9118,27,17612
"East Gull Lake city, Minnesota",524,509,15,1027,27,17630
"Easton city, Minnesota",84,82,2,172,27,17738
"Ebro CDP, Minnesota",33,28,5,91,27,17882
"Echo city, Minnesota",134,131,3,237,27,17900
"Eden Prairie city, Minnesota",36092,34718,1374,63623,27,18116
"Eden Valley city, Minnesota",552,547,5,1024,27,18134
"Edgerton city, Minnesota",651,651,0,1256,27,18152
"Edina city, Minnesota",27108,26106,1002,53037,27,18188
"Effie city, Minnesota",49,49,0,95,27,18260
"Eitzen city, Minnesota",135,129,6,319,27,18368
"Elba city, Minnesota",51,51,0,79,27,18386
"Elbow Lake CDP, Minnesota",21,16,5,79,27,18440
"Elbow Lake city, Minnesota",504,471,33,1125,27,18458
"Elgin city, Minnesota",725,694,31,1117,27,18530
"Elizabeth city, Minnesota",74,72,2,136,27,18566
"Elko New Market city, Minnesota",3027,3002,25,4850,27,18662
"Elk River city, Minnesota",14741,14448,293,25936,27,18674
"Elkton city, Minnesota",74,73,1,126,27,18728
"Ellendale city, Minnesota",370,368,2,594,27,18746
"Ellsworth city, Minnesota",247,239,8,494,27,18836
"Elmdale city, Minnesota",169,168,1,202,27,18872
"Elmore city, Minnesota",238,220,18,436,27,18998
"Elrosa city, Minnesota",105,105,0,195,27,19088
"Ely city, Minnesota",1727,1679,48,3265,27,19142
"Elysian city, Minnesota",381,372,9,653,27,19160
"Emily city, Minnesota",223,215,8,658,27,19286
"Emmons city, Minnesota",170,166,4,312,27,19340
"Erhard city, Minnesota",84,80,4,157,27,19556
"Erskine city, Minnesota",169,168,1,440,27,19700
"Esko CDP, Minnesota",1250,1238,12,2172,27,19718
"Essig CDP, Minnesota",44,44,0,60,27,19754
"Evan city, Minnesota",44,39,5,71,27,19880
"Evansville city, Minnesota",305,296,9,659,27,19898
"Eveleth city, Minnesota",1719,1675,44,3500,27,19934
"Excelsior city, Minnesota",1504,1489,15,2257,27,20078
"Eyota city, Minnesota",1084,1064,20,2090,27,20114
"Fairfax city, Minnesota",500,475,25,1169,27,20222
"Fairhaven CDP, Minnesota",145,139,6,275,27,20276
"Fairmont city, Minnesota",5452,5161,291,10411,27,20330
"Falcon Heights city, Minnesota",3103,2852,251,5232,27,20420
"Faribault city, Minnesota",10848,10153,695,24418,27,20546
"Farmington city, Minnesota",13398,12937,461,23487,27,20618
"Farwell city, Minnesota",21,21,0,36,27,20690
"Federal Dam city, Minnesota",59,55,4,158,27,20798
"Felton city, Minnesota",93,87,6,155,27,20834
"Fergus Falls city, Minnesota",7049,6566,483,14108,27,20906
"Fertile city, Minnesota",379,359,20,816,27,20978
"Fifty Lakes city, Minnesota",154,148,6,431,27,21032
"Finland CDP, Minnesota",69,66,3,177,27,21104
"Finlayson city, Minnesota",86,69,17,190,27,21122
"Fisher city, Minnesota",218,217,1,383,27,21158
"Fish Lake CDP, Minnesota",17,17,0,44,27,21196
"Flensburg city, Minnesota",110,109,1,205,27,21266
"Floodwood city, Minnesota",175,171,4,437,27,21338
"Florence city, Minnesota",7,7,0,14,27,21410
"Foley city, Minnesota",1319,1258,61,2695,27,21536
"Forada city, Minnesota",69,65,4,144,27,21608
"Forest Lake city, Minnesota",11960,11419,541,20553,27,21770
"Foreston city, Minnesota",384,372,12,693,27,21824
"Fort Ripley city, Minnesota",39,32,7,86,27,21932
"Fosston city, Minnesota",549,514,35,1299,27,21986
"Fountain city, Minnesota",313,289,24,484,27,22094
"Foxhome city, Minnesota",60,57,3,113,27,22202
"Franklin city, Minnesota",254,250,4,540,27,22364
"Frazee city, Minnesota",708,641,67,1591,27,22472
"Freeborn city, Minnesota",136,119,17,304,27,22526
"Freeport city, Minnesota",441,434,7,822,27,22652
"Fridley city, Minnesota",16421,15455,966,29731,27,22814
"Frontenac CDP, Minnesota",142,142,0,214,27,22904
"Frost city, Minnesota",146,136,10,286,27,22940
"Fulda city, Minnesota",711,701,10,1377,27,22958
"Funkley city, Minnesota",2,2,0,61,27,22976
"Garden City CDP, Minnesota",134,124,10,221,27,23084
"Garfield city, Minnesota",190,168,22,308,27,23120
"Garrison city, Minnesota",84,84,0,168,27,23192
"Garvin city, Minnesota",48,45,3,96,27,23228
"Gary city, Minnesota",152,149,3,277,27,23246
"Gaylord city, Minnesota",1121,1081,40,2082,27,23300
"Gem Lake city, Minnesota",241,239,2,475,27,23318
"Geneva city, Minnesota",217,211,6,351,27,23354
"Genola city, Minnesota",50,47,3,69,27,23444
"Georgetown city, Minnesota",27,26,1,67,27,23498
"Ghent city, Minnesota",248,248,0,457,27,23660
"Gibbon city, Minnesota",407,369,38,824,27,23678
"Gilbert city, Minnesota",784,775,9,1821,27,23714
"Gilman city, Minnesota",133,124,9,254,27,23804
"Glencoe city, Minnesota",2952,2891,61,5712,27,23948
"Glenville city, Minnesota",310,306,4,562,27,24056
"Glenwood city, Minnesota",1384,1378,6,2628,27,24074
"Glyndon city, Minnesota",634,604,30,1341,27,24182
"Golden Valley city, Minnesota",12384,11984,400,22142,27,24308
"Gonvick city, Minnesota",74,66,8,191,27,24344
"Goodhue city, Minnesota",652,639,13,1230,27,24398
"Goodland CDP, Minnesota",3,3,0,9,27,24434
"Goodridge city, Minnesota",40,36,4,83,27,24470
"Good Thunder city, Minnesota",252,250,2,474,27,24506
"Goodview city, Minnesota",2472,2361,111,4109,27,24524
"Graceville city, Minnesota",272,265,7,640,27,24758
"Granada city, Minnesota",108,107,1,224,27,24884
"Grand Marais city, Minnesota",877,865,12,1768,27,24992
"Grand Meadow city, Minnesota",486,482,4,953,27,25010
"Grand Rapids city, Minnesota",4943,4592,351,11158,27,25118
"Granite Falls city, Minnesota",1180,1149,31,2423,27,25280
"Grant city, Minnesota",1840,1826,14,3969,27,25334
"Grasston city, Minnesota",63,56,7,119,27,25424
"Greenbush city, Minnesota",292,290,2,677,27,25604
"Greenfield city, Minnesota",1575,1562,13,2909,27,25622
"Green Isle city, Minnesota",283,280,3,479,27,25658
"Greenwald city, Minnesota",119,118,1,227,27,25874
"Greenwood city, Minnesota",425,409,16,742,27,25918
"Grey Eagle city, Minnesota",153,145,8,306,27,26000
"Grove City city, Minnesota",419,402,17,816,27,26126
"Grygla city, Minnesota",121,119,2,287,27,26216
"Gully city, Minnesota",30,30,0,49,27,26270
"Hackensack city, Minnesota",135,133,2,252,27,26378
"Hadley city, Minnesota",30,30,0,43,27,26450
"Hallock city, Minnesota",424,417,7,801,27,26576
"Halma city, Minnesota",13,13,0,37,27,26612
"Halstad city, Minnesota",293,293,0,622,27,26630
"Hamburg city, Minnesota",330,313,17,522,27,26666
"Ham Lake city, Minnesota",8451,8245,206,16489,27,26738
"Hammond city, Minnesota",88,88,0,137,27,26828
"Hampton city, Minnesota",350,319,31,591,27,26864
"Hancock city, Minnesota",402,392,10,725,27,26936
"Hanley Falls city, Minnesota",229,218,11,344,27,26972
"Hanover city, Minnesota",1986,1970,16,3454,27,26990
"Hanska city, Minnesota",165,164,1,384,27,27008
"Harding city, Minnesota",58,58,0,139,27,27098
"Hardwick city, Minnesota",94,92,2,171,27,27116
"Harmony city, Minnesota",519,498,21,1018,27,27188
"Harris city, Minnesota",564,537,27,924,27,27278
"Hartland city, Minnesota",239,197,42,386,27,27404
"Hastings city, Minnesota",11916,11537,379,22063,27,27530
"Hatfield city, Minnesota",18,18,0,32,27,27566
"Hawley city, Minnesota",1026,1012,14,2065,27,27746
"Hayfield city, Minnesota",774,756,18,1416,27,27872
"Hayward city, Minnesota",107,103,4,216,27,27944
"Hazel Run city, Minnesota",33,27,6,80,27,28016
"Hector city, Minnesota",635,629,6,1127,27,28124
"Heidelberg city, Minnesota",114,106,8,214,27,28214
"Henderson city, Minnesota",523,498,25,957,27,28394
"Hendricks city, Minnesota",272,262,10,602,27,28430
"Hendrum city, Minnesota",90,84,6,164,27,28484
"Henning city, Minnesota",332,325,7,771,27,28520
"Henriette city, Minnesota",15,13,2,40,27,28574
"Herman city, Minnesota",214,183,31,424,27,28646
"Hermantown city, Minnesota",4943,4856,87,10135,27,28682
"Heron Lake city, Minnesota",356,356,0,600,27,28700
"Hewitt city, Minnesota",127,125,2,276,27,28754
"Hibbing city, Minnesota",7612,7237,375,16167,27,28790
"High Forest CDP, Minnesota",52,52,0,132,27,28862
"Hill City city, Minnesota",228,200,28,518,27,29096
"Hillman city, Minnesota",13,11,2,20,27,29150
"Hills city, Minnesota",438,409,29,817,27,29204
"Hilltop city, Minnesota",585,482,103,1005,27,29258
"Hinckley city, Minnesota",736,666,70,1564,27,29294
"Hitterdal city, Minnesota",129,127,2,318,27,29402
"Hoffman city, Minnesota",372,354,18,680,27,29474
"Hokah city, Minnesota",402,402,0,749,27,29510
"Holdingford city, Minnesota",413,412,1,697,27,29582
"Holland city, Minnesota",148,148,0,277,27,29618
"Hollandale city, Minnesota",131,130,1,338,27,29636
"Holloway city, Minnesota",42,40,2,65,27,29672
"Holt city, Minnesota",30,26,4,60,27,29870
"Homer CDP, Minnesota",63,63,0,131,27,30014
"Hopkins city, Minnesota",10672,10211,461,18752,27,30140
"Houston city, Minnesota",384,353,31,892,27,30230
"Howard Lake city, Minnesota",937,918,19,1852,27,30284
"Hoyt Lakes city, Minnesota",970,812,158,2095,27,30302
"Hubbard CDP, Minnesota",10,9,1,30,27,30320
"Hugo city, Minnesota",9387,9239,148,15831,27,30392
"Humboldt city, Minnesota",9,7,2,38,27,30446
"Hutchinson city, Minnesota",7691,7341,350,14588,27,30644
"Ihlen city, Minnesota",23,23,0,71,27,30806
"Independence city, Minnesota",1807,1807,0,3718,27,30842
"Inger CDP, Minnesota",62,26,36,95,27,30950
"International Falls city, Minnesota",2807,2613,194,5795,27,31040
"Inver Grove Heights city, Minnesota",20366,19715,651,35673,27,31076
"Iona city, Minnesota",64,56,8,205,27,31094
"Iron Junction city, Minnesota",46,45,1,85,27,31238
"Ironton city, Minnesota",251,231,20,559,27,31274
"Isanti city, Minnesota",3785,3725,60,6850,27,31328
"Isle city, Minnesota",305,267,38,707,27,31472
"Ivanhoe city, Minnesota",331,309,22,595,27,31526
"Jackson city, Minnesota",1786,1732,54,3301,27,31562
"Janesville city, Minnesota",1519,1467,52,2455,27,31706
"Jasper city, Minnesota",291,283,8,590,27,31760
"Jeffers city, Minnesota",158,137,21,324,27,31796
"Jenkins city, Minnesota",257,249,8,457,27,31832
"Johnson city, Minnesota",13,13,0,24,27,32012
"Jordan city, Minnesota",3765,3538,227,6648,27,32174
"Kandiyohi city, Minnesota",297,277,20,471,27,32372
"Karlstad city, Minnesota",307,303,4,662,27,32444
"Kasota city, Minnesota",399,341,58,687,27,32462
"Kasson city, Minnesota",3756,3650,106,6855,27,32498
"Keewatin city, Minnesota",522,491,31,1195,27,32570
"Kelliher city, Minnesota",66,66,0,352,27,32606
"Kellogg city, Minnesota",269,267,2,429,27,32642
"Kennedy city, Minnesota",109,108,1,177,27,32732
"Kenneth city, Minnesota",11,8,3,66,27,32750
"Kensington city, Minnesota",123,116,7,226,27,32768
"Kent city, Minnesota",19,19,0,28,27,32786
"Kenyon city, Minnesota",906,883,23,1820,27,32840
"Kerkhoven city, Minnesota",365,353,12,837,27,32876
"Kerrick city, Minnesota",18,8,10,24,27,32912
"Kettle River city, Minnesota",57,54,3,117,27,32966
"Kiester city, Minnesota",288,255,33,617,27,33056
"Kilkenny city, Minnesota",32,31,1,76,27,33110
"Kimball city, Minnesota",421,412,9,696,27,33164
"Kinbrae city, Minnesota",4,4,0,6,27,33236
"Kingston city, Minnesota",104,103,1,215,27,33344
"Kinney city, Minnesota",56,50,6,143,27,33416
"Knife River CDP, Minnesota",0,0,0,114,27,33578
"La Crescent city, Minnesota",3119,3119,0,5352,27,33866
"Lafayette city, Minnesota",337,337,0,557,27,33920
"Lake Benton city, Minnesota",346,334,12,658,27,34100
"Lake Bronson city, Minnesota",132,102,30,170,27,34136
"Lake City city, Minnesota",2556,2542,14,5108,27,34172
"Lake Crystal city, Minnesota",1313,1264,49,2535,27,34190
"Lake Elmo city, Minnesota",6197,5990,207,11861,27,34244
"Lakefield city, Minnesota",830,827,3,1626,27,34316
"Lake George CDP, Minnesota",124,104,20,256,27,34370
"Lake Henry city, Minnesota",57,56,1,76,27,34478
"Lakeland city, Minnesota",959,913,46,1637,27,34622
"Lakeland Shores city, Minnesota",150,150,0,330,27,34658
"Lake Lillian city, Minnesota",107,101,6,201,27,34676
"Lake Park city, Minnesota",333,331,2,602,27,34784
"Lake St. Croix Beach city, Minnesota",693,683,10,1106,27,34865
"Lake Shore city, Minnesota",545,533,12,1166,27,34928
"Lakeville city, Minnesota",39689,38697,992,70696,27,35180
"Lake Wilson city, Minnesota",106,106,0,213,27,35198
"Lamberton city, Minnesota",369,364,5,828,27,35288
"Lancaster city, Minnesota",165,163,2,353,27,35378
"Landfall city, Minnesota",407,400,7,748,27,35414
"Lanesboro city, Minnesota",422,417,5,829,27,35450
"Lansing CDP, Minnesota",53,53,0,159,27,35558
"Laporte city, Minnesota",27,26,1,58,27,35612
"La Prairie city, Minnesota",289,278,11,623,27,35648
"La Salle city, Minnesota",49,49,0,59,27,35702
"Lastrup city, Minnesota",57,53,4,98,27,35720
"Lauderdale city, Minnesota",1578,1409,169,2454,27,35738
"Le Center city, Minnesota",1418,1340,78,2502,27,36134
"Lengby city, Minnesota",19,19,0,46,27,36404
"Leonard city, Minnesota",6,6,0,20,27,36494
"Leonidas city, Minnesota",29,29,0,59,27,36530
"Leota CDP, Minnesota",54,54,0,146,27,36548
"Le Roy city, Minnesota",311,308,3,794,27,36620
"Lester Prairie city, Minnesota",1071,1064,7,1918,27,36728
"Le Sueur city, Minnesota",2296,2289,7,4210,27,36746
"Lewiston city, Minnesota",1019,982,37,1768,27,36800
"Lewisville city, Minnesota",108,106,2,273,27,36818
"Lexington city, Minnesota",1539,1451,88,2448,27,36836
"Lilydale city, Minnesota",209,197,12,761,27,37016
"Lindstrom city, Minnesota",2726,2649,77,4891,27,37304
"Lino Lakes city, Minnesota",11694,11337,357,21525,27,37322
"Lismore city, Minnesota",181,181,0,292,27,37412
"Litchfield city, Minnesota",3346,3278,68,6598,27,37448
"Little Canada city, Minnesota",5822,5366,456,10624,27,37502
"Little Falls city, Minnesota",4001,3760,241,9084,27,37556
"Littlefork city, Minnesota",326,321,5,611,27,37592
"Little Rock CDP, Minnesota",436,333,103,1011,27,37656
"Long Beach city, Minnesota",130,128,2,301,27,37970
"Long Lake city, Minnesota",937,881,56,1712,27,38006
"Long Prairie city, Minnesota",1619,1535,84,3661,27,38060
"Longville city, Minnesota",58,51,7,185,27,38114
"Lonsdale city, Minnesota",2362,2340,22,4727,27,38150
"Loretto city, Minnesota",379,376,3,751,27,38222
"Louisburg city, Minnesota",6,5,1,22,27,38258
"Lowry city, Minnesota",173,173,0,316,27,38366
"Lucan city, Minnesota",79,79,0,181,27,38420
"Lutsen CDP, Minnesota",139,131,8,225,27,38546
"Luverne city, Minnesota",2557,2500,57,4910,27,38564
"Lyle city, Minnesota",273,253,20,488,27,38654
"Lynd city, Minnesota",253,248,5,527,27,38708
"Mabel city, Minnesota",407,390,17,803,27,38888
"McGrath city, Minnesota",0,0,0,24,27,38996
"McGregor city, Minnesota",213,191,22,446,27,39014
"McIntosh city, Minnesota",434,415,19,842,27,39050
"McKinley city, Minnesota",53,52,1,104,27,39140
"Madelia city, Minnesota",1310,1265,45,2352,27,39230
"Madison city, Minnesota",662,658,4,1566,27,39266
"Madison Lake city, Minnesota",695,678,17,1190,27,39320
"Magnolia city, Minnesota",119,119,0,198,27,39338
"Mahnomen city, Minnesota",454,403,51,1111,27,39392
"Mahnomen CDP, Minnesota",59,39,20,190,27,39394
"Mahtomedi city, Minnesota",4040,3910,130,8073,27,39428
"Mahtowa CDP, Minnesota",169,153,16,366,27,39446
"Manchester city, Minnesota",33,33,0,49,27,39716
"Manhattan Beach city, Minnesota",5,5,0,16,27,39806
"Mankato city, Minnesota",26873,25738,1135,44444,27,39878
"Mantorville city, Minnesota",602,585,17,997,27,39986
"Maple Grove city, Minnesota",40704,39081,1623,70110,27,40166
"Maple Lake city, Minnesota",1348,1312,36,2260,27,40220
"Maple Plain city, Minnesota",853,828,25,1780,27,40256
"Mapleton city, Minnesota",865,828,37,1674,27,40310
"Mapleview city, Minnesota",47,36,11,116,27,40346
"Maplewood city, Minnesota",22023,21345,678,41405,27,40382
"Marble city, Minnesota",328,304,24,614,27,40418
"Marietta city, Minnesota",55,55,0,184,27,40526
"Marine on St. Croix city, Minnesota",360,360,0,721,27,40562
"Marion CDP, Minnesota",183,183,0,377,27,40598
"Marshall city, Minnesota",6907,6695,212,13647,27,40688
"Martin Lake CDP, Minnesota",508,495,13,882,27,40814
"Mayer city, Minnesota",1497,1463,34,2460,27,41138
"Maynard city, Minnesota",161,156,5,271,27,41210
"Mazeppa city, Minnesota",483,465,18,901,27,41282
"Meadowlands city, Minnesota",58,54,4,135,27,41372
"Medford city, Minnesota",709,675,34,1258,27,41426
"Medicine Lake city, Minnesota",224,224,0,419,27,41462
"Medina city, Minnesota",3324,3263,61,6746,27,41480
"Meire Grove city, Minnesota",97,95,2,132,27,41534
"Melrose city, Minnesota",1795,1754,41,3606,27,41570
"Menahga city, Minnesota",433,421,12,1218,27,41660
"Mendota city, Minnesota",73,70,3,142,27,41678
"Mendota Heights city, Minnesota",6129,6071,58,11642,27,41696
"Mentor city, Minnesota",72,66,6,142,27,41714
"Merrifield CDP, Minnesota",102,102,0,122,27,41804
"Middle River city, Minnesota",150,148,2,272,27,41912
"Midway CDP, Minnesota",9,7,2,32,27,42010
"Miesville city, Minnesota",53,51,2,114,27,42092
"Milaca city, Minnesota",1576,1562,14,3031,27,42110
"Milan city, Minnesota",194,161,33,398,27,42146
"Millerville city, Minnesota",62,62,0,112,27,42254
"Millville city, Minnesota",101,98,3,257,27,42290
"Milroy city, Minnesota",129,115,14,216,27,42362
"Miltona city, Minnesota",221,215,6,399,27,42398
"Minneapolis city, Minnesota",259198,244212,14986,426877,27,43000
"Minneiska city, Minnesota",66,66,0,102,27,43036
"Minneota city, Minnesota",738,722,16,1420,27,43126
"Minnesota City city, Minnesota",103,92,11,172,27,43144
"Minnesota Lake city, Minnesota",353,335,18,608,27,43198
"Minnetonka city, Minnesota",30473,29703,770,53529,27,43252
"Minnetonka Beach city, Minnesota",240,240,0,463,27,43270
"Minnetrista city, Minnesota",4283,4183,100,8347,27,43306
"Mizpah city, Minnesota",17,16,1,59,27,43540
"Montevideo city, Minnesota",2610,2501,109,5350,27,43720
"Montgomery city, Minnesota",1742,1693,49,3326,27,43738
"Monticello city, Minnesota",8082,7938,144,14447,27,43774
"Montrose city, Minnesota",1976,1882,94,3779,27,43810
"Moorhead city, Minnesota",24964,23735,1229,44443,27,43864
"Moose Lake city, Minnesota",694,688,6,3282,27,43954
"Mora city, Minnesota",1672,1632,40,3685,27,44044
"Morgan city, Minnesota",424,419,5,870,27,44116
"Morris city, Minnesota",2747,2736,11,5094,27,44242
"Morristown city, Minnesota",563,525,38,912,27,44296
"Morton city, Minnesota",176,174,2,370,27,44368
"Motley city, Minnesota",314,299,15,647,27,44422
"Mound city, Minnesota",5337,5143,194,9272,27,44476
"Mounds View city, Minnesota",7432,7113,319,13100,27,44530
"Mountain Iron city, Minnesota",1506,1465,41,2862,27,44548
"Mountain Lake city, Minnesota",871,822,49,1900,27,44566
"Murdock city, Minnesota",149,140,9,285,27,44818
"Myrtle city, Minnesota",13,13,0,54,27,44890
"Nashua city, Minnesota",16,16,0,55,27,44944
"Nashwauk city, Minnesota",541,513,28,1091,27,44980
"Nassau city, Minnesota",19,19,0,52,27,45016
"Naytahwaush CDP, Minnesota",140,105,35,472,27,45052
"Nelson city, Minnesota",56,54,2,97,27,45106
"Nerstrand city, Minnesota",120,119,1,217,27,45196
"Nett Lake CDP, Minnesota",67,61,6,203,27,45279
"Nevis city, Minnesota",197,193,4,429,27,45340
"New Auburn city, Minnesota",264,256,8,468,27,45376
"New Brighton city, Minnesota",12292,12008,284,23141,27,45430
"Newfolden city, Minnesota",245,241,4,448,27,45520
"New Germany city, Minnesota",358,353,5,585,27,45556
"New Hope city, Minnesota",12090,11472,618,21620,27,45628
"New London city, Minnesota",556,550,6,1193,27,45682
"New Munich city, Minnesota",149,149,0,297,27,45772
"Newport city, Minnesota",2261,2179,82,4163,27,45790
"New Prague city, Minnesota",4190,4039,151,8155,27,45808
"New Richland city, Minnesota",476,452,24,1020,27,45862
"New Trier city, Minnesota",46,44,2,72,27,46024
"New Ulm city, Minnesota",7482,7270,212,14055,27,46042
"New York Mills city, Minnesota",611,580,31,1166,27,46060
"Nicollet city, Minnesota",567,556,11,873,27,46150
"Nielsville city, Minnesota",36,29,7,88,27,46258
"Nimrod city, Minnesota",49,49,0,75,27,46294
"Nisswa city, Minnesota",972,962,10,1733,27,46348
"Norcross city, Minnesota",50,50,0,104,27,46492
"North Branch city, Minnesota",6211,5981,230,10968,27,46798
"Northfield city, Minnesota",11444,10736,708,20518,27,46924
"North Mankato city, Minnesota",7889,7731,158,14238,27,47068
"North Oaks city, Minnesota",2114,2006,108,5193,27,47104
"Northome city, Minnesota",111,107,4,216,27,47122
"Northrop city, Minnesota",110,110,0,208,27,47212
"North St. Paul city, Minnesota",6620,6356,264,12465,27,47221
"Norwood Young America city, Minnesota",2079,1966,113,3852,27,47520
"Nowthen city, Minnesota",2484,2413,71,4518,27,47536
"Oakdale city, Minnesota",15066,14465,601,28029,27,47680
"Oak Grove city, Minnesota",5262,5129,133,8956,27,47690
"Oak Park Heights city, Minnesota",1848,1792,56,4790,27,47914
"Odessa city, Minnesota",50,50,0,97,27,48058
"Odin city, Minnesota",65,65,0,150,27,48094
"Ogema city, Minnesota",124,118,6,237,27,48130
"Ogilvie city, Minnesota",228,221,7,411,27,48166
"Okabena city, Minnesota",90,85,5,180,27,48184
"Oklee city, Minnesota",196,196,0,399,27,48202
"Olivia city, Minnesota",1133,1075,58,2358,27,48256
"Onamia city, Minnesota",254,245,9,796,27,48310
"Ormsby city, Minnesota",58,57,1,122,27,48562
"Orono city, Minnesota",4259,4123,136,8223,27,48580
"Oronoco city, Minnesota",854,851,3,1696,27,48598
"Orr city, Minnesota",243,243,0,393,27,48634
"Ortonville city, Minnesota",927,902,25,2081,27,48706
"Osage CDP, Minnesota",89,79,10,211,27,48760
"Osakis city, Minnesota",716,706,10,1706,27,48796
"Oslo city, Minnesota",139,136,3,327,27,48976
"Osseo city, Minnesota",1525,1428,97,2634,27,49012
"Ostrander city, Minnesota",161,159,2,332,27,49030
"Otsego city, Minnesota",11375,11199,176,20455,27,49138
"Ottertail city, Minnesota",268,260,8,478,27,49210
"Owatonna city, Minnesota",13938,13442,496,26400,27,49300
"Palisade city, Minnesota",49,45,4,128,27,49498
"Parkers Prairie city, Minnesota",524,499,25,1209,27,49732
"Park Rapids city, Minnesota",2016,1912,104,4163,27,49768
"Paynesville city, Minnesota",1205,1169,36,2432,27,49966
"Pease city, Minnesota",122,117,5,221,27,50056
"Pelican Rapids city, Minnesota",1047,1018,29,2589,27,50164
"Pemberton city, Minnesota",130,124,6,231,27,50200
"Pennock city, Minnesota",292,274,18,515,27,50344
"Pequot Lakes city, Minnesota",1009,925,84,2135,27,50416
"Perham city, Minnesota",1827,1477,350,3524,27,50470
"Perley city, Minnesota",76,57,19,119,27,50506
"Peterson city, Minnesota",133,132,1,268,27,50596
"Pickwick CDP, Minnesota",75,61,14,142,27,50740
"Pierz city, Minnesota",729,714,15,1613,27,50776
"Pillager city, Minnesota",246,236,10,460,27,50902
"Pine Bend CDP, Minnesota",14,14,0,28,27,51028
"Pine City city, Minnesota",1486,1413,73,3205,27,51064
"Pine Island city, Minnesota",2127,2079,48,3831,27,51136
"Pine Point CDP, Minnesota",75,58,17,285,27,51234
"Pine River city, Minnesota",406,397,9,845,27,51280
"Pine Springs city, Minnesota",204,197,7,443,27,51316
"Pipestone city, Minnesota",1939,1862,77,4171,27,51388
"Plainview city, Minnesota",1622,1552,70,3477,27,51424
"Plato city, Minnesota",117,117,0,218,27,51460
"Plummer city, Minnesota",200,198,2,325,27,51712
"Plymouth city, Minnesota",45080,44135,945,79918,27,51730
"Ponemah CDP, Minnesota",257,205,52,852,27,51892
"Porter city, Minnesota",104,103,1,185,27,52144
"Preston city, Minnesota",630,602,28,1222,27,52450
"Princeton city, Minnesota",2602,2549,53,4898,27,52522
"Prinsburg city, Minnesota",267,267,0,515,27,52558
"Prior Lake city, Minnesota",15822,15584,238,27608,27,52594
"Proctor city, Minnesota",1645,1605,40,3113,27,52630
"Quamba city, Minnesota",34,33,1,61,27,52756
"Racine city, Minnesota",266,262,4,477,27,52882
"Ramsey city, Minnesota",15803,15119,684,27774,27,53026
"Randall city, Minnesota",351,329,22,635,27,53080
"Randolph city, Minnesota",287,266,21,484,27,53098
"Ranier city, Minnesota",300,281,19,602,27,53134
"Raymond city, Minnesota",402,383,19,747,27,53296
"Redby CDP, Minnesota",414,348,66,1228,27,53386
"Red Lake CDP, Minnesota",590,477,113,1435,27,53458
"Red Lake Falls city, Minnesota",659,654,5,1288,27,53476
"Red Wing city, Minnesota",8173,7751,422,16627,27,53620
"Redwood Falls city, Minnesota",2469,2445,24,5091,27,53656
"Regal city, Minnesota",27,27,0,44,27,53710
"Remer city, Minnesota",174,153,21,363,27,53782
"Renville city, Minnesota",644,601,43,1397,27,53890
"Revere city, Minnesota",20,20,0,64,27,53908
"Rice city, Minnesota",1149,1123,26,1900,27,53998
"Rice Lake CDP, Minnesota",83,70,13,272,27,54056
"Rice Lake city, Minnesota",2095,2079,16,4120,27,54060
"Richfield city, Minnesota",21763,20753,1010,36809,27,54214
"Richmond city, Minnesota",767,756,11,1329,27,54268
"Richville city, Minnesota",19,19,0,48,27,54340
"Riverland CDP, Minnesota",101,73,28,299,27,54596
"Riverton city, Minnesota",65,65,0,136,27,54736
"Robbinsdale city, Minnesota",8477,7983,494,14452,27,54808
"Rochester city, Minnesota",67552,65026,2526,120848,27,54880
"Rock Creek city, Minnesota",919,892,27,1694,27,54934
"Rockford city, Minnesota",2809,2721,88,4638,27,55006
"Rockville city, Minnesota",1214,1201,13,2271,27,55078
"Rogers city, Minnesota",7002,6912,90,13283,27,55186
"Rollingstone city, Minnesota",304,299,5,601,27,55276
"Ronneby CDP, Minnesota",29,27,2,54,27,55366
"Roosevelt city, Minnesota",101,101,0,175,27,55438
"Roscoe city, Minnesota",57,55,2,104,27,55510
"Roseau city, Minnesota",1467,1400,67,2731,27,55546
"Rose Creek city, Minnesota",227,225,2,473,27,55600
"Rosemount city, Minnesota",14902,14443,459,25993,27,55726
"Roseville city, Minnesota",19091,18075,1016,36066,27,55852
"Rothsay city, Minnesota",255,252,3,509,27,56014
"Round Lake city, Minnesota",265,255,10,404,27,56086
"Royalton city, Minnesota",640,591,49,1179,27,56176
"Roy Lake CDP, Minnesota",10,10,0,62,27,56212
"Rush City city, Minnesota",1371,1294,77,3239,27,56266
"Rushford city, Minnesota",910,877,33,1816,27,56284
"Rushford Village city, Minnesota",387,386,1,714,27,56302
"Rushmore city, Minnesota",162,155,7,337,27,56338
"Russell city, Minnesota",155,145,10,304,27,56428
"Ruthton city, Minnesota",113,111,2,200,27,56482
"Rutledge city, Minnesota",102,100,2,251,27,56518
"Sabin city, Minnesota",321,312,9,619,27,56554
"Sacred Heart city, Minnesota",238,226,12,597,27,56572
"St. Anthony city (Hennepin and Ramsey Counties), Minnesota",4678,4596,82,9332,27,56680
"St. Anthony city (Stearns County), Minnesota",36,36,0,57,27,56698
"St. Augusta city, Minnesota",1986,1914,72,3520,27,56724
"St. Bonifacius city, Minnesota",1171,1132,39,1956,27,56770
"St. Charles city, Minnesota",2320,2261,59,3979,27,56788
"St. Clair city, Minnesota",471,450,21,789,27,56824
"St. Cloud city, Minnesota",38779,36025,2754,68910,27,56896
"St. Francis city, Minnesota",4439,4319,120,8198,27,56950
"St. Hilaire city, Minnesota",167,165,2,258,27,57022
"St. James city, Minnesota",2064,1844,220,4757,27,57040
"St. John's University CDP, Minnesota",1086,1004,82,1643,27,57094
"St. Joseph city, Minnesota",4400,4281,119,7066,27,57130
"St. Leo city, Minnesota",60,57,3,151,27,57202
"St. Louis Park city, Minnesota",31410,30529,881,49500,27,57220
"St. Martin city, Minnesota",172,172,0,308,27,57238
"St. Marys Point city, Minnesota",228,221,7,467,27,57292
"St. Michael city, Minnesota",10909,10628,281,18648,27,57346
"St. Paul city, Minnesota",170506,161928,8578,308806,27,58000
"St. Paul Park city, Minnesota",3306,3291,15,5497,27,58018
"St. Peter city, Minnesota",7008,6870,138,12039,27,58036
"St. Rosa city, Minnesota",27,27,0,50,27,58072
"St. Stephen city, Minnesota",494,474,20,782,27,58090
"St. Vincent city, Minnesota",28,27,1,43,27,58144
"Sanborn city, Minnesota",170,166,4,350,27,58306
"Sandstone city, Minnesota",662,626,36,2566,27,58396
"Sargeant city, Minnesota",32,32,0,41,27,58576
"Sartell city, Minnesota",10578,10299,279,19382,27,58612
"Sauk Centre city, Minnesota",2521,2350,171,4568,27,58648
"Sauk Rapids city, Minnesota",7617,7394,223,13830,27,58684
"Savage city, Minnesota",19392,18631,761,32441,27,58738
"Scandia city, Minnesota",1595,1578,17,3965,27,58900
"Scanlon city, Minnesota",557,510,47,1047,27,58936
"Seaforth city, Minnesota",44,43,1,103,27,59098
"Searles CDP, Minnesota",118,117,1,285,27,59116
"Sebeka city, Minnesota",345,332,13,724,27,59152
"Sedan city, Minnesota",19,19,0,29,27,59188
"Shafer city, Minnesota",661,640,21,1111,27,59314
"Shakopee city, Minnesota",25203,24224,979,44135,27,59350
"Shelly city, Minnesota",97,84,13,192,27,59566
"Sherburn city, Minnesota",499,464,35,1035,27,59620
"Shevlin city, Minnesota",85,82,3,172,27,59782
"Shoreview city, Minnesota",13797,13238,559,26846,27,59998
"Shorewood city, Minnesota",3987,3784,203,7722,27,60016
"Silver Bay city, Minnesota",737,708,29,1690,27,60250
"Silver Creek CDP, Minnesota",71,66,5,141,27,60322
"Silver Lake city, Minnesota",464,429,35,822,27,60376
"Skyline city, Minnesota",143,139,4,270,27,60754
"Slayton city, Minnesota",1039,1000,39,2053,27,60808
"Sleepy Eye city, Minnesota",1902,1823,79,3452,27,60844
"Sobieski city, Minnesota",107,106,1,166,27,61006
"Solway city, Minnesota",58,58,0,114,27,61114
"Soudan CDP, Minnesota",212,191,21,423,27,61204
"South End CDP, Minnesota",16,9,7,39,27,61340
"South Haven city, Minnesota",106,106,0,179,27,61402
"South St. Paul city, Minnesota",12080,11388,692,20598,27,61492
"Spicer city, Minnesota",718,704,14,1190,27,61690
"Springfield city, Minnesota",902,882,20,2090,27,61816
"Spring Grove city, Minnesota",602,572,30,1361,27,61852
"Spring Hill city, Minnesota",64,64,0,98,27,61888
"Spring Lake Park city, Minnesota",3573,3475,98,6966,27,61996
"Spring Park city, Minnesota",1024,988,36,1919,27,62014
"Spring Valley city, Minnesota",1354,1301,53,2512,27,62104
"Squaw Lake city, Minnesota",46,42,4,96,27,62284
"Stacy city, Minnesota",992,932,60,1895,27,62320
"Stanchfield CDP, Minnesota",50,47,3,94,27,62356
"Staples city, Minnesota",894,845,49,2299,27,62446
"Starbuck city, Minnesota",667,663,4,1269,27,62500
"Steen city, Minnesota",56,53,3,104,27,62662
"Stephen city, Minnesota",259,249,10,552,27,62698
"Stewart city, Minnesota",301,288,13,554,27,62788
"Stewartville city, Minnesota",3529,3485,44,6684,27,62806
"Stillwater city, Minnesota",10342,10075,267,19316,27,62824
"Stockton city, Minnesota",390,375,15,723,27,62896
"Storden city, Minnesota",112,112,0,258,27,63022
"Strandquist city, Minnesota",53,43,10,75,27,63112
"Strathcona city, Minnesota",7,7,0,13,27,63130
"Sturgeon Lake city, Minnesota",248,240,8,445,27,63220
"Sunburg city, Minnesota",36,35,1,89,27,63454
"Sunfish Lake city, Minnesota",265,262,3,553,27,63544
"Swanville city, Minnesota",116,114,2,212,27,63778
"Taconite city, Minnesota",309,301,8,625,27,64048
"Tamarack city, Minnesota",37,35,2,76,27,64156
"Taopi city, Minnesota",30,30,0,53,27,64210
"Taunton city, Minnesota",115,114,1,169,27,64264
"Taylors Falls city, Minnesota",678,665,13,1219,27,64318
"Tenstrike city, Minnesota",120,116,4,181,27,64444
"The Lakes CDP, Minnesota",347,339,8,647,27,64543
"The Ranch CDP, Minnesota",2,0,2,3,27,64547
"Thief River Falls city, Minnesota",4815,4751,64,8871,27,64570
"Tintah city, Minnesota",29,29,0,60,27,64948
"Tonka Bay city, Minnesota",713,659,54,1462,27,65164
"Tower city, Minnesota",202,188,14,410,27,65272
"Tracy city, Minnesota",1010,976,34,2006,27,65308
"Trail city, Minnesota",12,12,0,47,27,65344
"Trimont city, Minnesota",363,351,12,684,27,65470
"Trommald city, Minnesota",61,45,16,106,27,65506
"Trosky city, Minnesota",42,42,0,68,27,65542
"Truman city, Minnesota",638,636,2,1216,27,65668
"Turtle River city, Minnesota",25,25,0,67,27,65794
"Twin Lakes city, Minnesota",104,104,0,186,27,65920
"Twin Lakes CDP, Minnesota",91,88,3,217,27,65927
"Twin Valley city, Minnesota",292,259,33,711,27,65938
"Two Harbors city, Minnesota",1737,1710,27,3620,27,65956
"Tyler city, Minnesota",542,534,8,1042,27,66046
"Ulen city, Minnesota",133,131,2,428,27,66136
"Underwood city, Minnesota",213,205,8,420,27,66172
"Upsala city, Minnesota",220,210,10,425,27,66334
"Urbank city, Minnesota",25,25,0,34,27,66388
"Utica city, Minnesota",97,97,0,187,27,66424
"Vadnais Heights city, Minnesota",6790,6458,332,12864,27,66460
"Vergas city, Minnesota",114,111,3,242,27,66766
"Vermillion city, Minnesota",239,235,4,467,27,66802
"Verndale city, Minnesota",211,198,13,480,27,66874
"Vernon Center city, Minnesota",231,229,2,362,27,66910
"Vesta city, Minnesota",156,143,13,322,27,66982
"Victoria city, Minnesota",6087,5826,261,10681,27,67036
"Viking city, Minnesota",47,47,0,100,27,67090
"Villard city, Minnesota",119,117,2,268,27,67144
"Vineland CDP, Minnesota",225,169,56,792,27,67180
"Vining city, Minnesota",36,36,0,97,27,67216
"Virginia city, Minnesota",3575,3372,203,8415,27,67288
"Wabasha city, Minnesota",1181,1136,45,2560,27,67378
"Wabasso city, Minnesota",266,263,3,622,27,67396
"Waconia city, Minnesota",7205,6976,229,12993,27,67432
"Wadena city, Minnesota",2099,1874,225,4328,27,67504
"Wahkon city, Minnesota",109,100,9,271,27,67558
"Waite Park city, Minnesota",4292,4054,238,8290,27,67612
"Waldorf city, Minnesota",72,70,2,176,27,67756
"Walker city, Minnesota",361,334,27,937,27,67792
"Walnut Grove city, Minnesota",342,340,2,734,27,67846
"Walters city, Minnesota",38,30,8,73,27,67900
"Waltham city, Minnesota",101,95,6,193,27,67918
"Wanamingo city, Minnesota",633,619,14,1189,27,67972
"Wanda city, Minnesota",55,55,0,82,27,68008
"Warba city, Minnesota",67,60,7,161,27,68080
"Warren city, Minnesota",748,733,15,1649,27,68170
"Warroad city, Minnesota",947,878,69,2076,27,68224
"Warsaw CDP, Minnesota",463,442,21,774,27,68260
"Waseca city, Minnesota",4282,4081,201,9208,27,68296
"Watertown city, Minnesota",2870,2870,0,4712,27,68548
"Waterville city, Minnesota",990,945,45,1680,27,68584
"Watkins city, Minnesota",420,417,3,831,27,68620
"Watson city, Minnesota",98,93,5,191,27,68656
"Waubun city, Minnesota",174,151,23,395,27,68674
"Waverly city, Minnesota",1051,1047,4,1803,27,68764
"Wayzata city, Minnesota",1943,1917,26,4365,27,68818
"Welcome city, Minnesota",399,367,32,824,27,69070
"Wells city, Minnesota",1101,1062,39,2278,27,69106
"Wendell city, Minnesota",105,105,0,185,27,69142
"Westbrook city, Minnesota",396,392,4,832,27,69250
"West Concord city, Minnesota",393,374,19,873,27,69304
"Westport city, Minnesota",22,22,0,45,27,69628
"West Roy Lake CDP, Minnesota",9,9,0,43,27,69690
"West St. Paul city, Minnesota",11504,10934,570,20820,27,69700
"West Union city, Minnesota",45,41,4,77,27,69736
"Whalan city, Minnesota",36,36,0,71,27,69808
"Wheaton city, Minnesota",547,528,19,1341,27,69844
"Whipholt CDP, Minnesota",36,33,3,74,27,69880
"White Bear Lake city, Minnesota",12707,12128,579,24317,27,69970
"White Earth CDP, Minnesota",258,206,52,733,27,70006
"Wilder city, Minnesota",11,11,0,42,27,70258
"Willernie city, Minnesota",281,222,59,463,27,70366
"Williams city, Minnesota",108,92,16,261,27,70402
"Willmar city, Minnesota",10879,10291,588,21006,27,70420
"Willow River city, Minnesota",194,170,24,368,27,70492
"Wilmont city, Minnesota",137,132,5,257,27,70582
"Wilton city, Minnesota",107,78,29,242,27,70708
"Windom city, Minnesota",2322,2198,124,4770,27,70798
"Winger city, Minnesota",85,82,3,155,27,70870
"Winnebago city, Minnesota",661,621,40,1245,27,70924
"Winona city, Minnesota",15163,14750,413,26083,27,71032
"Winsted city, Minnesota",1173,1160,13,1962,27,71086
"Winthrop city, Minnesota",610,589,21,1296,27,71122
"Winton city, Minnesota",59,57,2,107,27,71140
"Wolf Lake city, Minnesota",47,47,0,73,27,71338
"Wolverton city, Minnesota",79,73,6,141,27,71392
"Woodbury city, Minnesota",42586,41206,1380,75549,27,71428
"Wood Lake city, Minnesota",194,188,6,376,27,71446
"Woodland city, Minnesota",257,241,16,562,27,71500
"Woodstock city, Minnesota",82,82,0,171,27,71680
"Worthington city, Minnesota",6645,6410,235,13838,27,71734
"Wrenshall city, Minnesota",177,174,3,362,27,71788
"Wright city, Minnesota",41,35,6,109,27,71824
"Wykoff city, Minnesota",218,215,3,389,27,71950
"Wyoming city, Minnesota",4441,4310,131,8037,27,72022
"Zemple city, Minnesota",63,63,0,113,27,72184
"Zimmerman city, Minnesota",3369,3358,11,6243,27,72238
"Zumbro Falls city, Minnesota",99,99,0,151,27,72310
"Zumbrota city, Minnesota",2073,2015,58,3777,27,72328
"Abbeville town, Mississippi",204,185,19,395,28,00100
"Aberdeen city, Mississippi",2044,1913,131,4972,28,00180
"Ackerman town, Mississippi",660,541,119,1793,28,00300
"Agricola CDP, Mississippi",203,203,0,512,28,00460
"Alcorn State University CDP, Mississippi",490,485,5,1071,28,00680
"Algoma town, Mississippi",383,379,4,834,28,00820
"Alligator town, Mississippi",69,69,0,247,28,00940
"Amory city, Mississippi",3331,3070,261,6642,28,01260
"Anguilla town, Mississippi",272,259,13,613,28,01500
"Arcola town, Mississippi",50,41,9,208,28,01820
"Arkabutla CDP, Mississippi",150,150,0,326,28,01940
"Arnold Line CDP, Mississippi",678,640,38,1789,28,02060
"Artesia town, Mississippi",130,128,2,374,28,02100
"Ashland town, Mississippi",221,217,4,663,28,02140
"Austin CDP, Mississippi",0,0,0,0,28,02380
"Baldwyn city, Mississippi",1238,1156,82,3178,28,02700
"Bassfield town, Mississippi",96,92,4,293,28,03580
"Batesville city, Mississippi",3066,2929,137,7464,28,03620
"Baxterville CDP, Mississippi",262,262,0,416,28,03940
"Bay St. Louis city, Mississippi",4624,4198,426,9788,28,03980
"Bay Springs city, Mississippi",669,652,17,1789,28,04060
"Beaumont town, Mississippi",315,305,10,857,28,04500
"Beauregard village, Mississippi",206,182,24,500,28,04540
"Beechwood CDP, Mississippi",1378,1377,1,3468,28,04705
"Belmont town, Mississippi",1185,1175,10,2606,28,05100
"Belzoni city, Mississippi",649,562,87,1947,28,05140
"Benndale CDP, Mississippi",0,0,0,0,28,05180
"Benoit town, Mississippi",198,168,30,547,28,05220
"Benton CDP, Mississippi",181,155,26,311,28,05340
"Bentonia town, Mississippi",118,113,5,343,28,05380
"Bethlehem CDP, Mississippi",47,47,0,226,28,05780
"Beulah town, Mississippi",128,106,22,334,28,05820
"Big Creek village, Mississippi",67,67,0,144,28,06060
"Biggersville CDP, Mississippi",60,60,0,128,28,06100
"Big Point CDP, Mississippi",732,669,63,918,28,06180
"Biloxi city, Mississippi",22680,20832,1848,49141,28,06220
"Blue Mountain town, Mississippi",455,450,5,1100,28,07060
"Blue Springs village, Mississippi",167,161,6,277,28,07100
"Bobo CDP, Mississippi",64,64,0,108,28,07220
"Bogue Chitto CDP (Lincoln County), Mississippi",167,167,0,301,28,07322
"Bogue Chitto CDP (Kemper and Neshoba Counties), Mississippi",113,113,0,319,28,07330
"Bolivar CDP, Mississippi",24,24,0,49,28,07460
"Bolton town, Mississippi",557,545,12,936,28,07540
"Bond CDP, Mississippi",91,73,18,234,28,07620
"Booneville city, Mississippi",3621,3455,166,9027,28,07780
"Bovina CDP, Mississippi",107,107,0,277,28,07900
"Boyle town, Mississippi",339,304,35,700,28,08180
"Brandon city, Mississippi",12449,11923,526,25142,28,08300
"Braxton village, Mississippi",81,73,8,220,28,08460
"Bridgetown CDP, Mississippi",1688,1480,208,2893,28,08655
"Brookhaven city, Mississippi",4689,4427,262,11714,28,08820
"Brooksville town, Mississippi",202,175,27,799,28,08980
"Bruce town, Mississippi",518,501,17,1523,28,09180
"Buckatunna CDP, Mississippi",80,80,0,182,28,09380
"Bude town, Mississippi",268,252,16,964,28,09460
"Burnsville town, Mississippi",338,317,21,814,28,09820
"Byhalia town, Mississippi",809,770,39,1990,28,10060
"Byram city, Mississippi",6898,6640,258,12922,28,10140
"Caledonia town, Mississippi",545,535,10,1196,28,10460
"Calhoun City town, Mississippi",726,674,52,1853,28,10580
"Canton city, Mississippi",4868,4674,194,10951,28,11100
"Carrollton town, Mississippi",160,160,0,435,28,11580
"Carthage city, Mississippi",1929,1762,167,4861,28,11780
"Cary town, Mississippi",203,186,17,414,28,11820
"Centreville town, Mississippi",735,728,7,2352,28,12740
"Chalybeate CDP, Mississippi",11,11,0,11,28,12780
"Charleston city, Mississippi",1039,885,154,2624,28,12900
"Chunky town, Mississippi",129,119,10,267,28,13580
"Clara CDP, Mississippi",290,290,0,597,28,13700
"Clarksdale city, Mississippi",5930,5182,748,14769,28,13820
"Cleary CDP, Mississippi",889,751,138,2010,28,14140
"Cleveland city, Mississippi",4339,4020,319,11082,28,14260
"Clinton city, Mississippi",13034,12488,546,27668,28,14420
"Cloverdale CDP, Mississippi",267,267,0,569,28,14540
"Coahoma town, Mississippi",73,62,11,195,28,14580
"Coffeeville town, Mississippi",332,321,11,984,28,14740
"Coldwater town, Mississippi",576,558,18,1237,28,14900
"Collins city, Mississippi",724,630,94,2270,28,15140
"Collinsville CDP, Mississippi",811,811,0,1783,28,15180
"Columbia city, Mississippi",1793,1639,154,5831,28,15340
"Columbus city, Mississippi",10137,9139,998,23896,28,15380
"Columbus AFB CDP, Mississippi",351,345,6,1428,28,15420
"Como town, Mississippi",535,364,171,1570,28,15500
"Conehatta CDP, Mississippi",358,358,0,1240,28,15540
"Corinth city, Mississippi",6344,5811,533,14520,28,15700
"Courtland town, Mississippi",307,296,11,961,28,15980
"Crawford town, Mississippi",178,172,6,415,28,16420
"Crenshaw town, Mississippi",353,291,62,864,28,16460
"Crosby town, Mississippi",67,59,8,239,28,16620
"Crowder town, Mississippi",181,161,20,718,28,16940
"Cruger town, Mississippi",89,79,10,267,28,16980
"Crystal Springs city, Mississippi",1875,1784,91,4820,28,17060
"Darling CDP, Mississippi",51,51,0,157,28,17700
"Decatur town, Mississippi",720,642,78,2325,28,18180
"De Kalb town, Mississippi",267,252,15,757,28,18340
"DeLisle CDP, Mississippi",680,680,0,1583,28,18420
"Delta City CDP, Mississippi",0,0,0,0,28,18500
"Dennis CDP, Mississippi",0,0,0,21,28,18700
"Derma town, Mississippi",351,325,26,819,28,18940
"De Soto CDP, Mississippi",109,109,0,273,28,18980
"Diamondhead city, Mississippi",4236,4130,106,9360,28,19100
"D'Iberville city, Mississippi",6631,6218,413,12922,28,19180
"D'Lo town, Mississippi",203,168,35,540,28,19340
"Doddsville town, Mississippi",11,11,0,198,28,19420
"Drew city, Mississippi",882,783,99,2225,28,20020
"Dublin CDP, Mississippi",0,0,0,0,28,20220
"Duck Hill town, Mississippi",332,330,2,840,28,20260
"Dumas town, Mississippi",158,154,4,323,28,20340
"Duncan town, Mississippi",146,129,17,352,28,20380
"Dundee CDP, Mississippi",18,18,0,45,28,20420
"Durant city, Mississippi",627,564,63,2133,28,20500
"Eagle Bend CDP, Mississippi",38,38,0,202,28,20610
"Eastabuchie CDP, Mississippi",119,119,0,148,28,20740
"Ecru town, Mississippi",671,645,26,1404,28,21340
"Eden village, Mississippi",96,56,40,211,28,21420
"Edwards town, Mississippi",267,244,23,903,28,21580
"Elizabeth CDP, Mississippi",129,129,0,259,28,21860
"Elliott CDP, Mississippi",278,278,0,629,28,21940
"Ellisville city, Mississippi",1352,1226,126,4615,28,22020
"Enterprise town, Mississippi",237,234,3,514,28,22580
"Escatawpa CDP, Mississippi",1127,952,175,3239,28,22900
"Ethel town, Mississippi",109,99,10,369,28,23220
"Eudora CDP, Mississippi",230,219,11,478,28,23340
"Eupora city, Mississippi",769,561,208,2279,28,23420
"Falcon town, Mississippi",51,49,2,173,28,24180
"Falkner town, Mississippi",273,239,34,812,28,24220
"Farmington town, Mississippi",1021,971,50,2534,28,24420
"Farrell CDP, Mississippi",114,110,4,265,28,24460
"Fayette city, Mississippi",510,509,1,1640,28,24500
"Fernwood CDP, Mississippi",109,109,0,121,28,24740
"Flora town, Mississippi",1090,1029,61,2380,28,24940
"Florence city, Mississippi",2623,2415,208,4596,28,24980
"Flowood city, Mississippi",5459,5206,253,10204,28,25100
"Forest city, Mississippi",2139,1987,152,5416,28,25340
"Foxworth CDP, Mississippi",164,130,34,606,28,25740
"French Camp town, Mississippi",92,90,2,247,28,26020
"Friars Point town, Mississippi",429,384,45,1083,28,26060
"Fulton city, Mississippi",1703,1605,98,4494,28,26300
"Gattman village, Mississippi",90,90,0,159,28,26780
"Gautier city, Mississippi",9502,8512,990,19007,28,26860
"Georgetown town, Mississippi",81,80,1,258,28,26980
"Glen town, Mississippi",197,160,37,428,28,27540
"Glen Allan CDP, Mississippi",43,43,0,234,28,27580
"Glendale CDP, Mississippi",682,646,36,1514,28,27620
"Glendora village, Mississippi",77,23,54,142,28,27660
"Gloster town, Mississippi",402,358,44,1319,28,27820
"Gluckstadt CDP, Mississippi",1608,1483,125,2998,28,27900
"Golden town, Mississippi",113,109,4,212,28,27940
"Goodman town, Mississippi",299,246,53,1287,28,28220
"Grace CDP, Mississippi",39,39,0,227,28,28500
"Greenville city, Mississippi",11661,10318,1343,29495,28,29180
"Greenwood city, Mississippi",6114,5632,482,14242,28,29340
"Grenada city, Mississippi",5741,5380,361,12594,28,29460
"Gulf Hills CDP, Mississippi",4608,4402,206,8647,28,29620
"Gulf Park Estates CDP, Mississippi",3665,3608,57,6965,28,29660
"Gulfport city, Mississippi",33056,29286,3770,72524,28,29700
"Gunnison town, Mississippi",111,86,25,376,28,29900
"Guntown town, Mississippi",1101,1051,50,2279,28,29940
"Hamilton CDP, Mississippi",123,115,8,236,28,30220
"Harperville CDP, Mississippi",53,42,11,336,28,30780
"Hatley town, Mississippi",272,246,26,632,28,30980
"Hattiesburg city, Mississippi",25144,23182,1962,48466,28,31020
"Hazlehurst city, Mississippi",1343,1279,64,3601,28,31220
"Heidelberg town, Mississippi",272,263,9,746,28,31420
"Helena CDP, Mississippi",385,380,5,692,28,31460
"Henderson Point CDP, Mississippi",16,16,0,211,28,31540
"Hermanville CDP, Mississippi",104,104,0,495,28,31740
"Hernando city, Mississippi",8210,8026,184,17262,28,31780
"Hickory town, Mississippi",180,179,1,470,28,31980
"Hickory Flat town, Mississippi",247,217,30,730,28,32020
"Hide-A-Way Lake CDP, Mississippi",1311,1178,133,2194,28,32110
"Hillsboro CDP, Mississippi",408,293,115,962,28,32460
"Holcomb CDP, Mississippi",124,124,0,143,28,32820
"Hollandale city, Mississippi",892,753,139,2371,28,32900
"Holly Springs city, Mississippi",2777,2558,219,6942,28,33100
"Horn Lake city, Mississippi",14120,13003,1117,26652,28,33700
"Houston city, Mississippi",1543,1492,51,3762,28,33900
"Hurley CDP, Mississippi",709,700,9,1391,28,34340
"Independence CDP, Mississippi",94,94,0,131,28,34700
"Indianola city, Mississippi",4085,3562,523,9572,28,34740
"Inverness town, Mississippi",431,402,29,939,28,35020
"Isola town, Mississippi",324,280,44,740,28,35220
"Itta Bena city, Mississippi",694,497,197,1532,28,35260
"Iuka city, Mississippi",1106,1041,65,3117,28,35300
"Jacinto CDP, Mississippi",12,12,0,12,28,35340
"Jackson city, Mississippi",72700,65911,6789,153271,28,36000
"Jonestown town, Mississippi",325,246,79,959,28,36800
"Jumpertown town, Mississippi",195,183,12,424,28,37040
"Kearney Park CDP, Mississippi",222,222,0,867,28,37190
"Kilmichael town, Mississippi",292,259,33,833,28,37560
"Kiln CDP, Mississippi",1032,1032,0,2156,28,37600
"Kirkville CDP, Mississippi",272,272,0,342,28,37840
"Kokomo CDP, Mississippi",74,74,0,340,28,38160
"Kosciusko city, Mississippi",3237,3059,178,7056,28,38320
"Kossuth village, Mississippi",64,62,2,144,28,38360
"Lake town, Mississippi",221,221,0,512,28,38600
"Lakeview CDP, Mississippi",124,124,0,394,28,38910
"Lamar CDP, Mississippi",0,0,0,0,28,39000
"Lambert town, Mississippi",449,376,73,1074,28,39080
"Latimer CDP, Mississippi",3268,3005,263,6436,28,39520
"Lauderdale CDP, Mississippi",104,95,9,214,28,39600
"Laurel city, Mississippi",7106,6657,449,17241,28,39640
"Leaf CDP, Mississippi",0,0,0,16,28,39800
"Leakesville town, Mississippi",550,486,64,5463,28,39840
"Learned town, Mississippi",11,9,2,51,28,39880
"Leland city, Mississippi",1991,1863,128,3939,28,40280
"Lena town, Mississippi",57,57,0,111,28,40360
"Lexington city, Mississippi",578,547,31,1154,28,40600
"Liberty town, Mississippi",247,231,16,871,28,40640
"Long Beach city, Mississippi",7902,7445,457,16809,28,41680
"Longview CDP, Mississippi",167,167,0,215,28,41960
"Louin town, Mississippi",235,225,10,478,28,42200
"Louise town, Mississippi",60,60,0,138,28,42240
"Louisville city, Mississippi",2022,1881,141,6061,28,42280
"Lucedale city, Mississippi",790,686,104,2914,28,42440
"Lula town, Mississippi",103,98,5,202,28,42600
"Lumberton city, Mississippi",673,543,130,1588,28,42640
"Lyman CDP, Mississippi",513,449,64,1440,28,42800
"Lynchburg CDP, Mississippi",1374,1185,189,1950,28,42840
"Lyon town, Mississippi",198,194,4,381,28,42960
"Maben town, Mississippi",380,356,24,1024,28,42980
"McComb city, Mississippi",4673,4401,272,12295,28,43280
"McCool town, Mississippi",18,18,0,58,28,43400
"McLain town, Mississippi",83,82,1,367,28,43840
"Macon city, Mississippi",1437,1297,140,3293,28,44240
"Madison city, Mississippi",13668,13300,368,27595,28,44520
"Magee city, Mississippi",1865,1774,91,3974,28,44600
"Magnolia city, Mississippi",1091,1008,83,3243,28,44680
"Mantachie town, Mississippi",872,844,28,1803,28,44920
"Mantee village, Mississippi",281,278,3,465,28,44960
"Marietta town, Mississippi",85,80,5,171,28,45120
"Marion town, Mississippi",875,825,50,2257,28,45160
"Marks city, Mississippi",623,557,66,1633,28,45240
"Mathiston town, Mississippi",365,346,19,807,28,45720
"Mayersville town, Mississippi",46,21,25,242,28,46000
"Meadville town, Mississippi",187,184,3,690,28,46200
"Mendenhall city, Mississippi",1016,934,82,2593,28,46600
"Meridian city, Mississippi",14471,13226,1245,34990,28,46640
"Meridian Station CDP, Mississippi",179,159,20,557,28,46680
"Merigold town, Mississippi",328,328,0,564,28,46720
"Metcalfe town, Mississippi",383,340,43,1079,28,46880
"Mississippi State CDP, Mississippi",1115,993,122,4095,28,48030
"Mississippi Valley State University CDP, Mississippi",301,301,0,936,28,48120
"Mize town, Mississippi",108,103,5,321,28,48240
"Monticello town, Mississippi",394,365,29,1277,28,48560
"Montrose town, Mississippi",49,49,0,115,28,48640
"Mooreville CDP, Mississippi",870,646,224,1839,28,48720
"Moorhead city, Mississippi",512,407,105,1512,28,48760
"Morgan City town, Mississippi",72,65,7,186,28,48800
"Morgantown CDP, Mississippi",427,386,41,930,28,48880
"Morton city, Mississippi",1232,1221,11,3690,28,49080
"Moselle CDP, Mississippi",12,12,0,24,28,49160
"Moss Point city, Mississippi",5170,4660,510,12173,28,49240
"Mound Bayou city, Mississippi",569,546,23,1623,28,49320
"Mount Olive town, Mississippi",666,645,21,1405,28,49520
"Mount Pleasant CDP, Mississippi",147,147,0,418,28,49640
"Myrtle town, Mississippi",370,365,5,706,28,50280
"Natchez city, Mississippi",5367,4920,447,14380,28,50440
"Nellieburg CDP, Mississippi",498,480,18,1321,28,50720
"Nettleton city, Mississippi",748,680,68,1761,28,50880
"New Albany city, Mississippi",3261,3229,32,7657,28,51000
"New Augusta town, Mississippi",221,212,9,451,28,51040
"New Hamilton CDP, Mississippi",180,163,17,712,28,51240
"New Hebron town, Mississippi",187,181,6,477,28,51360
"New Hope CDP, Mississippi",1482,1466,16,2983,28,51400
"New Houlka town, Mississippi",244,218,26,564,28,51420
"New Site CDP, Mississippi",78,67,11,160,28,51680
"Newton city, Mississippi",1460,1366,94,3191,28,51720
"Nicholson CDP, Mississippi",1179,1141,38,2229,28,51840
"Nitta Yuma CDP, Mississippi",0,0,0,0,28,51960
"North Carrollton town, Mississippi",134,131,3,398,28,52400
"North Tunica CDP, Mississippi",489,165,324,941,28,52680
"Noxapater town, Mississippi",261,215,46,540,28,52880
"Oak Grove CDP, Mississippi",856,760,96,1569,28,53080
"Oakland town, Mississippi",164,113,51,382,28,53200
"Ocean Springs city, Mississippi",8997,8625,372,18417,28,53520
"Okolona city, Mississippi",899,839,60,2597,28,53680
"Olive Branch city, Mississippi",24950,24278,672,45938,28,54040
"Osyka town, Mississippi",133,125,8,408,28,54640
"Ovett CDP, Mississippi",34,0,34,107,28,54680
"Oxford city, Mississippi",13110,12683,427,25713,28,54840
"Pace town, Mississippi",78,78,0,156,28,54920
"Pachuta town, Mississippi",71,61,10,212,28,54960
"Paden village, Mississippi",39,35,4,98,28,55000
"Panther Burn CDP, Mississippi",16,16,0,69,28,55160
"Paris CDP, Mississippi",92,92,0,378,28,55280
"Pascagoula city, Mississippi",9151,8053,1098,21904,28,55360
"Pass Christian city, Mississippi",2607,2388,219,5802,28,55400
"Pattison CDP, Mississippi",0,0,0,100,28,55560
"Pearl city, Mississippi",15145,14343,802,27255,28,55760
"Pearlington CDP, Mississippi",392,377,15,803,28,55920
"Pearl River CDP, Mississippi",1815,1695,120,4298,28,55930
"Pelahatchie town, Mississippi",827,766,61,1871,28,56200
"Petal city, Mississippi",5275,4937,338,11047,28,56800
"Pheba CDP, Mississippi",12,12,0,22,28,56920
"Philadelphia city, Mississippi",3013,2696,317,7065,28,56960
"Picayune city, Mississippi",4996,4712,284,11804,28,57160
"Pickens town, Mississippi",360,355,5,1096,28,57200
"Pittsboro village, Mississippi",144,144,0,233,28,58360
"Plantersville town, Mississippi",443,391,52,910,28,58440
"Polkville town, Mississippi",281,260,21,594,28,58960
"Pontotoc city, Mississippi",2567,2438,129,5676,28,59160
"Pope village, Mississippi",290,282,8,529,28,59240
"Poplarville city, Mississippi",1100,953,147,2814,28,59480
"Porterville CDP, Mississippi",0,0,0,0,28,59520
"Port Gibson city, Mississippi",462,366,96,1165,28,59560
"Potts Camp town, Mississippi",114,111,3,310,28,59720
"Prentiss town, Mississippi",247,232,15,985,28,59920
"Puckett village, Mississippi",171,167,4,420,28,60360
"Purvis city, Mississippi",709,672,37,1809,28,60480
"Quitman city, Mississippi",668,627,41,1808,28,60720
"Raleigh town, Mississippi",403,340,63,1020,28,60840
"Randolph CDP, Mississippi",136,136,0,567,28,60880
"Rawls Springs CDP, Mississippi",1230,1164,66,2069,28,61080
"Raymond city, Mississippi",623,581,42,1974,28,61160
"Red Banks CDP, Mississippi",9,9,0,41,28,61240
"Redwater CDP, Mississippi",229,193,36,514,28,61400
"Redwood CDP, Mississippi",46,46,0,73,28,61440
"Rena Lara CDP, Mississippi",97,97,0,217,28,61840
"Renova town, Mississippi",377,347,30,1008,28,61890
"Richland city, Mississippi",3607,3457,150,7208,28,62400
"Richton town, Mississippi",369,369,0,1150,28,62480
"Ridgeland city, Mississippi",14479,13852,627,24618,28,62520
"Rienzi town, Mississippi",94,92,2,302,28,62560
"Ripley city, Mississippi",2909,2630,279,5440,28,62600
"Robinhood CDP, Mississippi",621,618,3,1291,28,62900
"Rolling Fork city, Mississippi",960,783,177,2172,28,63560
"Rosedale city, Mississippi",433,379,54,1871,28,63720
"Roxie town, Mississippi",324,306,18,861,28,64080
"Ruleville city, Mississippi",1244,1019,225,2633,28,64200
"Runnelstown CDP, Mississippi",290,290,0,369,28,64240
"St. Martin CDP, Mississippi",3498,3303,195,7843,28,64680
"Sallis town, Mississippi",95,95,0,177,28,64800
"Saltillo city, Mississippi",2739,2635,104,4910,28,64840
"Sandersville town, Mississippi",284,272,12,574,28,64920
"Sardis town, Mississippi",723,627,96,2168,28,65560
"Satartia village, Mississippi",27,27,0,44,28,65680
"Saucier CDP, Mississippi",571,475,96,1199,28,65720
"Schlater town, Mississippi",54,45,9,225,28,66080
"Scooba town, Mississippi",192,144,48,717,28,66160
"Scott CDP, Mississippi",22,22,0,39,28,66240
"Sebastopol town, Mississippi",101,93,8,267,28,66280
"Seminary town, Mississippi",159,159,0,350,28,66400
"Senatobia city, Mississippi",3880,3684,196,8288,28,66440
"Shannon town, Mississippi",685,637,48,1663,28,66720
"Sharon CDP, Mississippi",1234,1162,72,1920,28,66840
"Shaw city, Mississippi",577,530,47,1615,28,67000
"Shelby city, Mississippi",382,318,64,1751,28,67040
"Sherman town, Mississippi",312,304,8,646,28,67200
"Shubuta town, Mississippi",165,146,19,414,28,67520
"Shuqualak town, Mississippi",152,136,16,354,28,67640
"Sidon town, Mississippi",50,47,3,174,28,67840
"Silver City town, Mississippi",81,79,2,201,28,67920
"Silver Creek town, Mississippi",54,46,8,209,28,67960
"Skene CDP, Mississippi",105,105,0,256,28,68200
"Slate Springs village, Mississippi",40,40,0,72,28,68320
"Sledge town, Mississippi",186,179,7,374,28,68400
"Smithville town, Mississippi",267,254,13,741,28,68720
"Snow Lake Shores town, Mississippi",159,140,19,364,28,68960
"Soso town, Mississippi",233,222,11,472,28,69160
"Southaven city, Mississippi",28566,27386,1180,54908,28,69280
"Standing Pine CDP, Mississippi",210,198,12,573,28,70120
"Starkville city, Mississippi",12505,11512,993,24274,28,70240
"State Line town, Mississippi",386,230,156,824,28,70320
"Stewart CDP, Mississippi",49,14,35,127,28,70640
"Stoneville CDP, Mississippi",9,9,0,24,28,70720
"Stonewall town, Mississippi",365,323,42,881,28,70760
"Strayhorn CDP, Mississippi",27,27,0,96,28,71040
"Sturgis town, Mississippi",77,73,4,177,28,71320
"Summit town, Mississippi",1080,981,99,2774,28,71480
"Sumner town, Mississippi",137,125,12,367,28,71520
"Sumrall town, Mississippi",1167,1079,88,2194,28,71560
"Sunflower town, Mississippi",460,439,21,1144,28,71600
"Sylvarena village, Mississippi",27,26,1,82,28,72040
"Symonds CDP, Mississippi",0,0,0,27,28,72080
"Taylor village, Mississippi",124,124,0,251,28,72360
"Taylorsville town, Mississippi",753,753,0,1915,28,72400
"Tchula town, Mississippi",742,622,120,2274,28,72440
"Terry town, Mississippi",585,580,5,1541,28,72680
"Thaxton town, Mississippi",330,327,3,651,28,72760
"Tillatoba town, Mississippi",38,38,0,57,28,73440
"Tishomingo town, Mississippi",224,222,2,526,28,73720
"Toccopola town, Mississippi",149,141,8,263,28,73760
"Toomsuba CDP, Mississippi",316,232,84,728,28,73880
"Tremont town, Mississippi",124,115,9,321,28,74400
"Tucker CDP, Mississippi",90,90,0,376,28,74675
"Tula CDP, Mississippi",66,43,23,96,28,74720
"Tunica town, Mississippi",484,471,13,1062,28,74760
"Tunica Resorts CDP, Mississippi",1273,1221,52,2096,28,74820
"Tupelo city, Mississippi",18889,17931,958,37939,28,74840
"Tutwiler town, Mississippi",816,720,96,2509,28,75040
"Tylertown town, Mississippi",788,657,131,2341,28,75160
"Union town, Mississippi",886,760,126,2780,28,75360
"University CDP, Mississippi",887,885,2,4480,28,75520
"Utica town, Mississippi",344,332,12,977,28,75760
"Vaiden town, Mississippi",145,142,3,1122,28,75880
"Valley Park CDP, Mississippi",24,24,0,120,28,76040
"Vancleave CDP, Mississippi",2343,2197,146,5207,28,76200
"Van Vleet CDP, Mississippi",0,0,0,21,28,76240
"Vardaman town, Mississippi",413,401,12,972,28,76320
"Verona city, Mississippi",1464,1380,84,2800,28,76560
"Vicksburg city, Mississippi",9129,8516,613,21337,28,76720
"Victoria CDP, Mississippi",668,668,0,1245,28,76760
"Wade CDP, Mississippi",502,261,241,1349,28,77080
"Walls town, Mississippi",716,676,40,1386,28,77400
"Walnut town, Mississippi",283,264,19,716,28,77480
"Walnut Grove town, Mississippi",197,162,35,721,28,77520
"Walthall village, Mississippi",36,36,0,134,28,77640
"Waterford CDP, Mississippi",0,0,0,12,28,77880
"Water Valley city, Mississippi",1447,1379,68,3383,28,78000
"Waveland city, Mississippi",3744,3406,338,7075,28,78200
"Waynesboro city, Mississippi",1289,1222,67,4576,28,78360
"Webb town, Mississippi",160,140,20,489,28,78480
"Weir town, Mississippi",296,243,53,788,28,78520
"Wesson town, Mississippi",764,707,57,2286,28,78640
"West town, Mississippi",156,156,0,200,28,78680
"West Hattiesburg CDP, Mississippi",2876,2464,412,6234,28,78890
"West Point city, Mississippi",4105,3652,453,10063,28,79120
"Wheeler CDP, Mississippi",412,412,0,525,28,79280
"White Oak CDP, Mississippi",150,140,10,551,28,79620
"Wiggins city, Mississippi",1839,1609,230,4266,28,80160
"Winona city, Mississippi",1470,1344,126,4422,28,80760
"Winstonville town, Mississippi",48,48,0,105,28,80800
"Winterville CDP, Mississippi",20,18,2,105,28,80840
"Woodland village, Mississippi",114,107,7,157,28,81000
"Woodville town, Mississippi",499,451,48,1124,28,81120
"Yazoo City city, Mississippi",4530,3782,748,10573,28,81520
"Adrian city, Missouri",968,859,109,2021,29,00244
"Advance city, Missouri",705,679,26,1451,29,00262
"Affton CDP, Missouri",11931,11699,232,19922,29,00280
"Agency village, Missouri",478,467,11,757,29,00298
"Airport Drive village, Missouri",431,431,0,675,29,00424
"Alba city, Missouri",318,315,3,721,29,00496
"Albany city, Missouri",889,862,27,1859,29,00514
"Aldrich village, Missouri",20,17,3,60,29,00568
"Alexandria city, Missouri",4,4,0,48,29,00604
"Allendale village, Missouri",13,13,0,56,29,00712
"Allenville village, Missouri",33,31,2,91,29,00748
"Alma city, Missouri",235,226,9,448,29,00802
"Altamont village, Missouri",54,54,0,156,29,00910
"Altenburg city, Missouri",200,198,2,387,29,00928
"Alton city, Missouri",295,287,8,761,29,00964
"Amazonia village, Missouri",136,133,3,280,29,01018
"Amity town, Missouri",63,63,0,76,29,01054
"Amoret city, Missouri",86,81,5,135,29,01072
"Amsterdam city, Missouri",54,53,1,146,29,01090
"Anderson city, Missouri",1034,1007,27,2561,29,01198
"Annada village, Missouri",24,24,0,44,29,01252
"Annapolis city, Missouri",148,114,34,422,29,01270
"Anniston town, Missouri",63,63,0,246,29,01288
"Appleton City city, Missouri",578,555,23,1330,29,01522
"Arbela town, Missouri",5,5,0,25,29,01576
"Arbyrd city, Missouri",169,169,0,428,29,01630
"Arcadia city, Missouri",242,237,5,595,29,01648
"Archie city, Missouri",575,567,8,1292,29,01702
"Arcola village, Missouri",12,12,0,32,29,01720
"Argyle town, Missouri",88,88,0,141,29,01828
"Arkoe town, Missouri",45,45,0,79,29,01864
"Armstrong city, Missouri",134,127,7,262,29,01954
"Arnold city, Missouri",11026,10635,391,20840,29,01972
"Arrow Point village, Missouri",29,29,0,102,29,02034
"Arrow Rock town, Missouri",15,15,0,36,29,02044
"Asbury city, Missouri",258,256,2,562,29,02098
"Ashburn town, Missouri",0,0,0,0,29,02152
"Ash Grove city, Missouri",674,646,28,1617,29,02188
"Ashland city, Missouri",2849,2828,21,4730,29,02242
"Ashley CDP, Missouri",0,0,0,35,29,02260
"Atlanta city, Missouri",269,252,17,546,29,02422
"Augusta town, Missouri",138,135,3,290,29,02512
"Aullville village, Missouri",52,51,1,162,29,02530
"Aurora city, Missouri",3282,3000,282,7290,29,02548
"Aurora Springs CDP, Missouri",74,74,0,198,29,02584
"Auxvasse city, Missouri",666,604,62,1286,29,02638
"Ava city, Missouri",1130,1034,96,2933,29,02674
"Avalon CDP, Missouri",23,23,0,47,29,02692
"Avilla town, Missouri",30,26,4,65,29,02746
"Avondale city, Missouri",184,175,9,343,29,02800
"Bagnell town, Missouri",36,32,4,63,29,02962
"Baker village, Missouri",0,0,0,0,29,03034
"Bakersfield village, Missouri",92,87,5,231,29,03052
"Baldwin Park village, Missouri",15,11,4,46,29,03124
"Ballwin city, Missouri",16482,16118,364,30948,29,03160
"Baring city, Missouri",19,14,5,26,29,03322
"Barnard city, Missouri",104,103,1,212,29,03340
"Barnett city, Missouri",55,52,3,138,29,03376
"Barnhart CDP, Missouri",3416,3354,62,6040,29,03394
"Bates City city, Missouri",63,52,11,154,29,03556
"Battlefield city, Missouri",3425,3313,112,6046,29,03592
"Bella Villa city, Missouri",419,398,21,695,29,04114
"Bell City city, Missouri",266,178,88,509,29,04132
"Belle city, Missouri",601,587,14,1249,29,04150
"Bellefontaine Neighbors city, Missouri",4090,3838,252,10637,29,04222
"Bellerive Acres city, Missouri",220,208,12,421,29,04248
"Bellflower city, Missouri",98,82,16,305,29,04330
"Bel-Nor village, Missouri",699,681,18,1349,29,04348
"Bel-Ridge village, Missouri",1204,984,220,2687,29,04366
"Belton city, Missouri",12949,12247,702,24241,29,04384
"Bennett Springs CDP, Missouri",25,25,0,109,29,04525
"Benton city, Missouri",397,382,15,783,29,04798
"Benton City village, Missouri",67,67,0,117,29,04834
"Bent Tree Harbor CDP, Missouri",82,82,0,305,29,04864
"Berger city, Missouri",118,112,6,201,29,04888
"Berkeley city, Missouri",3578,3431,147,8232,29,04906
"Bernie city, Missouri",659,645,14,1916,29,04960
"Bertrand city, Missouri",300,294,6,743,29,04996
"Bethany city, Missouri",1233,1207,26,3113,29,05068
"Bethel village, Missouri",70,69,1,127,29,05104
"Beverly Hills city, Missouri",316,308,8,469,29,05248
"Bevier city, Missouri",301,283,18,633,29,05266
"Biehle CDP, Missouri",27,27,0,37,29,05320
"Bigelow village, Missouri",1,1,0,3,29,05464
"Big Lake village, Missouri",21,21,0,69,29,05495
"Big Spring CDP, Missouri",49,49,0,49,29,05608
"Billings city, Missouri",353,342,11,854,29,05626
"Birch Tree city, Missouri",204,195,9,408,29,05734
"Birmingham village, Missouri",77,69,8,161,29,05824
"Bismarck city, Missouri",661,635,26,1617,29,05878
"Blackburn city, Missouri",107,107,0,205,29,05950
"Black Jack city, Missouri",3047,2717,330,6632,29,06004
"Blackwater city, Missouri",109,107,2,214,29,06148
"Blairstown city, Missouri",26,25,1,59,29,06238
"Blanchard CDP, Missouri",13,13,0,38,29,06247
"Bland city, Missouri",178,177,1,573,29,06256
"Blodgett village, Missouri",86,80,6,190,29,06346
"Bloomfield city, Missouri",744,684,60,2172,29,06382
"Bloomsdale city, Missouri",504,493,11,911,29,06454
"Blue Eye town, Missouri",131,124,7,389,29,06526
"Blue Springs city, Missouri",30790,29562,1228,58720,29,06652
"Blue Summit CDP, Missouri",296,296,0,782,29,06670
"Blythedale village, Missouri",129,124,5,384,29,06742
"Bogard city, Missouri",92,92,0,188,29,06832
"Bolckow city, Missouri",121,117,4,235,29,06922
"Bolivar city, Missouri",4532,4304,228,10780,29,06976
"Bonne Terre city, Missouri",2127,2049,78,6863,29,07102
"Boonville city, Missouri",3081,2861,220,7725,29,07318
"Bosworth city, Missouri",85,69,16,160,29,07426
"Bourbon city, Missouri",811,790,21,1759,29,07534
"Bowling Green city, Missouri",1462,1343,119,4149,29,07660
"Bragg City town, Missouri",16,15,1,89,29,07876
"Brandsville city, Missouri",19,16,3,183,29,07948
"Branson city, Missouri",6104,5861,243,12651,29,07966
"Branson West city, Missouri",162,143,19,449,29,07989
"Brashear city, Missouri",55,54,1,124,29,08002
"Braymer city, Missouri",344,337,7,691,29,08038
"Breckenridge city, Missouri",240,238,2,514,29,08128
"Breckenridge Hills city, Missouri",2417,2220,197,4452,29,08164
"Brentwood city, Missouri",5047,4931,116,8173,29,08236
"Brewer CDP, Missouri",305,246,59,477,29,08272
"Briarwood Estates CDP, Missouri",91,91,0,279,29,08294
"Bridgeton city, Missouri",5606,5374,232,11422,29,08398
"Brimson village, Missouri",25,24,1,42,29,08470
"Bronaugh city, Missouri",56,52,4,111,29,08614
"Brookfield city, Missouri",1917,1865,52,4142,29,08650
"Brooklyn Heights town, Missouri",59,58,1,113,29,08776
"Broseley CDP, Missouri",30,30,0,55,29,08812
"Browning city, Missouri",127,125,2,295,29,08884
"Brownington town, Missouri",38,34,4,86,29,08902
"Brumley town, Missouri",37,37,0,96,29,08974
"Brunswick city, Missouri",313,294,19,856,29,09046
"Bucklin city, Missouri",155,150,5,434,29,09388
"Buckner city, Missouri",1648,1579,69,2941,29,09424
"Buell CDP, Missouri",24,24,0,24,29,09496
"Buffalo city, Missouri",1159,1127,32,3319,29,09514
"Bull Creek village, Missouri",233,221,12,567,29,09642
"Bunceton city, Missouri",169,166,3,298,29,09658
"Bunker city, Missouri",136,121,15,344,29,09694
"Burfordville CDP, Missouri",61,48,13,129,29,09784
"Burgess CDP, Missouri",20,20,0,42,29,09802
"Burlington Junction city, Missouri",193,191,2,509,29,09838
"Butler city, Missouri",1608,1372,236,4541,29,10054
"Butterfield city, Missouri",235,218,17,511,29,10144
"Byrnes Mill city, Missouri",1288,1266,22,3155,29,10240
"Cabool city, Missouri",928,906,22,2543,29,10288
"Cainsville city, Missouri",94,91,3,210,29,10342
"Cairo village, Missouri",105,102,3,242,29,10360
"Caledonia village, Missouri",84,84,0,194,29,10432
"Calhoun city, Missouri",157,151,6,357,29,10450
"California city, Missouri",2512,2389,123,4520,29,10468
"Callao city, Missouri",119,108,11,301,29,10486
"Calverton Park city, Missouri",603,513,90,1295,29,10612
"Camden city, Missouri",44,35,9,90,29,10738
"Camden Point city, Missouri",251,247,4,469,29,10792
"Camdenton city, Missouri",1917,1888,29,3979,29,10810
"Cameron city, Missouri",3007,2764,243,9101,29,10828
"Campbell city, Missouri",625,575,50,1639,29,10864
"Canalou city, Missouri",67,67,0,144,29,11026
"Canton city, Missouri",1400,1244,156,2733,29,11134
"Cape Girardeau city, Missouri",20537,19829,708,39795,29,11242
"Cardwell city, Missouri",357,341,16,770,29,11350
"Carl Junction city, Missouri",3829,3749,80,8197,29,11368
"Carrollton city, Missouri",1503,1454,49,3454,29,11566
"Carterville city, Missouri",848,775,73,1951,29,11638
"Carthage city, Missouri",6454,6168,286,15491,29,11656
"Caruthersville city, Missouri",2145,2031,114,5504,29,11692
"Carytown city, Missouri",134,134,0,304,29,11728
"Cassville city, Missouri",1404,1404,0,3193,29,11890
"Castle Point CDP, Missouri",1221,1142,79,2940,29,11908
"Catron town, Missouri",12,12,0,41,29,12052
"Cave town, Missouri",0,0,0,4,29,12079
"Cedar Hill CDP, Missouri",820,789,31,1453,29,12358
"Cedar Hill Lakes village, Missouri",155,149,6,282,29,12376
"Center city, Missouri",210,204,6,542,29,12592
"Centertown town, Missouri",173,166,7,331,29,12664
"Centerview city, Missouri",123,114,9,248,29,12682
"Centerville city, Missouri",127,116,11,269,29,12718
"Centralia city, Missouri",2158,2067,91,4570,29,12898
"Chaffee city, Missouri",1413,1351,62,3037,29,12988
"Chain of Rocks village, Missouri",137,137,0,272,29,13006
"Chain-O-Lakes village, Missouri",56,56,0,222,29,13015
"Chamois city, Missouri",149,135,14,400,29,13060
"Champ village, Missouri",4,4,0,6,29,13078
"Charlack city, Missouri",913,828,85,1933,29,13330
"Charleston city, Missouri",1324,1219,105,4683,29,13366
"Charmwood town, Missouri",13,13,0,14,29,13390
"Cherokee Pass CDP, Missouri",124,117,7,196,29,13474
"Chesapeake CDP, Missouri",0,0,0,0,29,13582
"Chesterfield city, Missouri",25573,24788,785,49645,29,13600
"Chilhowee town, Missouri",96,88,8,267,29,13654
"Chillicothe city, Missouri",3807,3673,134,9091,29,13690
"Chula city, Missouri",67,63,4,146,29,13852
"Clarence city, Missouri",343,335,8,936,29,13978
"Clark city, Missouri",94,87,7,204,29,14068
"Clarksburg city, Missouri",112,76,36,293,29,14140
"Clarksdale city, Missouri",134,100,34,310,29,14158
"Clarkson Valley city, Missouri",1154,1131,23,2608,29,14176
"Clarksville city, Missouri",189,176,13,472,29,14194
"Clarkton city, Missouri",419,408,11,1094,29,14212
"Claycomo village, Missouri",947,889,58,1815,29,14554
"Clayton city, Missouri",7778,7590,188,17212,29,14572
"Clearmont city, Missouri",73,73,0,152,29,14662
"Cleveland city, Missouri",447,436,11,923,29,14770
"Clever city, Missouri",1577,1547,30,2926,29,14788
"Cliff Village village, Missouri",15,15,0,23,29,14806
"Clifton Hill city, Missouri",43,41,2,87,29,14896
"Climax Springs CDP, Missouri",103,103,0,141,29,14914
"Clinton city, Missouri",4175,3760,415,8908,29,14986
"Clyde village, Missouri",17,17,0,38,29,15130
"Cobalt village, Missouri",108,108,0,269,29,15220
"Coffey city, Missouri",41,41,0,126,29,15274
"Cole Camp city, Missouri",549,546,3,1363,29,15436
"Collins village, Missouri",38,38,0,107,29,15562
"Columbia city, Missouri",69015,66236,2779,126172,29,15670
"Commerce village, Missouri",64,60,4,154,29,15760
"Conception CDP, Missouri",87,87,0,266,29,15886
"Conception Junction town, Missouri",86,83,3,198,29,15922
"Concord CDP, Missouri",9802,9496,306,18606,29,16030
"Concordia city, Missouri",1060,1053,7,2390,29,16102
"Coney Island village, Missouri",15,13,2,38,29,16115
"Connelsville CDP, Missouri",40,40,0,88,29,16138
"Conway city, Missouri",278,255,23,722,29,16192
"Cool Valley city, Missouri",478,458,20,1175,29,16228
"Cooter city, Missouri",134,126,8,343,29,16336
"Corder city, Missouri",259,255,4,595,29,16408
"Corning town, Missouri",0,0,0,2,29,16462
"Cosby village, Missouri",85,77,8,201,29,16588
"Cottleville city, Missouri",3540,3485,55,5584,29,16678
"Country Club village, Missouri",1532,1435,97,3191,29,16802
"Country Club Hills city, Missouri",618,554,64,1201,29,16822
"Country Life Acres village, Missouri",46,46,0,93,29,16876
"Cowgill city, Missouri",91,74,17,201,29,16984
"Craig city, Missouri",39,39,0,92,29,17056
"Crane city, Missouri",557,533,24,1470,29,17074
"Creighton city, Missouri",153,138,15,329,29,17164
"Crestwood city, Missouri",6761,6663,98,12315,29,17218
"Creve Coeur city, Missouri",10184,9938,246,18679,29,17272
"Crocker city, Missouri",366,354,12,862,29,17344
"Cross Timbers city, Missouri",66,16,50,377,29,17524
"Crystal City city, Missouri",2390,2264,126,4721,29,17632
"Crystal Lake Park city, Missouri",193,190,3,460,29,17650
"Crystal Lakes city, Missouri",208,204,4,456,29,17660
"Cuba city, Missouri",1276,1276,0,3173,29,17668
"Curryville city, Missouri",83,78,5,255,29,17902
"Dadeville village, Missouri",100,89,11,207,29,17992
"Dalton town, Missouri",14,14,0,55,29,18118
"Danville CDP, Missouri",0,0,0,0,29,18190
"Dardenne Prairie city, Missouri",7370,7203,167,12903,29,18253
"Darlington village, Missouri",7,7,0,47,29,18316
"Dawn CDP, Missouri",47,47,0,81,29,18496
"Dearborn city, Missouri",189,185,4,498,29,18658
"Deepwater city, Missouri",123,113,10,385,29,18730
"Deerfield village, Missouri",14,14,0,47,29,18802
"Deering CDP, Missouri",26,26,0,61,29,18838
"Defiance CDP, Missouri",61,61,0,81,29,18910
"De Kalb town, Missouri",241,241,0,528,29,18946
"Dellwood city, Missouri",2788,2692,96,4899,29,19018
"Delta city, Missouri",336,327,9,502,29,19072
"Dennis Acres village, Missouri",37,36,1,52,29,19090
"Denton CDP, Missouri",48,48,0,99,29,19144
"Denver village, Missouri",9,9,0,21,29,19162
"Des Arc village, Missouri",88,83,5,195,29,19198
"Desloge city, Missouri",2656,2461,195,4875,29,19216
"De Soto city, Missouri",3237,3092,145,6430,29,19252
"Des Peres city, Missouri",4439,4418,21,9140,29,19270
"De Witt city, Missouri",11,11,0,51,29,19378
"Dexter city, Missouri",3153,3125,28,7910,29,19396
"Diamond town, Missouri",534,505,29,982,29,19432
"Diehlstadt village, Missouri",48,46,2,117,29,19486
"Diggins village, Missouri",152,151,1,280,29,19504
"Dixon city, Missouri",558,554,4,1158,29,19630
"Doe Run CDP, Missouri",375,375,0,790,29,19684
"Doniphan city, Missouri",838,788,50,2138,29,19792
"Doolittle city, Missouri",257,252,5,669,29,19828
"Dover town, Missouri",37,36,1,126,29,19918
"Downing city, Missouri",124,121,3,332,29,19990
"Drexel city, Missouri",517,490,27,983,29,20134
"Dudley city, Missouri",63,63,0,94,29,20296
"Duenweg city, Missouri",852,828,24,1604,29,20314
"Duquesne village, Missouri",1190,1155,35,2297,29,20512
"Dutchtown CDP, Missouri",134,116,18,208,29,20566
"Eagle Rock CDP, Missouri",39,39,0,66,29,20656
"Eagleville town, Missouri",179,175,4,375,29,20674
"East Lynne city, Missouri",104,102,2,203,29,20980
"Easton city, Missouri",116,115,1,263,29,21034
"East Prairie city, Missouri",1089,1024,65,2969,29,21052
"Edgar Springs city, Missouri",51,51,0,125,29,21214
"Edgerton city, Missouri",227,227,0,499,29,21250
"Edina city, Missouri",641,619,22,1379,29,21322
"Edinburg CDP, Missouri",20,20,0,87,29,21340
"Edmundson city, Missouri",590,580,10,1224,29,21376
"Eldon city, Missouri",2162,2107,55,4435,29,21484
"El Dorado Springs city, Missouri",1497,1441,56,3531,29,21502
"Ellington city, Missouri",600,443,157,1302,29,21844
"Ellisville city, Missouri",4974,4715,259,9914,29,21898
"Ellsinore city, Missouri",211,209,2,442,29,21916
"Elmer city, Missouri",8,8,0,21,29,21988
"Elmira village, Missouri",10,10,0,18,29,22006
"Elmo city, Missouri",84,79,5,188,29,22024
"Elsberry city, Missouri",755,715,40,1975,29,22114
"Emerald Beach village, Missouri",92,89,3,211,29,22250
"Eminence city, Missouri",169,155,14,462,29,22276
"Emma city, Missouri",133,133,0,257,29,22312
"Eolia village, Missouri",213,208,5,440,29,22474
"Essex city, Missouri",246,244,2,366,29,22600
"Ethel town, Missouri",16,16,0,64,29,22672
"Eugene CDP, Missouri",88,88,0,143,29,22798
"Eureka city, Missouri",6015,5689,326,12008,29,22834
"Evergreen village, Missouri",27,27,0,95,29,22951
"Everton city, Missouri",99,89,10,267,29,22996
"Ewing city, Missouri",133,133,0,442,29,23032
"Excello CDP, Missouri",22,22,0,27,29,23050
"Excelsior Estates village, Missouri",150,141,9,313,29,23077
"Excelsior Springs city, Missouri",5477,5256,221,10546,29,23086
"Exeter city, Missouri",432,422,10,946,29,23122
"Fairdealing CDP, Missouri",263,263,0,411,29,23248
"Fairfax city, Missouri",344,332,12,646,29,23266
"Fair Grove city, Missouri",892,849,43,1625,29,23338
"Fair Play city, Missouri",183,177,6,509,29,23428
"Fairview town, Missouri",173,130,43,398,29,23518
"Farber city, Missouri",186,186,0,373,29,23662
"Farley village, Missouri",136,136,0,239,29,23698
"Farmington city, Missouri",6656,6373,283,17859,29,23752
"Faucett CDP, Missouri",96,96,0,193,29,23824
"Fayette city, Missouri",993,980,13,2790,29,23842
"Fenton city, Missouri",2253,2039,214,4097,29,23950
"Ferguson city, Missouri",9084,8602,482,18546,29,23986
"Ferrelview village, Missouri",364,342,22,635,29,24058
"Festus city, Missouri",5930,5612,318,12772,29,24094
"Fidelity town, Missouri",162,156,6,368,29,24120
"Fillmore city, Missouri",117,116,1,231,29,24184
"Fisk city, Missouri",227,224,3,508,29,24328
"Fleming city, Missouri",28,27,1,81,29,24562
"Flemington village, Missouri",18,17,1,62,29,24580
"Flint Hill city, Missouri",517,512,5,1041,29,24688
"Flordell Hills city, Missouri",647,442,205,1448,29,24706
"Florida village, Missouri",0,0,0,0,29,24760
"Florissant city, Missouri",28707,26883,1824,52167,29,24778
"Foley city, Missouri",67,65,2,159,29,24886
"Fordland city, Missouri",288,271,17,634,29,25012
"Forest City city, Missouri",82,81,1,208,29,25066
"Foristell city, Missouri",325,323,2,750,29,25120
"Forsyth city, Missouri",943,915,28,2731,29,25192
"Fortescue town, Missouri",18,18,0,41,29,25228
"Fort Leonard Wood CDP, Missouri",2968,2841,127,15615,29,25264
"Fortuna CDP, Missouri",38,38,0,57,29,25300
"Foster village, Missouri",41,41,0,70,29,25372
"Fountain N' Lakes village, Missouri",72,39,33,198,29,25411
"Frankclay CDP, Missouri",20,20,0,124,29,25516
"Frankford city, Missouri",251,233,18,460,29,25552
"Franklin city, Missouri",56,46,10,188,29,25624
"Fredericktown city, Missouri",2104,1954,150,4438,29,25768
"Freeburg village, Missouri",178,170,8,387,29,25822
"Freeman city, Missouri",293,268,25,560,29,25894
"Freistatt village, Missouri",140,140,0,255,29,25912
"Fremont CDP, Missouri",0,0,0,0,29,25948
"Fremont Hills city, Missouri",558,542,16,1272,29,25957
"Friedenswald village, Missouri",0,0,0,0,29,26000
"Frisbee CDP, Missouri",33,33,0,58,29,26020
"Frohna city, Missouri",183,182,1,328,29,26092
"Frontenac city, Missouri",1748,1677,71,3639,29,26110
"Fulton city, Missouri",5111,4573,538,12648,29,26182
"Gainesville city, Missouri",244,190,54,835,29,26218
"Galena city, Missouri",156,148,8,584,29,26254
"Gallatin city, Missouri",658,627,31,1747,29,26308
"Galt city, Missouri",69,67,2,189,29,26362
"Garden City city, Missouri",898,867,31,1711,29,26434
"Gasconade city, Missouri",165,157,8,254,29,26578
"Gentry village, Missouri",53,50,3,76,29,26776
"Gerald city, Missouri",655,618,37,1197,29,26866
"Gerster town, Missouri",9,9,0,20,29,26902
"Gibbs village, Missouri",15,15,0,73,29,26920
"Gideon city, Missouri",272,259,13,714,29,26974
"Gilliam city, Missouri",87,79,8,198,29,27028
"Gilman City city, Missouri",172,169,3,412,29,27064
"Ginger Blue village, Missouri",76,76,0,113,29,27100
"Gladstone city, Missouri",14094,13470,624,26964,29,27190
"Glasgow city, Missouri",563,546,17,1143,29,27208
"Glasgow Village CDP, Missouri",2054,1857,197,5482,29,27226
"Glenaire city, Missouri",310,307,3,547,29,27262
"Glen Allen town, Missouri",29,23,6,73,29,27280
"Glendale city, Missouri",2626,2604,22,6131,29,27334
"Glen Echo Park village, Missouri",51,45,6,86,29,27370
"Glenwood village, Missouri",52,41,11,178,29,27514
"Golden CDP, Missouri",209,209,0,391,29,27658
"Golden City city, Missouri",228,214,14,612,29,27676
"Goodman city, Missouri",452,436,16,1207,29,27874
"Goose Creek Lake CDP, Missouri",169,154,15,690,29,27924
"Gordonville village, Missouri",303,300,3,533,29,27928
"Goss town, Missouri",0,0,0,0,29,28000
"Gower city, Missouri",786,775,11,1718,29,28036
"Graham town, Missouri",68,63,5,139,29,28072
"Grain Valley city, Missouri",8769,8531,238,15688,29,28090
"Granby city, Missouri",1068,913,155,2274,29,28108
"Grand Falls Plaza town, Missouri",89,72,17,214,29,28170
"Grandin city, Missouri",150,150,0,269,29,28180
"Grand Pass village, Missouri",8,6,2,29,29,28198
"Grandview city, Missouri",13744,12862,882,25921,29,28324
"Granger village, Missouri",1,1,0,8,29,28360
"Grant City town, Missouri",512,506,6,1004,29,28594
"Grantwood Village town, Missouri",473,461,12,924,29,28630
"Gravois Mills town, Missouri",53,52,1,121,29,28828
"Grayhawk CDP, Missouri",507,507,0,866,29,28860
"Grayridge CDP, Missouri",30,26,4,65,29,28864
"Grayson CDP, Missouri",36,36,0,84,29,28882
"Gray Summit CDP, Missouri",1229,1198,31,2573,29,28918
"Greencastle city, Missouri",131,130,1,298,29,29116
"Green City city, Missouri",222,218,4,596,29,29134
"Greendale city, Missouri",266,246,20,833,29,29152
"Greenfield city, Missouri",526,463,63,1288,29,29206
"Green Park city, Missouri",1327,1302,25,2688,29,29324
"Green Ridge city, Missouri",264,258,6,535,29,29332
"Greentop city, Missouri",302,300,2,546,29,29422
"Greenville city, Missouri",126,121,5,444,29,29476
"Greenwood city, Missouri",3653,3598,55,6038,29,29494
"Grovespring CDP, Missouri",15,15,0,64,29,29656
"Guilford town, Missouri",44,38,6,83,29,29692
"Gunn City village, Missouri",46,46,0,98,29,29764
"Hale city, Missouri",234,233,1,543,29,29908
"Halfway village, Missouri",59,59,0,134,29,29962
"Hallsville city, Missouri",973,945,28,1993,29,29998
"Halltown village, Missouri",12,8,4,46,29,30016
"Hamilton city, Missouri",812,777,35,1879,29,30034
"Hanley Hills village, Missouri",1005,942,63,1612,29,30196
"Hannibal city, Missouri",7747,7441,306,17003,29,30214
"Hardin city, Missouri",355,349,6,659,29,30322
"Harris town, Missouri",29,29,0,52,29,30466
"Harrisburg town, Missouri",187,182,5,377,29,30484
"Harrisonville city, Missouri",5231,4820,411,10024,29,30610
"Hartsburg town, Missouri",43,43,0,130,29,30718
"Hartville city, Missouri",235,208,27,652,29,30754
"Hartwell CDP, Missouri",42,42,0,50,29,30772
"Harviell CDP, Missouri",0,0,0,0,29,30844
"Harwood village, Missouri",1,1,0,7,29,30862
"Hawk Point city, Missouri",219,172,47,537,29,31024
"Hayti city, Missouri",697,610,87,2367,29,31132
"Hayti Heights city, Missouri",142,141,1,376,29,31168
"Hayward CDP, Missouri",15,15,0,48,29,31186
"Haywood City village, Missouri",70,70,0,172,29,31204
"Hazelwood city, Missouri",14073,12722,1351,25345,29,31276
"Henrietta city, Missouri",121,113,8,295,29,31654
"Herculaneum city, Missouri",2385,2250,135,4767,29,31708
"Hermann city, Missouri",1124,1084,40,2374,29,31762
"Hermitage city, Missouri",262,190,72,684,29,31780
"Higbee city, Missouri",375,373,2,579,29,31924
"Higginsville city, Missouri",2563,2506,57,4776,29,31960
"High Hill city, Missouri",96,83,13,223,29,31996
"Highlandville city, Missouri",447,416,31,1039,29,32068
"High Ridge CDP, Missouri",2589,2492,97,4651,29,32140
"Hillsboro city, Missouri",1641,1514,127,3467,29,32248
"Hillsdale village, Missouri",515,499,16,1070,29,32266
"Hoberg village, Missouri",20,20,0,48,29,32410
"Holcomb city, Missouri",315,301,14,764,29,32536
"Holden city, Missouri",900,851,49,1840,29,32572
"Holland town, Missouri",47,46,1,97,29,32590
"Holliday village, Missouri",70,70,0,163,29,32626
"Hollister city, Missouri",2180,2017,163,4585,29,32662
"Hollywood CDP, Missouri",0,0,0,0,29,32698
"Holt city, Missouri",188,183,5,349,29,32752
"Holts Summit city, Missouri",2258,2230,28,4499,29,32770
"Homestead village, Missouri",102,95,7,157,29,32806
"Homestown city, Missouri",52,51,1,120,29,32824
"Hopkins city, Missouri",228,228,0,384,29,33004
"Horine CDP, Missouri",379,334,45,945,29,33040
"Hornersville city, Missouri",205,193,12,519,29,33076
"Houston city, Missouri",1190,1080,110,2416,29,33238
"Houstonia city, Missouri",158,156,2,245,29,33256
"Houston Lake city, Missouri",190,182,8,356,29,33292
"Howardville city, Missouri",58,56,2,173,29,33364
"Hughesville village, Missouri",91,91,0,152,29,33652
"Humansville city, Missouri",386,347,39,1256,29,33706
"Hume town, Missouri",153,138,15,348,29,33724
"Humphreys village, Missouri",15,15,0,85,29,33742
"Hunnewell city, Missouri",79,79,0,164,29,33760
"Hunter CDP, Missouri",51,51,0,103,29,33778
"Huntleigh city, Missouri",199,196,3,430,29,33850
"Huntsdale town, Missouri",6,6,0,16,29,33868
"Huntsville city, Missouri",799,791,8,1748,29,33886
"Hurdland city, Missouri",113,113,0,224,29,33904
"Hurley city, Missouri",71,71,0,109,29,33922
"Iantha CDP, Missouri",11,11,0,76,29,34192
"Iatan village, Missouri",0,0,0,6,29,34210
"Iberia city, Missouri",348,336,12,579,29,34228
"Imperial CDP, Missouri",3047,2849,198,5385,29,34354
"Independence city, Missouri",61376,57589,3787,122218,29,35000
"Indian Lake CDP, Missouri",217,202,15,1000,29,35180
"Indian Point village, Missouri",187,172,15,447,29,35186
"Innsbrook village, Missouri",298,270,28,877,29,35240
"Ionia town, Missouri",15,15,0,52,29,35306
"Irena village, Missouri",3,3,0,10,29,35324
"Irondale city, Missouri",201,179,22,560,29,35396
"Iron Mountain Lake city, Missouri",231,221,10,806,29,35450
"Ironton city, Missouri",609,576,33,1639,29,35468
"Irwin CDP, Missouri",41,41,0,41,29,35486
"Jackson city, Missouri",7782,7487,295,15394,29,35648
"Jacksonville village, Missouri",59,59,0,86,29,36224
"Jameson town, Missouri",39,34,5,136,29,36314
"Jamesport city, Missouri",296,290,6,625,29,36332
"Jamestown town, Missouri",171,168,3,331,29,36368
"Jane town, Missouri",258,242,16,535,29,36422
"Jasper city, Missouri",401,383,18,833,29,36512
"Jefferson City city, Missouri",21283,20660,623,42644,29,37000
"Jennings city, Missouri",5695,5117,578,12996,29,37178
"Jerico Springs village, Missouri",98,96,2,230,29,37214
"Jonesburg city, Missouri",340,333,7,699,29,37574
"Joplin city, Missouri",25495,24241,1254,51848,29,37592
"Josephville village, Missouri",312,312,0,728,29,37700
"Junction City village, Missouri",90,86,4,228,29,37736
"Kahoka city, Missouri",827,774,53,2134,29,37790
"Kansas City city, Missouri",278515,265204,13311,505958,29,38000
"Kearney city, Missouri",6181,6093,88,10491,29,38072
"Kelso village, Missouri",298,295,3,617,29,38216
"Kennett city, Missouri",4156,3853,303,10383,29,38306
"Keytesville city, Missouri",177,165,12,384,29,38468
"Kidder city, Missouri",177,170,7,388,29,38522
"Kimberling City city, Missouri",1047,923,124,2625,29,38612
"Kimmswick city, Missouri",53,53,0,122,29,38684
"King City city, Missouri",355,349,6,769,29,38774
"Kingdom City village, Missouri",78,78,0,126,29,38792
"Kingston city, Missouri",111,104,7,298,29,38846
"Kingsville city, Missouri",166,160,6,377,29,38918
"Kinloch city, Missouri",177,175,2,291,29,38972
"Kirbyville village, Missouri",42,42,0,109,29,39008
"Kirksville city, Missouri",6909,6505,404,17533,29,39026
"Kirkwood city, Missouri",14541,14129,412,29309,29,39044
"Kissee Mills CDP, Missouri",400,396,4,1132,29,39080
"Knob Lick CDP, Missouri",13,13,0,19,29,39170
"Knob Noster city, Missouri",1283,1169,114,2793,29,39188
"Knox City city, Missouri",61,58,3,148,29,39278
"Koshkonong town, Missouri",65,60,5,174,29,39440
"LaBarque Creek CDP, Missouri",747,728,19,1201,29,39503
"La Belle city, Missouri",265,259,6,784,29,39512
"Laclede city, Missouri",132,125,7,265,29,39566
"Laddonia city, Missouri",272,249,23,671,29,39602
"La Due village, Missouri",14,10,4,69,29,39638
"Ladue city, Missouri",4320,4262,58,8934,29,39656
"La Grange city, Missouri",439,434,5,764,29,39764
"Lake Annette city, Missouri",51,42,9,88,29,39845
"Lake Arrowhead CDP, Missouri",47,47,0,193,29,39852
"Lake Lafayette city, Missouri",75,71,4,242,29,39952
"Lake Lotawana city, Missouri",1696,1633,63,3017,29,39980
"Lake Ozark city, Missouri",1347,1293,54,2628,29,40034
"Lake St. Clair CDP, Missouri",432,382,50,845,29,40039
"Lake St. Louis city, Missouri",9487,9122,365,17088,29,40043
"Lakeshire city, Missouri",734,718,16,1422,29,40088
"Lakeside city, Missouri",0,0,0,0,29,40142
"Lake Tapawingo city, Missouri",469,442,27,871,29,40196
"Lake Tekakwitha village, Missouri",171,161,10,252,29,40214
"Lake Timberline CDP, Missouri",305,305,0,639,29,40222
"Lake Viking CDP, Missouri",185,182,3,403,29,40304
"Lake Waukomis city, Missouri",626,581,45,1021,29,40322
"Lake Winnebago city, Missouri",615,607,8,1263,29,40340
"Lamar city, Missouri",1777,1604,173,4298,29,40376
"Lamar Heights city, Missouri",65,65,0,145,29,40430
"Lambert village, Missouri",28,28,0,36,29,40448
"La Monte city, Missouri",504,491,13,1029,29,40520
"Lanagan town, Missouri",188,183,5,433,29,40592
"Lancaster city, Missouri",190,185,5,499,29,40610
"La Plata city, Missouri",473,443,30,1265,29,40682
"Laredo city, Missouri",42,40,2,116,29,40736
"La Russell city, Missouri",57,56,1,149,29,40790
"Latham CDP, Missouri",38,38,0,63,29,40808
"Lathrop city, Missouri",1249,1174,75,2546,29,40826
"La Tour CDP, Missouri",86,86,0,241,29,40880
"Laurie city, Missouri",347,314,33,991,29,40916
"Lawson city, Missouri",1089,1055,34,2429,29,40988
"Leadington city, Missouri",428,353,75,827,29,41024
"Leadwood city, Missouri",571,532,39,1475,29,41078
"Leasburg village, Missouri",213,159,54,469,29,41114
"Leawood village, Missouri",319,316,3,692,29,41132
"Lebanon city, Missouri",7392,6799,593,15023,29,41168
"Lee's Summit city, Missouri",55371,53264,2107,101728,29,41348
"Leeton city, Missouri",289,278,11,684,29,41402
"Leisure Lake CDP, Missouri",169,169,0,199,29,41417
"Lemay CDP, Missouri",8246,7894,352,16211,29,41438
"Leonard village, Missouri",36,36,0,55,29,41546
"Leslie village, Missouri",35,34,1,67,29,41690
"Levasy city, Missouri",43,43,0,66,29,41762
"Lewis and Clark Village town, Missouri",56,54,2,102,29,41834
"Lewistown town, Missouri",195,178,17,442,29,41852
"Lexington city, Missouri",2269,2172,97,4592,29,41870
"Liberal city, Missouri",345,296,49,794,29,41906
"Liberty city, Missouri",15477,14908,569,30299,29,42032
"Licking city, Missouri",715,623,92,2784,29,42464
"Lilbourn city, Missouri",412,403,9,995,29,42536
"Lincoln city, Missouri",552,524,28,1493,29,42608
"Linn city, Missouri",646,644,2,1484,29,43238
"Linn Creek city, Missouri",138,127,11,247,29,43274
"Linneus city, Missouri",93,91,2,207,29,43292
"Lithium CDP, Missouri",6,6,0,47,29,43346
"Livonia village, Missouri",4,4,0,18,29,43454
"Loch Lloyd village, Missouri",332,329,3,783,29,43468
"Lock Springs village, Missouri",15,15,0,40,29,43472
"Lockwood city, Missouri",460,450,10,960,29,43490
"Lohman city, Missouri",118,118,0,251,29,43652
"Loma Linda town, Missouri",557,542,15,986,29,43672
"Lone Jack city, Missouri",699,679,20,1328,29,43760
"Longtown town, Missouri",65,65,0,104,29,43940
"Louisburg village, Missouri",39,38,1,92,29,44156
"Louisiana city, Missouri",1324,1242,82,3249,29,44174
"Lowry City city, Missouri",255,252,3,626,29,44282
"Lucerne village, Missouri",13,13,0,31,29,44372
"Ludlow town, Missouri",62,53,9,148,29,44390
"Lupus town, Missouri",10,10,0,27,29,44498
"Luray village, Missouri",17,17,0,62,29,44516
"McBaine town, Missouri",0,0,0,2,29,44768
"McCord Bend village, Missouri",55,54,1,240,29,44829
"McFall city, Missouri",73,66,7,155,29,45020
"McKittrick town, Missouri",45,45,0,92,29,45200
"Macks Creek CDP, Missouri",69,69,0,233,29,45218
"Macon city, Missouri",2601,2531,70,5452,29,45326
"Madison city, Missouri",175,175,0,389,29,45470
"Maitland city, Missouri",148,122,26,289,29,45596
"Malden city, Missouri",1530,1415,115,3790,29,45614
"Malta Bend town, Missouri",83,81,2,155,29,45632
"Manchester city, Missouri",9630,9366,264,18240,29,45668
"Mansfield city, Missouri",569,535,34,1351,29,45740
"Maplewood city, Missouri",5329,5231,98,8205,29,45830
"Marble Hill city, Missouri",710,654,56,1854,29,45848
"Marceline city, Missouri",983,939,44,2190,29,45866
"Marionville city, Missouri",1265,1140,125,2551,29,46172
"Marlborough village, Missouri",1952,1795,157,2492,29,46208
"Marquand city, Missouri",101,94,7,153,29,46244
"Marshall city, Missouri",6502,6318,184,13687,29,46316
"Marshfield city, Missouri",3116,2947,169,7501,29,46388
"Marston city, Missouri",158,144,14,420,29,46406
"Marthasville city, Missouri",1523,1513,10,2616,29,46424
"Martinsburg town, Missouri",258,254,4,559,29,46460
"Maryland Heights city, Missouri",16694,16211,483,28099,29,46586
"Maryville city, Missouri",5219,5093,126,10691,29,46640
"Matthews city, Missouri",222,209,13,569,29,46730
"Maysville city, Missouri",455,446,9,1007,29,46946
"Mayview city, Missouri",130,127,3,399,29,46964
"Meadville city, Missouri",254,254,0,511,29,47036
"Medill CDP, Missouri",233,233,0,299,29,47144
"Mehlville CDP, Missouri",15392,14810,582,29089,29,47180
"Memphis city, Missouri",791,768,23,1862,29,47270
"Mendon city, Missouri",99,99,0,203,29,47288
"Mercer town, Missouri",221,219,2,380,29,47486
"Merriam Woods city, Missouri",1089,953,136,2153,29,47520
"Merwin village, Missouri",22,20,2,49,29,47540
"Meta city, Missouri",52,50,2,124,29,47594
"Metz town, Missouri",2,2,0,6,29,47612
"Mexico city, Missouri",5691,5364,327,11502,29,47648
"Miami city, Missouri",32,31,1,81,29,47684
"Middle Grove CDP, Missouri",18,18,0,48,29,47846
"Middletown town, Missouri",98,96,2,196,29,47900
"Milan city, Missouri",916,876,40,1989,29,48062
"Milford village, Missouri",4,4,0,21,29,48098
"Millard village, Missouri",40,37,3,68,29,48134
"Miller city, Missouri",314,293,21,727,29,48242
"Millersville CDP, Missouri",171,171,0,310,29,48350
"Mill Spring village, Missouri",33,33,0,109,29,48386
"Milo village, Missouri",13,13,0,46,29,48476
"Mindenmines city, Missouri",108,108,0,387,29,48566
"Mine La Motte CDP, Missouri",56,56,0,236,29,48602
"Miner city, Missouri",386,380,6,844,29,48656
"Mineral Point town, Missouri",122,118,4,394,29,48710
"Miramiguoa Park village, Missouri",106,104,2,189,29,48880
"Missouri City city, Missouri",129,122,7,299,29,48980
"Moberly city, Missouri",5705,5278,427,13708,29,49034
"Mokane city, Missouri",213,112,101,329,29,49070
"Moline Acres city, Missouri",1095,931,164,2815,29,49088
"Monett city, Missouri",4787,4565,222,9632,29,49196
"Monroe City city, Missouri",1443,1436,7,3176,29,49394
"Montgomery City city, Missouri",1425,1368,57,2817,29,49574
"Monticello village, Missouri",183,183,0,309,29,49592
"Montier CDP, Missouri",63,63,0,73,29,49610
"Montreal CDP, Missouri",21,21,0,58,29,49646
"Montrose city, Missouri",167,145,22,433,29,49664
"Mooresville village, Missouri",49,47,2,96,29,49790
"Morehouse city, Missouri",334,324,10,839,29,49898
"Morley city, Missouri",307,297,10,572,29,49988
"Morrison city, Missouri",17,17,0,59,29,50060
"Morrisville town, Missouri",296,284,12,550,29,50078
"Mosby city, Missouri",27,27,0,55,29,50168
"Moscow Mills city, Missouri",1671,1542,129,3502,29,50204
"Mound City city, Missouri",516,507,9,1143,29,50312
"Moundville town, Missouri",40,35,5,77,29,50330
"Mountain Grove city, Missouri",1465,1453,12,4498,29,50402
"Mountain View city, Missouri",952,927,25,2558,29,50438
"Mount Leonard town, Missouri",7,7,0,53,29,50510
"Mount Moriah town, Missouri",48,48,0,112,29,50528
"Mount Vernon city, Missouri",1858,1826,32,4511,29,50672
"Murphy CDP, Missouri",4771,4525,246,8427,29,50834
"Napoleon city, Missouri",108,106,2,199,29,51140
"Naylor city, Missouri",177,171,6,495,29,51302
"Neck City city, Missouri",80,73,7,201,29,51356
"Neelyville city, Missouri",88,78,10,297,29,51446
"Nelson city, Missouri",26,24,2,99,29,51500
"Neosho city, Missouri",5925,5674,251,12670,29,51572
"Nevada city, Missouri",3498,3334,164,8128,29,51644
"Newark village, Missouri",29,29,0,48,29,51662
"New Bloomfield city, Missouri",590,570,20,909,29,51680
"Newburg city, Missouri",120,105,15,329,29,51716
"New Cambria city, Missouri",52,45,7,128,29,51734
"New Florence city, Missouri",239,229,10,750,29,51770
"New Franklin city, Missouri",446,436,10,1057,29,51824
"New Hamburg CDP, Missouri",153,153,0,185,29,51842
"New Hampton city, Missouri",114,111,3,317,29,51860
"New Haven city, Missouri",1528,1457,71,3363,29,51914
"New London city, Missouri",469,438,31,1101,29,52058
"New Madrid city, Missouri",1103,1078,25,2761,29,52076
"New Market CDP, Missouri",49,49,0,66,29,52130
"New Melle city, Missouri",190,184,6,418,29,52148
"Newtonia town, Missouri",82,78,4,222,29,52292
"Newtown town, Missouri",80,80,0,206,29,52328
"New Wells CDP, Missouri",21,21,0,33,29,52364
"Niangua city, Missouri",161,154,7,548,29,52418
"Nixa city, Missouri",12012,11515,497,23523,29,52616
"Noel city, Missouri",873,815,58,1930,29,52742
"Norborne city, Missouri",316,303,13,656,29,52760
"Normandy city, Missouri",2413,2224,189,4301,29,52796
"North Kansas City city, Missouri",3026,2834,192,4553,29,53102
"North Lilbourn village, Missouri",12,12,0,91,29,53138
"Northmoor city, Missouri",205,205,0,379,29,53174
"Northwoods city, Missouri",1219,1119,100,3700,29,53408
"Norwood city, Missouri",332,297,35,862,29,53454
"Norwood Court town, Missouri",588,537,51,830,29,53462
"Novelty village, Missouri",40,40,0,85,29,53516
"Novinger city, Missouri",252,236,16,560,29,53534
"Oak Grove city, Missouri",4203,3981,222,8304,29,53624
"Oak Grove Village village, Missouri",136,132,4,369,29,53650
"Oakland city, Missouri",666,627,39,1633,29,53750
"Oak Ridge town, Missouri",127,125,2,279,29,53786
"Oaks village, Missouri",96,88,8,183,29,53804
"Oakview village, Missouri",234,227,7,386,29,53858
"Oakville CDP, Missouri",19052,18317,735,35412,29,53876
"Oakwood village, Missouri",79,75,4,163,29,53894
"Oakwood Park village, Missouri",163,163,0,251,29,53948
"Odessa city, Missouri",2731,2731,0,5554,29,54038
"O'Fallon city, Missouri",52326,50701,1625,91825,29,54074
"Old Appleton town, Missouri",51,51,0,85,29,54200
"Old Jamestown CDP, Missouri",10234,9796,438,20387,29,54352
"Old Monroe city, Missouri",104,101,3,199,29,54416
"Olean town, Missouri",63,63,0,112,29,54560
"Olivette city, Missouri",4405,4180,225,8431,29,54650
"Olympian Village city, Missouri",375,353,22,785,29,54686
"Oran city, Missouri",628,579,49,1150,29,54758
"Oregon city, Missouri",465,460,5,922,29,54848
"Oronogo city, Missouri",1319,1289,30,2597,29,54920
"Orrick city, Missouri",360,344,16,788,29,54938
"Osage Beach city, Missouri",2320,2075,245,4736,29,55244
"Osborn city, Missouri",183,181,2,334,29,55352
"Osceola city, Missouri",335,317,18,1071,29,55388
"Osgood village, Missouri",17,17,0,36,29,55424
"Otterville city, Missouri",160,151,9,392,29,55478
"Overland city, Missouri",8165,7512,653,15838,29,55550
"Owensville city, Missouri",1127,1097,30,2800,29,55640
"Oxly CDP, Missouri",5,5,0,49,29,55694
"Ozark city, Missouri",10646,10259,387,21459,29,55766
"Ozora CDP, Missouri",156,156,0,275,29,55892
"Pacific city, Missouri",3658,3604,54,7239,29,55910
"Pagedale city, Missouri",1146,1099,47,2592,29,55964
"Palmyra city, Missouri",1723,1695,28,3613,29,56036
"Paradise CDP, Missouri",0,0,0,0,29,56126
"Paris city, Missouri",594,584,10,1385,29,56144
"Parkdale village, Missouri",85,80,5,248,29,56226
"Park Hills city, Missouri",4290,4045,245,8653,29,56272
"Parkville city, Missouri",3983,3838,145,7669,29,56288
"Parkway village, Missouri",359,330,29,766,29,56306
"Parma city, Missouri",207,199,8,558,29,56342
"Parnell city, Missouri",89,83,6,200,29,56360
"Pasadena Hills city, Missouri",730,638,92,1272,29,56396
"Pasadena Park village, Missouri",438,431,7,731,29,56414
"Pascola village, Missouri",28,28,0,83,29,56432
"Passaic town, Missouri",18,10,8,49,29,56468
"Pattonsburg city, Missouri",67,63,4,276,29,56558
"Paynesville village, Missouri",9,9,0,41,29,56612
"Peaceful Village village, Missouri",51,48,3,127,29,56620
"Peculiar city, Missouri",3087,2954,133,5675,29,56756
"Pendleton village, Missouri",30,30,0,40,29,56882
"Penermon village, Missouri",3,3,0,86,29,56900
"Perkins CDP, Missouri",66,59,7,180,29,57044
"Perry city, Missouri",255,252,3,707,29,57080
"Perryville city, Missouri",3998,3744,254,8536,29,57116
"Pevely city, Missouri",2962,2822,140,6012,29,57278
"Phelps City CDP, Missouri",0,0,0,0,29,57332
"Philadelphia CDP, Missouri",140,140,0,302,29,57350
"Phillipsburg village, Missouri",100,95,5,199,29,57368
"Pickering city, Missouri",89,83,6,161,29,57404
"Piedmont city, Missouri",805,758,47,2739,29,57422
"Pierce City city, Missouri",641,611,30,1373,29,57494
"Pierpont village, Missouri",38,36,2,63,29,57512
"Pilot Grove city, Missouri",321,321,0,671,29,57602
"Pilot Knob city, Missouri",390,357,33,773,29,57656
"Pine Lawn city, Missouri",973,815,158,2772,29,57800
"Pineville city, Missouri",399,375,24,895,29,57818
"Pinhook village, Missouri",0,0,0,0,29,57926
"Plato village, Missouri",44,44,0,131,29,58088
"Platte City city, Missouri",2580,2477,103,4781,29,58178
"Platte Woods city, Missouri",293,285,8,503,29,58196
"Plattsburg city, Missouri",1114,1061,53,2284,29,58250
"Pleasant Hill city, Missouri",4893,4610,283,8822,29,58394
"Pleasant Hope city, Missouri",340,339,1,726,29,58448
"Pleasant Valley city, Missouri",1690,1601,89,2748,29,58520
"Plevna CDP, Missouri",0,0,0,0,29,58574
"Pocahontas town, Missouri",23,23,0,43,29,58628
"Pollock village, Missouri",10,10,0,23,29,58898
"Polo city, Missouri",227,221,6,473,29,58916
"Pomona CDP, Missouri",113,92,21,259,29,58934
"Pontiac CDP, Missouri",88,67,21,121,29,59060
"Poplar Bluff city, Missouri",6349,5974,375,16313,29,59096
"Portage Des Sioux city, Missouri",176,170,6,330,29,59150
"Portageville city, Missouri",1322,1263,59,2918,29,59186
"Potosi city, Missouri",1001,978,23,2559,29,59330
"Powersville village, Missouri",49,47,2,75,29,59420
"Prairie Hill CDP, Missouri",15,15,0,48,29,59708
"Prairie Home city, Missouri",90,88,2,215,29,59726
"Prathersville village, Missouri",45,43,2,90,29,59816
"Preston village, Missouri",155,143,12,344,29,59870
"Princeton city, Missouri",545,539,6,1264,29,59942
"Purcell city, Missouri",175,166,9,414,29,60140
"Purdin city, Missouri",29,29,0,69,29,60158
"Purdy city, Missouri",588,502,86,1374,29,60176
"Puxico city, Missouri",441,419,22,1001,29,60284
"Queen City city, Missouri",214,208,6,708,29,60356
"Quitman CDP, Missouri",11,8,3,15,29,60410
"Qulin city, Missouri",316,312,4,722,29,60428
"Raintree Plantation CDP, Missouri",788,788,0,1830,29,60528
"Randolph village, Missouri",13,13,0,20,29,60590
"Ravanna CDP, Missouri",26,21,5,59,29,60644
"Ravenwood town, Missouri",195,190,5,530,29,60716
"Raymondville town, Missouri",212,194,18,528,29,60734
"Raymore city, Missouri",11961,11622,339,23232,29,60752
"Raytown city, Missouri",16606,15746,860,29772,29,60788
"Rayville CDP, Missouri",122,67,55,242,29,60824
"Rea city, Missouri",32,32,0,64,29,60842
"Redings Mill village, Missouri",34,33,1,95,29,60986
"Reeds town, Missouri",79,73,6,222,29,61094
"Reeds Spring city, Missouri",456,426,30,840,29,61112
"Renick village, Missouri",71,60,11,140,29,61166
"Rensselaer village, Missouri",126,125,1,256,29,61184
"Republic city, Missouri",9771,9396,375,18824,29,61238
"Revere town, Missouri",37,37,0,55,29,61292
"Rhineland town, Missouri",51,50,1,118,29,61328
"Richards town, Missouri",23,23,0,138,29,61364
"Rich Hill city, Missouri",702,666,36,1384,29,61418
"Richland city, Missouri",873,820,53,2307,29,61562
"Richmond city, Missouri",2685,2596,89,5975,29,61670
"Richmond Heights city, Missouri",5564,5469,95,9186,29,61706
"Ridgely village, Missouri",67,63,4,122,29,61886
"Ridgeway city, Missouri",168,149,19,516,29,61904
"Risco city, Missouri",104,93,11,202,29,61994
"Ritchey town, Missouri",21,21,0,44,29,62030
"River Bend village, Missouri",4,4,0,5,29,62056
"Riverside city, Missouri",1841,1757,84,4017,29,62156
"Riverview village, Missouri",1519,1408,111,2912,29,62192
"Riverview Estates village, Missouri",57,56,1,89,29,62210
"Rives town, Missouri",33,30,3,84,29,62228
"Rocheport city, Missouri",120,120,0,204,29,62498
"Rockaway Beach city, Missouri",254,237,17,649,29,62570
"Rock Hill city, Missouri",2906,2854,52,4728,29,62660
"Rock Port city, Missouri",615,608,7,1274,29,62696
"Rockville city, Missouri",54,46,8,197,29,62786
"Rocky Comfort CDP, Missouri",75,75,0,155,29,62822
"Rogersville city, Missouri",2393,2323,70,4326,29,62894
"Rolla city, Missouri",8392,7972,420,20025,29,62912
"Roscoe village, Missouri",43,43,0,126,29,63074
"Rosebud city, Missouri",240,228,12,481,29,63110
"Rosendale city, Missouri",78,78,0,158,29,63200
"Rothville village, Missouri",22,16,6,70,29,63236
"Rush Hill village, Missouri",77,75,2,157,29,63560
"Rushville village, Missouri",120,117,3,261,29,63596
"Russellville city, Missouri",505,495,10,876,29,63704
"Rutledge town, Missouri",17,17,0,68,29,63776
"Saddlebrooke village, Missouri",114,112,2,314,29,63857
"Saginaw village, Missouri",129,126,3,305,29,63902
"St. Ann city, Missouri",7201,6984,217,12917,29,63956
"St. Catharine CDP, Missouri",0,0,0,1,29,64046
"St. Charles city, Missouri",39020,38039,981,70687,29,64082
"St. Clair city, Missouri",2025,1890,135,4771,29,64136
"St. Clement CDP, Missouri",6,6,0,84,29,64154
"St. Cloud village, Missouri",17,10,7,19,29,64172
"Ste. Genevieve city, Missouri",2132,2003,129,4965,29,64180
"St. Elizabeth village, Missouri",216,212,4,527,29,64190
"St. Francisville CDP, Missouri",81,69,12,200,29,64244
"St. George CDP, Missouri",1228,1211,17,1875,29,64370
"St. James city, Missouri",1684,1577,107,3942,29,64424
"St. John city, Missouri",3684,3464,220,6583,29,64478
"St. Joseph city, Missouri",34395,32658,1737,72198,29,64550
"St. Louis city, Missouri",163553,154689,8864,298018,29,65000
"St. Martins city, Missouri",538,520,18,1214,29,65018
"St. Mary city, Missouri",104,95,9,240,29,65034
"St. Paul city, Missouri",1604,1596,8,3149,29,65108
"St. Peters city, Missouri",32012,31098,914,57692,29,65126
"St. Robert city, Missouri",2235,2174,61,5242,29,65144
"St. Thomas town, Missouri",150,150,0,249,29,65162
"Salem city, Missouri",2054,1911,143,4673,29,65234
"Salisbury city, Missouri",621,585,36,1430,29,65450
"Sappington CDP, Missouri",3564,3377,187,7039,29,65954
"Sarcoxie city, Missouri",542,492,50,1464,29,65990
"Savannah city, Missouri",2399,2361,38,5068,29,66044
"Saverton CDP, Missouri",35,35,0,88,29,66062
"Schell City city, Missouri",38,36,2,164,29,66134
"Scotsdale town, Missouri",81,80,1,147,29,66337
"Scott City city, Missouri",2362,2296,66,4364,29,66368
"Sedalia city, Missouri",10588,10019,569,21767,29,66440
"Sedgewickville village, Missouri",98,98,0,161,29,66476
"Seligman city, Missouri",370,350,20,906,29,66530
"Senath city, Missouri",566,538,28,1597,29,66638
"Seneca city, Missouri",839,838,1,2005,29,66674
"Seymour city, Missouri",902,861,41,1932,29,66800
"Shakertowne CDP, Missouri",263,187,76,452,29,66935
"Shawneetown CDP, Missouri",105,105,0,172,29,67124
"Shelbina city, Missouri",1000,991,9,2165,29,67178
"Shelbyville city, Missouri",207,207,0,525,29,67196
"Sheldon city, Missouri",192,179,13,398,29,67214
"Shell Knob CDP, Missouri",483,468,15,1415,29,67232
"Sheridan town, Missouri",63,63,0,173,29,67358
"Shoal Creek Drive village, Missouri",287,280,7,598,29,67628
"Shoal Creek Estates village, Missouri",35,27,8,177,29,67632
"Shrewsbury city, Missouri",3547,3491,56,6352,29,67700
"Sibley village, Missouri",175,173,2,356,29,67718
"Sikeston city, Missouri",7018,6812,206,16146,29,67790
"Silex city, Missouri",81,81,0,314,29,67808
"Skidmore city, Missouri",108,101,7,227,29,68132
"Slater city, Missouri",776,754,22,1987,29,68204
"Smithton city, Missouri",284,267,17,514,29,68384
"Smithville city, Missouri",5205,5170,35,10416,29,68420
"South Fork CDP, Missouri",53,53,0,89,29,68762
"South Gifford village, Missouri",18,18,0,50,29,68852
"South Gorin town, Missouri",10,10,0,38,29,68870
"South Greenfield village, Missouri",42,42,0,106,29,68888
"South Lineville town, Missouri",7,7,0,12,29,68942
"Southwest City town, Missouri",432,416,16,988,29,69230
"Spanish Lake CDP, Missouri",9383,8601,782,18051,29,69266
"Sparta city, Missouri",1162,1146,16,2442,29,69302
"Spickard city, Missouri",80,77,3,285,29,69464
"Spokane CDP, Missouri",143,143,0,209,29,69518
"Springfield city, Missouri",84999,80907,4092,168873,29,70000
"Stanberry city, Missouri",579,558,21,1261,29,70270
"Stanton CDP, Missouri",155,155,0,316,29,70342
"Stark City town, Missouri",53,52,1,144,29,70414
"Steele city, Missouri",701,523,178,1375,29,70558
"Steelville city, Missouri",558,507,51,1515,29,70576
"Stella town, Missouri",72,69,3,266,29,70648
"Stewartsville city, Missouri",381,378,3,758,29,70738
"Stockton city, Missouri",607,555,52,1932,29,70828
"Stotesbury town, Missouri",0,0,0,1,29,70954
"Stotts City city, Missouri",97,97,0,196,29,70990
"Stoutland city, Missouri",113,76,37,272,29,71008
"Stoutsville village, Missouri",8,6,2,32,29,71026
"Stover city, Missouri",428,411,17,954,29,71044
"Strafford city, Missouri",1198,1166,32,2570,29,71062
"Strasburg city, Missouri",88,81,7,142,29,71098
"Sturgeon city, Missouri",518,511,7,1078,29,71224
"Sugar Creek city, Missouri",1624,1530,94,3247,29,71368
"Sullivan city, Missouri",3089,2954,135,6441,29,71440
"Summer Set CDP, Missouri",589,581,8,1168,29,71508
"Summersville city, Missouri",127,118,9,342,29,71512
"Sumner town, Missouri",34,34,0,97,29,71620
"Sundown CDP, Missouri",47,47,0,159,29,71628
"Sunrise Beach village, Missouri",228,199,29,463,29,71728
"Sunset Hills city, Missouri",4490,4251,239,9121,29,71746
"Sweet Springs city, Missouri",591,552,39,1258,29,71890
"Sycamore Hills village, Missouri",421,419,2,621,29,72034
"Syracuse city, Missouri",97,83,14,157,29,72106
"Tallapoosa city, Missouri",40,40,0,80,29,72196
"Taneyville village, Missouri",76,76,0,187,29,72232
"Taos city, Missouri",623,615,8,1275,29,72304
"Tarkio city, Missouri",752,731,21,1473,29,72340
"Tarrants village, Missouri",0,0,0,14,29,72376
"Tarsney Lakes CDP, Missouri",65,65,0,206,29,72412
"Tebbetts CDP, Missouri",301,222,79,402,29,72574
"Terre du Lac CDP, Missouri",1241,1171,70,2443,29,72772
"Thayer city, Missouri",692,663,29,2111,29,72826
"Theodosia village, Missouri",23,23,0,146,29,72898
"Thomasville CDP, Missouri",0,0,0,0,29,73006
"Three Creeks village, Missouri",3,3,0,3,29,73127
"Tightwad village, Missouri",26,26,0,73,29,73240
"Tina village, Missouri",81,77,4,182,29,73330
"Tindall town, Missouri",46,46,0,84,29,73348
"Tipton city, Missouri",595,584,11,2738,29,73420
"Town and Country city, Missouri",5136,4964,172,11575,29,73618
"Tracy city, Missouri",109,103,6,202,29,73690
"Trenton city, Missouri",2263,2140,123,5527,29,73816
"Trimble city, Missouri",306,302,4,604,29,73852
"Triplett city, Missouri",6,6,0,12,29,73870
"Troy city, Missouri",6621,6500,121,12964,29,73942
"Truesdale city, Missouri",450,443,7,926,29,73978
"Truxton village, Missouri",27,24,3,55,29,74014
"Turney village, Missouri",76,74,2,153,29,74176
"Tuscumbia town, Missouri",56,53,3,148,29,74194
"Twin Oaks village, Missouri",422,418,4,619,29,74284
"Umber View Heights village, Missouri",16,16,0,40,29,74473
"Union city, Missouri",6355,6000,355,12341,29,74626
"Union Star town, Missouri",224,214,10,512,29,75130
"Unionville city, Missouri",813,783,30,1814,29,75166
"Unity Village village, Missouri",36,35,1,65,29,75202
"University City city, Missouri",19433,19041,392,34850,29,75220
"Uplands Park village, Missouri",162,143,19,364,29,75238
"Urbana city, Missouri",170,165,5,452,29,75310
"Urich city, Missouri",186,171,15,352,29,75346
"Utica village, Missouri",130,126,4,202,29,75364
"Valley Park city, Missouri",3913,3599,314,6848,29,75472
"Van Buren town, Missouri",306,305,1,1125,29,75580
"Vandalia city, Missouri",1324,1280,44,3382,29,75688
"Vandiver village, Missouri",48,48,0,107,29,75706
"Vanduser village, Missouri",73,64,9,182,29,75724
"Velda City city, Missouri",561,536,25,1254,29,75796
"Velda Village Hills city, Missouri",393,328,65,849,29,75814
"Verona town, Missouri",190,161,29,478,29,75886
"Versailles city, Missouri",1001,945,56,2549,29,75922
"Vibbard CDP, Missouri",170,170,0,369,29,75994
"Viburnum city, Missouri",266,266,0,639,29,76012
"Vienna city, Missouri",348,342,6,796,29,76102
"Village of Four Seasons village, Missouri",846,770,76,1732,29,76157
"Villa Ridge CDP, Missouri",1450,1366,84,2971,29,76192
"Vinita Park city, Missouri",1134,1022,112,1857,29,76246
"Vista village, Missouri",14,14,0,29,29,76390
"Waco city, Missouri",86,72,14,185,29,76444
"Walker city, Missouri",115,110,5,343,29,76660
"Walnut Grove city, Missouri",220,216,4,529,29,76840
"Wardell town, Missouri",162,160,2,455,29,76966
"Wardsville village, Missouri",837,829,8,1635,29,77002
"Warrensburg city, Missouri",9681,9020,661,19317,29,77092
"Warrenton city, Missouri",4351,4123,228,8648,29,77128
"Warsaw city, Missouri",867,833,34,2326,29,77146
"Warson Woods city, Missouri",1065,1055,10,2107,29,77182
"Washburn city, Missouri",255,250,5,594,29,77200
"Washington city, Missouri",8063,7736,327,14769,29,77416
"Wasola CDP, Missouri",11,11,0,107,29,77794
"Watson village, Missouri",30,30,0,68,29,77848
"Waverly city, Missouri",363,353,10,883,29,77866
"Wayland city, Missouri",239,239,0,478,29,77920
"Waynesville city, Missouri",2504,2375,129,5372,29,77992
"Weatherby town, Missouri",30,22,8,78,29,78028
"Weatherby Lake city, Missouri",1230,1207,23,2422,29,78046
"Weaubleau city, Missouri",197,195,2,528,29,78064
"Webb City city, Missouri",6154,5861,293,13002,29,78118
"Webster Groves city, Missouri",12643,12147,496,23838,29,78154
"Weingarten CDP, Missouri",37,37,0,141,29,78226
"Weldon Spring city, Missouri",2367,2218,149,5320,29,78314
"Weldon Spring Heights town, Missouri",61,59,2,145,29,78334
"Wellington city, Missouri",219,196,23,501,29,78352
"Wellston city, Missouri",895,868,27,1913,29,78370
"Wellsville city, Missouri",507,484,23,1177,29,78406
"Wentworth village, Missouri",35,31,4,85,29,78424
"Wentzville city, Missouri",23436,22655,781,44584,29,78442
"West Alton city, Missouri",283,271,12,513,29,78514
"Westboro city, Missouri",31,28,3,96,29,78622
"West Line village, Missouri",60,60,0,105,29,78838
"Weston city, Missouri",873,836,37,1743,29,78856
"Westphalia city, Missouri",208,208,0,462,29,78910
"West Plains city, Missouri",5227,4981,246,12250,29,78928
"West Sullivan town, Missouri",112,97,15,260,29,79000
"Westwood village, Missouri",151,145,6,309,29,79054
"Wheatland city, Missouri",85,83,2,244,29,79090
"Wheaton city, Missouri",205,194,11,541,29,79126
"Wheeling city, Missouri",64,57,7,203,29,79180
"White Branch CDP, Missouri",115,74,41,246,29,79288
"Whiteman AFB CDP, Missouri",842,814,28,4119,29,79432
"White Oak CDP, Missouri",0,0,0,51,29,79468
"Whiteside village, Missouri",58,54,4,107,29,79558
"Whitewater town, Missouri",43,43,0,75,29,79612
"Whiting CDP, Missouri",46,46,0,152,29,79684
"Wilbur Park village, Missouri",234,230,4,373,29,79756
"Wildwood city, Missouri",18365,17878,487,35276,29,79820
"Willard city, Missouri",2996,2909,87,6342,29,79882
"Williamstown CDP, Missouri",29,29,0,40,29,80008
"Williamsville city, Missouri",105,88,17,283,29,80026
"Willow Springs city, Missouri",1027,935,92,2125,29,80098
"Wilson City village, Missouri",32,28,4,71,29,80260
"Winchester city, Missouri",1262,1223,39,1977,29,80314
"Windsor city, Missouri",1076,1039,37,3002,29,80350
"Windsor Place village, Missouri",255,252,3,448,29,80380
"Winfield city, Missouri",829,792,37,1722,29,80422
"Winigan CDP, Missouri",3,3,0,8,29,80440
"Winona city, Missouri",302,290,12,810,29,80512
"Winston village, Missouri",95,94,1,177,29,80548
"Wood Heights city, Missouri",409,402,7,705,29,80767
"Woodson Terrace city, Missouri",1863,1817,46,3943,29,80962
"Wooldridge village, Missouri",16,16,0,26,29,81016
"Worth village, Missouri",24,22,2,41,29,81070
"Wortham CDP, Missouri",66,56,10,132,29,81088
"Worthington village, Missouri",5,5,0,35,29,81106
"Wright City city, Missouri",2457,2295,162,4828,29,81124
"Wyaconda city, Missouri",86,86,0,170,29,81142
"Wyatt city, Missouri",109,97,12,256,29,81178
"Zalma CDP, Missouri",32,26,6,69,29,81430
"Absarokee CDP, Montana",427,427,0,869,30,00175
"Acton CDP, Montana",46,37,9,79,30,00400
"Alberton town, Montana",285,281,4,533,30,00700
"Alder CDP, Montana",57,57,0,108,30,00850
"Alzada CDP, Montana",7,7,0,14,30,01300
"Amsterdam CDP, Montana",80,80,0,160,30,01525
"Anaconda-Deer Lodge County, Montana",4373,4207,166,9435,30,01675
"Antelope CDP, Montana",0,0,0,0,30,02050
"Argenta CDP, Montana",0,0,0,92,30,02350
"Arlee CDP, Montana",316,286,30,693,30,02425
"Ashland CDP, Montana",414,349,65,783,30,02800
"Augusta CDP, Montana",81,81,0,215,30,03025
"Avon CDP, Montana",50,50,0,164,30,03175
"Ayers Ranch Colony CDP, Montana",33,33,0,39,30,03196
"Azure CDP, Montana",108,75,33,386,30,03212
"Babb CDP, Montana",103,103,0,271,30,03250
"Bainville town, Montana",108,108,0,153,30,03400
"Baker city, Montana",708,708,0,1500,30,03475
"Ballantine CDP, Montana",99,99,0,272,30,03625
"Basin CDP, Montana",190,190,0,364,30,04150
"Batavia CDP, Montana",393,355,38,687,30,04230
"Bearcreek town, Montana",87,87,0,121,30,04300
"Bear Dance CDP, Montana",96,81,15,241,30,04410
"Beaver Creek CDP, Montana",264,262,2,382,30,04575
"Belfry CDP, Montana",78,78,0,178,30,04900
"Belgrade city, Montana",6572,6491,81,10941,30,04975
"Belknap CDP, Montana",0,0,0,0,30,05050
"Belt town, Montana",307,285,22,532,30,05275
"Biddle CDP, Montana",20,20,0,22,30,05650
"Big Arm CDP, Montana",57,57,0,168,30,05800
"Bigfork CDP, Montana",1970,1902,68,4953,30,05875
"Big Sandy town, Montana",367,324,43,798,30,06250
"Big Sky CDP, Montana",1972,1938,34,2825,30,06325
"Big Sky Colony CDP, Montana",0,0,0,0,30,06410
"Big Stone Colony CDP, Montana",18,18,0,31,30,06440
"Big Timber city, Montana",885,850,35,1702,30,06475
"Billings city, Montana",62322,60050,2272,117093,30,06550
"Birch Creek Colony CDP, Montana",56,56,0,101,30,06815
"Birney CDP, Montana",23,23,0,124,30,06925
"Black Eagle CDP, Montana",293,293,0,672,30,07150
"Blackfoot CDP, Montana",9,9,0,64,30,07300
"Bloomfield CDP, Montana",5,5,0,9,30,07675
"Boneau CDP, Montana",105,102,3,285,30,08162
"Bonner-West Riverside CDP, Montana",761,723,38,1281,30,08462
"Boulder city, Montana",566,532,34,1214,30,08575
"Box Elder CDP, Montana",38,38,0,68,30,08725
"Boyd CDP, Montana",11,11,0,36,30,08800
"Bozeman city, Montana",33661,32708,953,53500,30,08950
"Brady CDP, Montana",43,43,0,97,30,09250
"Brandon CDP, Montana",20,20,0,64,30,09400
"Bridger town, Montana",469,439,30,889,30,09475
"Bridger CDP, Montana",108,108,0,169,30,09500
"Broadus town, Montana",270,265,5,427,30,09700
"Broadview town, Montana",129,123,6,202,30,09775
"Brockton CDP, Montana",97,96,1,459,30,10000
"Brockway CDP, Montana",6,6,0,9,30,10075
"Brooks CDP, Montana",0,0,0,0,30,10150
"Browning town, Montana",359,300,59,871,30,10375
"Bull Lake CDP, Montana",81,81,0,205,30,10935
"Busby CDP, Montana",179,146,33,474,30,11200
"Butte-Silver Bow (balance), Montana",16904,16139,765,34638,30,11397
"Bynum CDP, Montana",5,5,0,16,30,11500
"Camas CDP, Montana",17,14,3,37,30,11800
"Camp Three CDP, Montana",73,73,0,155,30,11995
"Camrose Colony CDP, Montana",41,41,0,76,30,11999
"Canyon Creek CDP, Montana",14,11,3,59,30,12025
"Cardwell CDP, Montana",19,18,1,48,30,12400
"Carlton CDP, Montana",241,241,0,471,30,12435
"Carter CDP, Montana",22,20,2,94,30,12625
"Cascade town, Montana",236,228,8,569,30,12775
"Cascade Colony CDP, Montana",23,23,0,23,30,12783
"Centerville CDP, Montana",3,3,0,9,30,13375
"Charlo CDP, Montana",180,170,10,356,30,13900
"Charlos Heights CDP, Montana",29,29,0,44,30,13975
"Chester town, Montana",277,275,2,774,30,14200
"Chinook city, Montana",779,761,18,1488,30,14575
"Choteau city, Montana",755,741,14,1714,30,14650
"Churchill CDP, Montana",541,538,3,1081,30,14875
"Circle town, Montana",259,259,0,483,30,14950
"Clancy CDP, Montana",857,845,12,1970,30,15100
"Clinton CDP, Montana",382,377,5,745,30,15475
"Clyde Park town, Montana",172,165,7,319,30,15550
"Coffee Creek CDP, Montana",8,8,0,38,30,16000
"Colstrip city, Montana",1230,1168,62,2327,30,16525
"Columbia Falls city, Montana",2667,2513,154,5435,30,16600
"Columbus town, Montana",1011,960,51,1932,30,16825
"Condon CDP, Montana",91,88,3,307,30,17050
"Conner CDP, Montana",42,42,0,137,30,17200
"Conrad city, Montana",1218,1162,56,2640,30,17275
"Cooke City CDP, Montana",46,46,0,83,30,17350
"Coram CDP, Montana",113,102,11,442,30,17500
"Corvallis CDP, Montana",817,756,61,1396,30,17725
"Corwin Springs CDP, Montana",118,118,0,155,30,17800
"Craig CDP, Montana",23,23,0,39,30,18025
"Crane CDP, Montana",18,18,0,191,30,18100
"Crow Agency CDP, Montana",603,351,252,1965,30,18250
"Culbertson town, Montana",359,342,17,671,30,18475
"Custer CDP, Montana",79,77,2,146,30,18700
"Cut Bank city, Montana",1072,1044,28,3061,30,18775
"Cyr CDP, Montana",64,64,0,104,30,18850
"Danvers CDP, Montana",4,4,0,9,30,19225
"Darby town, Montana",286,278,8,610,30,19300
"Dayton CDP, Montana",14,14,0,114,30,19525
"De Borgia CDP, Montana",22,22,0,66,30,19675
"Deerfield Colony CDP, Montana",17,17,0,17,30,19800
"Deer Lodge city, Montana",1370,1323,47,3030,30,19825
"Dell CDP, Montana",7,7,0,26,30,20050
"Denton town, Montana",141,139,2,252,30,20425
"Dewey CDP, Montana",4,4,0,12,30,20725
"Dillon city, Montana",1918,1846,72,3958,30,20800
"Dixon CDP, Montana",124,102,22,288,30,20950
"Dodson town, Montana",9,1,8,119,30,21025
"Drummond town, Montana",103,101,2,277,30,21850
"Duncan Ranch Colony CDP, Montana",7,7,0,7,30,22130
"Dupuyer CDP, Montana",51,50,1,116,30,22450
"Dutton town, Montana",130,124,6,265,30,22600
"Eagle Creek Colony CDP, Montana",9,9,0,54,30,22655
"East End Colony CDP, Montana",0,0,0,0,30,22943
"East Glacier Park Village CDP, Montana",141,127,14,262,30,22985
"East Helena city, Montana",1128,1039,89,1829,30,23125
"East Malta Colony CDP, Montana",0,0,0,0,30,23168
"East Missoula CDP, Montana",1159,1078,81,2105,30,23200
"Edgar CDP, Montana",68,41,27,104,30,23500
"Ekalaka town, Montana",149,148,1,372,30,23650
"Elkhorn CDP, Montana",0,0,0,49,30,23865
"Elliston CDP, Montana",132,124,8,223,30,23950
"Elmo CDP, Montana",37,10,27,166,30,24100
"Emigrant CDP, Montana",150,145,5,318,30,24325
"Ennis town, Montana",403,399,4,736,30,24475
"Essex CDP, Montana",29,29,0,72,30,24700
"Eureka town, Montana",890,853,37,1790,30,24850
"Evaro CDP, Montana",149,138,11,505,30,25000
"Evergreen CDP, Montana",4831,4621,210,8514,30,25075
"Fairfield town, Montana",361,334,27,759,30,25225
"Fair Haven Colony CDP, Montana",0,0,0,0,30,25245
"Fairview town, Montana",542,463,79,979,30,25300
"Fallon CDP, Montana",67,67,0,360,30,25375
"Finley Point CDP, Montana",167,153,14,460,30,26226
"Fishtail CDP, Montana",35,32,3,108,30,26575
"Flat Willow Colony CDP, Montana",0,0,0,0,30,26733
"Flaxville town, Montana",26,26,0,62,30,26800
"Florence CDP, Montana",471,416,55,1046,30,26950
"Floweree CDP, Montana",14,14,0,22,30,27025
"Fords Creek Colony CDP, Montana",48,48,0,53,30,27360
"Forest Hill Village CDP, Montana",119,119,0,244,30,27595
"Forsyth city, Montana",613,597,16,1458,30,27700
"Fort Belknap Agency CDP, Montana",438,279,159,1473,30,27850
"Fort Benton city, Montana",642,601,41,1544,30,28000
"Fortine CDP, Montana",154,154,0,432,30,28150
"Fort Peck town, Montana",111,111,0,200,30,28450
"Fort Shaw CDP, Montana",93,93,0,163,30,28600
"Fort Smith CDP, Montana",49,49,0,115,30,28650
"Forty Mile Colony CDP, Montana",0,0,0,0,30,28725
"Four Corners CDP, Montana",2875,2870,5,5631,30,28862
"Fox CDP, Montana",24,24,0,71,30,29050
"Fox Lake CDP, Montana",98,98,0,174,30,29087
"Frazer CDP, Montana",127,96,31,365,30,29275
"Frenchtown CDP, Montana",658,634,24,1570,30,29350
"Froid town, Montana",107,107,0,304,30,29500
"Fromberg town, Montana",204,169,35,409,30,29575
"Gallatin Gateway CDP, Montana",423,404,19,886,30,29875
"Gallatin River Ranch CDP, Montana",55,55,0,183,30,29885
"Gardiner CDP, Montana",543,543,0,744,30,29950
"Garrison CDP, Montana",26,24,2,127,30,30175
"Geraldine town, Montana",100,99,1,259,30,30400
"Geyser CDP, Montana",36,35,1,74,30,30550
"Gibson Flats CDP, Montana",0,0,0,82,30,30625
"Gildford CDP, Montana",59,59,0,166,30,30700
"Gildford Colony CDP, Montana",17,17,0,26,30,30704
"Gilman CDP, Montana",16,16,0,25,30,30750
"Glacier Colony CDP, Montana",18,18,0,383,30,30925
"Glasgow city, Montana",1651,1638,13,3208,30,31075
"Glen CDP, Montana",34,34,0,56,30,31375
"Glendale Colony CDP, Montana",0,0,0,0,30,31418
"Glendive city, Montana",2343,2248,95,4861,30,31450
"Goldcreek CDP, Montana",1,1,0,1,30,31825
"Golden Valley Colony CDP, Montana",15,15,0,15,30,31991
"Grant CDP, Montana",20,20,0,38,30,32350
"Grass Range town, Montana",46,46,0,111,30,32575
"Great Falls city, Montana",29851,28828,1023,60373,30,32800
"Greycliff CDP, Montana",80,80,0,91,30,33250
"Hall CDP, Montana",13,13,0,34,30,33625
"Hamilton city, Montana",2350,2294,56,4806,30,33775
"Happys Inn CDP, Montana",55,55,0,78,30,34110
"Hardin city, Montana",1909,1689,220,3803,30,34225
"Hardy CDP, Montana",17,17,0,68,30,34300
"Harlem city, Montana",470,429,41,1005,30,34375
"Harlowton city, Montana",358,358,0,999,30,34450
"Harrison CDP, Montana",35,35,0,42,30,34525
"Hartland Colony CDP, Montana",0,0,0,0,30,34584
"Haugan CDP, Montana",13,13,0,21,30,34825
"Havre city, Montana",4800,4646,154,9332,30,35050
"Havre North CDP, Montana",331,319,12,848,30,35125
"Hays CDP, Montana",488,354,134,1095,30,35275
"Heart Butte CDP, Montana",192,152,40,554,30,35350
"Hebgen Lake Estates CDP, Montana",32,32,0,95,30,35435
"Helena city, Montana",17234,16674,560,32529,30,35600
"Helena Flats CDP, Montana",653,634,19,1071,30,35622
"Helena Valley Northeast CDP, Montana",2482,2445,37,4245,30,35628
"Helena Valley Northwest CDP, Montana",2530,2471,59,5143,30,35631
"Helena Valley Southeast CDP, Montana",4640,4404,236,9374,30,35634
"Helena Valley West Central CDP, Montana",4227,4012,215,8206,30,35637
"Helena West Side CDP, Montana",837,837,0,1591,30,35640
"Helmville CDP, Montana",18,18,0,72,30,35725
"Heron CDP, Montana",80,80,0,299,30,35875
"Herron CDP, Montana",9,9,0,28,30,35912
"Hidden Lake Colony CDP, Montana",0,0,0,0,30,36055
"Highwood CDP, Montana",95,77,18,179,30,36250
"Hilger CDP, Montana",0,0,0,0,30,36325
"Hilldale Colony CDP, Montana",25,25,0,25,30,36333
"Hillside Colony CDP, Montana",95,61,34,259,30,36385
"Hingham town, Montana",49,40,9,108,30,36400
"Hinsdale CDP, Montana",143,139,4,239,30,36475
"Hobson city, Montana",80,66,14,169,30,36700
"Hogeland CDP, Montana",10,10,0,22,30,36925
"Homestead CDP, Montana",13,13,0,15,30,37450
"Horizon Colony CDP, Montana",0,0,0,0,30,37710
"Hot Springs town, Montana",200,181,19,613,30,37825
"Hungry Horse CDP, Montana",325,325,0,891,30,38125
"Huntley CDP, Montana",122,122,0,380,30,38200
"Huson CDP, Montana",44,44,0,83,30,38275
"Hysham town, Montana",107,103,4,232,30,38350
"Indian Springs CDP, Montana",0,0,0,0,30,38480
"Inverness CDP, Montana",10,10,0,23,30,38725
"Ismay town, Montana",0,0,0,0,30,38950
"Jackson CDP, Montana",5,5,0,16,30,39025
"Jardine CDP, Montana",43,31,12,43,30,39175
"Jeffers CDP, Montana",0,0,0,45,30,39325
"Jefferson City CDP, Montana",167,167,0,480,30,39400
"Jette CDP, Montana",59,59,0,192,30,39627
"Joliet town, Montana",325,310,15,643,30,39700
"Joplin CDP, Montana",76,76,0,261,30,39775
"Jordan town, Montana",184,184,0,327,30,39925
"Judith Gap city, Montana",61,59,2,140,30,40000
"Kalispell city, Montana",13045,12506,539,25473,30,40075
"Kerr CDP, Montana",91,91,0,232,30,40355
"Kevin town, Montana",64,64,0,124,30,40525
"Kicking Horse CDP, Montana",79,79,0,106,30,40580
"Kila CDP, Montana",208,204,4,440,30,40675
"Kilby Butte Colony CDP, Montana",0,0,0,0,30,40680
"King Arthur Park CDP, Montana",1397,1397,0,2033,30,40685
"King Ranch Colony CDP, Montana",19,19,0,19,30,40718
"Kingsbury Colony CDP, Montana",0,0,0,9,30,40720
"Kings Point CDP, Montana",166,166,0,301,30,40725
"Klein CDP, Montana",91,91,0,260,30,41050
"Kremlin CDP, Montana",26,26,0,44,30,41725
"Lake Mary Ronan CDP, Montana",23,18,5,58,30,41910
"Lakeside CDP, Montana",1316,1316,0,2564,30,41950
"Lakeview CDP, Montana",24,15,9,31,30,42100
"Lame Deer CDP, Montana",585,431,154,2064,30,42250
"Landusky CDP, Montana",1,1,0,26,30,42325
"Laredo CDP, Montana",0,0,0,0,30,42475
"Laurel city, Montana",3810,3757,53,7181,30,42700
"Lavina town, Montana",78,78,0,123,30,42850
"Lewistown city, Montana",2755,2597,158,5988,30,43375
"Lewistown Heights CDP, Montana",323,323,0,486,30,43400
"Libby city, Montana",1152,1128,24,2857,30,43450
"Lima town, Montana",74,74,0,209,30,43525
"Lincoln CDP, Montana",475,474,1,1005,30,43675
"Lindisfarne CDP, Montana",300,284,16,495,30,43710
"Lindsay CDP, Montana",6,6,0,8,30,43750
"Little Bitterroot Lake CDP, Montana",36,26,10,104,30,43830
"Little Browning CDP, Montana",19,10,9,59,30,43835
"Livingston city, Montana",4856,4650,206,8489,30,43975
"Lockwood CDP, Montana",4082,3928,154,7393,30,44200
"Lodge Grass town, Montana",137,122,15,459,30,44275
"Lodge Pole CDP, Montana",112,67,45,239,30,44350
"Logan CDP, Montana",130,130,0,130,30,44500
"Lolo CDP, Montana",2288,2264,24,4573,30,44650
"Loma CDP, Montana",20,20,0,81,30,44800
"Lonepine CDP, Montana",67,63,4,145,30,44950
"Loring Colony CDP, Montana",15,15,0,15,30,45179
"Luther CDP, Montana",30,30,0,39,30,46150
"McAllister CDP, Montana",23,23,0,221,30,46225
"Malmstrom AFB CDP, Montana",774,745,29,4281,30,47275
"Malta city, Montana",955,914,41,2121,30,47425
"Mammoth CDP, Montana",0,0,0,18,30,47460
"Manhattan town, Montana",1042,1042,0,1986,30,47575
"Marion CDP, Montana",627,557,70,1219,30,47875
"Martin City CDP, Montana",174,163,11,308,30,48100
"Martinsdale CDP, Montana",30,30,0,37,30,48175
"Martinsdale Colony CDP, Montana",22,22,0,22,30,48190
"Marysville CDP, Montana",37,37,0,60,30,48250
"Maverick Mountain CDP, Montana",16,16,0,58,30,48585
"Maxville CDP, Montana",61,61,0,113,30,48625
"Medicine Lake town, Montana",122,118,4,206,30,48775
"Melstone town, Montana",41,41,0,68,30,49000
"Midway Colony CDP, Montana",11,11,0,32,30,49418
"Miles City city, Montana",4700,4501,199,8432,30,49525
"Milford Colony CDP, Montana",0,0,0,0,30,49600
"Miller Colony CDP, Montana",0,0,0,0,30,49750
"Missoula city, Montana",46262,44137,2125,74627,30,50200
"Moccasin CDP, Montana",3,1,2,29,30,50575
"Monarch CDP, Montana",0,0,0,38,30,50950
"Montana City CDP, Montana",1470,1437,33,2716,30,51175
"Montaqua CDP, Montana",57,57,0,98,30,51475
"Moore town, Montana",112,110,2,260,30,51550
"Mountain View Colony CDP, Montana",22,22,0,22,30,52185
"Muddy CDP, Montana",226,212,14,661,30,52315
"Musselshell CDP, Montana",13,13,0,33,30,52600
"Nashua town, Montana",121,108,13,314,30,52900
"Neihart town, Montana",10,10,0,40,30,53200
"New Miami Colony CDP, Montana",15,15,0,178,30,53476
"New Rockport Colony CDP, Montana",59,59,0,107,30,53500
"Niarada CDP, Montana",0,0,0,3,30,53725
"Nibbe CDP, Montana",35,35,0,129,30,53800
"Norris CDP, Montana",26,21,5,44,30,54475
"North Browning CDP, Montana",1030,911,119,3001,30,54510
"North Harlem Colony CDP, Montana",20,20,0,57,30,54684
"Noxon CDP, Montana",109,100,9,205,30,54925
"Nye CDP, Montana",32,32,0,63,30,55075
"Old Agency CDP, Montana",28,23,5,85,30,55260
"Olney CDP, Montana",70,70,0,132,30,55450
"Opheim town, Montana",70,70,0,100,30,55525
"Orchard Homes CDP, Montana",2817,2650,167,5265,30,55675
"Outlook town, Montana",24,23,1,71,30,56050
"Ovando CDP, Montana",23,23,0,44,30,56125
"Pablo CDP, Montana",680,624,56,1799,30,56350
"Paradise CDP, Montana",27,19,8,129,30,56425
"Park City CDP, Montana",507,496,11,1022,30,56575
"Parker School CDP, Montana",72,72,0,387,30,56650
"Peerless CDP, Montana",0,0,0,6,30,56800
"Pendroy CDP, Montana",7,7,0,16,30,56875
"Philipsburg town, Montana",405,349,56,914,30,57175
"Piltzville CDP, Montana",436,436,0,650,30,57475
"Pine Creek CDP, Montana",80,80,0,211,30,57550
"Pinesdale town, Montana",455,445,10,904,30,57700
"Pinnacle CDP, Montana",2,0,2,40,30,57775
"Pioneer Junction CDP, Montana",298,272,26,693,30,57950
"Plains town, Montana",520,507,13,1181,30,58150
"Pleasant Valley Colony CDP, Montana",24,24,0,45,30,58310
"Plentywood city, Montana",902,879,23,1781,30,58375
"Plevna town, Montana",114,114,0,250,30,58450
"Polebridge CDP, Montana",0,0,0,31,30,58675
"Polson city, Montana",2420,2264,156,5218,30,58750
"Pompeys Pillar CDP, Montana",0,0,0,23,30,58825
"Pondera Colony CDP, Montana",20,18,2,40,30,58834
"Ponderosa Pines CDP, Montana",473,473,0,841,30,58840
"Pony CDP, Montana",68,68,0,137,30,58900
"Poplar city, Montana",219,213,6,758,30,58975
"Potomac CDP, Montana",18,18,0,18,30,59350
"Power CDP, Montana",96,96,0,197,30,59500
"Prairie Elk Colony CDP, Montana",0,0,0,0,30,59650
"Pray CDP, Montana",483,465,18,1017,30,59725
"Pryor CDP, Montana",263,211,52,629,30,59950
"Racetrack CDP, Montana",7,7,0,7,30,60400
"Rader Creek CDP, Montana",135,117,18,401,30,60450
"Radersburg CDP, Montana",25,25,0,67,30,60475
"Rapelje CDP, Montana",41,41,0,91,30,60850
"Ravalli CDP, Montana",138,128,10,173,30,61075
"Raynesford CDP, Montana",29,29,0,51,30,61300
"Red Lodge city, Montana",1177,1128,49,2321,30,61525
"Redstone CDP, Montana",6,6,0,19,30,61675
"Reed Point CDP, Montana",86,86,0,175,30,61900
"Reserve CDP, Montana",5,5,0,27,30,62125
"Rexford town, Montana",55,34,21,142,30,62200
"Rhodes CDP, Montana",106,106,0,217,30,62230
"Riceville CDP, Montana",5,5,0,5,30,62245
"Richey town, Montana",151,141,10,245,30,62275
"Rimini CDP, Montana",53,53,0,89,30,62650
"Rimrock Colony CDP, Montana",47,47,0,140,30,62825
"Riverbend CDP, Montana",198,198,0,433,30,63042
"Riverview Colony CDP, Montana",48,48,0,265,30,63266
"Roberts CDP, Montana",163,125,38,281,30,63400
"Rockport Colony CDP, Montana",34,34,0,34,30,63590
"Rockvale CDP, Montana",222,222,0,315,30,63700
"Rocky Boy's Agency CDP, Montana",114,114,0,204,30,63900
"Rocky Boy West CDP, Montana",246,231,15,937,30,63928
"Rocky Point CDP, Montana",22,22,0,156,30,63940
"Rollins CDP, Montana",80,76,4,126,30,64075
"Ronan city, Montana",771,704,67,1868,30,64150
"Roscoe CDP, Montana",17,17,0,24,30,64300
"Rosebud CDP, Montana",8,8,0,12,30,64375
"Roundup city, Montana",822,791,31,1824,30,64525
"Roy CDP, Montana",90,87,3,163,30,64675
"Rudyard CDP, Montana",176,176,0,373,30,64900
"Ryegate town, Montana",97,97,0,245,30,64975
"Saco town, Montana",81,80,1,162,30,65050
"Saddle Butte CDP, Montana",99,85,14,180,30,65065
"Sage Creek Colony CDP, Montana",16,16,0,23,30,65160
"St. Ignatius town, Montana",350,326,24,1019,30,65275
"St. Marie CDP, Montana",112,85,27,428,30,65400
"St. Mary CDP, Montana",206,189,17,242,30,65425
"St. Pierre CDP, Montana",110,80,30,432,30,65537
"St. Regis CDP, Montana",107,107,0,314,30,65575
"St. Xavier CDP, Montana",30,26,4,78,30,65650
"Saltese CDP, Montana",0,0,0,15,30,65875
"Sand Coulee CDP, Montana",107,94,13,223,30,65950
"Sangrey CDP, Montana",122,99,23,501,30,66212
"Santa Rita CDP, Montana",52,38,14,52,30,66250
"Sapphire Ridge CDP, Montana",6,6,0,20,30,66317
"Savage CDP, Montana",206,197,9,294,30,66550
"Scobey city, Montana",408,401,7,791,30,66925
"Sedan CDP, Montana",76,76,0,114,30,67075
"Seeley Lake CDP, Montana",594,558,36,1590,30,67150
"Seville Colony CDP, Montana",0,0,0,0,30,67192
"Shawmut CDP, Montana",19,19,0,37,30,67225
"Shelby city, Montana",1280,1264,16,3058,30,67450
"Shepherd CDP, Montana",394,369,25,772,30,67525
"Sheridan town, Montana",447,436,11,867,30,67600
"Sidney city, Montana",3290,3122,168,6257,30,67900
"Silesia CDP, Montana",11,11,0,11,30,68050
"Silver Gate CDP, Montana",51,51,0,114,30,68425
"Silver Star CDP, Montana",34,34,0,74,30,68500
"Simms CDP, Montana",129,129,0,329,30,68575
"Sleeping Buffalo CDP, Montana",4,4,0,8,30,68985
"Snowslip CDP, Montana",0,0,0,7,30,69345
"Somers CDP, Montana",458,458,0,1037,30,69475
"South Browning CDP, Montana",589,499,90,1654,30,69680
"South Glastonbury CDP, Montana",110,110,0,276,30,69713
"South Hills CDP, Montana",342,342,0,629,30,69725
"Spokane Creek CDP, Montana",316,238,78,513,30,69900
"Spring Creek Colony CDP, Montana",0,0,0,0,30,70000
"Springdale CDP, Montana",9,9,0,13,30,70150
"Springdale Colony CDP, Montana",0,0,0,0,30,70225
"Springhill CDP, Montana",124,124,0,199,30,70375
"Springwater Colony CDP, Montana",25,25,0,25,30,70434
"Square Butte CDP, Montana",5,5,0,21,30,70600
"Stanford town, Montana",109,109,0,229,30,70675
"Starr School CDP, Montana",42,42,0,229,30,70825
"Stevensville town, Montana",963,916,47,2038,30,71200
"Stockett CDP, Montana",67,63,4,150,30,71350
"Stryker CDP, Montana",10,10,0,21,30,71575
"Sula CDP, Montana",23,23,0,36,30,71800
"Sunburst town, Montana",216,187,29,392,30,72175
"Sunnybrook Colony CDP, Montana",0,0,0,0,30,72305
"Sun Prairie CDP, Montana",655,655,0,1366,30,72380
"Sun River CDP, Montana",10,5,5,58,30,72475
"Superior town, Montana",307,287,20,872,30,72625
"Surprise Creek Colony CDP, Montana",10,10,0,10,30,72660
"Swan Lake CDP, Montana",96,96,0,216,30,72850
"Sweet Grass CDP, Montana",39,39,0,70,30,73075
"Sylvanite CDP, Montana",31,31,0,112,30,73165
"Terry town, Montana",238,231,7,501,30,73675
"The Silos CDP, Montana",213,213,0,474,30,73760
"Thompson Falls city, Montana",703,699,4,1658,30,73825
"Three Forks city, Montana",1073,1058,15,1895,30,73975
"Toston CDP, Montana",105,105,0,190,30,74500
"Townsend city, Montana",1113,971,142,2176,30,74575
"Tracy CDP, Montana",49,48,1,74,30,74650
"Trego CDP, Montana",349,347,2,766,30,74725
"Trout Creek CDP, Montana",103,103,0,298,30,74950
"Troy city, Montana",304,300,4,884,30,75025
"Turah CDP, Montana",286,261,25,466,30,75175
"Turner CDP, Montana",48,48,0,69,30,75250
"Turner Colony CDP, Montana",30,30,0,63,30,75258
"Turtle Lake CDP, Montana",33,33,0,133,30,75287
"Twin Bridges town, Montana",67,67,0,237,30,75475
"Twin Creeks CDP, Montana",117,116,1,188,30,75550
"Twin Hills Colony CDP, Montana",25,25,0,25,30,75590
"Twodot CDP, Montana",5,5,0,16,30,75700
"Ulm CDP, Montana",434,421,13,919,30,75775
"Unionville CDP, Montana",144,144,0,349,30,75905
"Utica CDP, Montana",0,0,0,19,30,76075
"Valier town, Montana",245,232,13,576,30,76225
"Vaughn CDP, Montana",473,471,2,975,30,76675
"Victor CDP, Montana",450,450,0,885,30,76900
"Vida CDP, Montana",9,9,0,53,30,76975
"Virginia City town, Montana",61,61,0,127,30,77125
"Walkerville town, Montana",335,309,26,668,30,77650
"Warm Spring Creek CDP, Montana",0,0,0,15,30,78143
"Weeksville CDP, Montana",57,57,0,96,30,78775
"Westby town, Montana",132,132,0,213,30,78925
"West Glacier CDP, Montana",101,98,3,174,30,79075
"West Glendive CDP, Montana",1107,1080,27,1912,30,79086
"West Havre CDP, Montana",87,87,0,144,30,79098
"West Kootenai CDP, Montana",77,77,0,189,30,79105
"West Yellowstone town, Montana",694,683,11,1147,30,79525
"Wheatland CDP, Montana",618,618,0,1017,30,79695
"Whitefish city, Montana",4709,4590,119,8098,30,79825
"Whitehall town, Montana",467,422,45,1129,30,79900
"White Haven CDP, Montana",334,290,44,699,30,79935
"White Sulphur Springs city, Montana",522,522,0,1112,30,80050
"Whitetail CDP, Montana",0,0,0,8,30,80125
"Whitewater CDP, Montana",52,52,0,99,30,80200
"Whitlash CDP, Montana",4,4,0,4,30,80275
"Wibaux town, Montana",268,268,0,640,30,80350
"Willow Creek CDP, Montana",100,98,2,211,30,80800
"Wilsall CDP, Montana",68,68,0,205,30,80875
"Windham CDP, Montana",9,9,0,22,30,80950
"Wineglass CDP, Montana",99,99,0,182,30,80975
"Winifred town, Montana",102,102,0,195,30,81025
"Winnett town, Montana",100,98,2,178,30,81100
"Winston CDP, Montana",24,24,0,96,30,81175
"Wisdom CDP, Montana",64,64,0,107,30,81250
"Wise River CDP, Montana",12,12,0,24,30,81325
"Wolf Creek CDP, Montana",2,2,0,12,30,81400
"Wolf Point city, Montana",1117,932,185,2634,30,81475
"Woods Bay CDP, Montana",421,419,2,737,30,81700
"Worden CDP, Montana",249,237,12,503,30,81925
"Wye CDP, Montana",653,616,37,1074,30,81980
"Wyola CDP, Montana",72,67,5,262,30,82075
"Yaak CDP, Montana",85,79,6,330,30,82130
"York CDP, Montana",168,168,0,234,30,82525
"Zenith Colony CDP, Montana",0,0,0,0,30,82635
"Zortman CDP, Montana",0,0,0,19,30,82675
"Zurich CDP, Montana",23,23,0,40,30,82750
"Abie village, Nebraska",28,28,0,59,31,00205
"Adams village, Nebraska",263,261,2,568,31,00240
"Agnew CDP, Nebraska",0,0,0,0,31,00380
"Ainsworth city, Nebraska",807,801,6,1563,31,00415
"Albion city, Nebraska",786,773,13,1641,31,00555
"Alda village, Nebraska",314,298,16,563,31,00625
"Alexandria village, Nebraska",49,47,2,100,31,00730
"Allen village, Nebraska",258,246,12,444,31,00870
"Alliance city, Nebraska",4012,3794,218,8118,31,00905
"Alma city, Nebraska",514,512,2,1131,31,00975
"Alvo village, Nebraska",62,62,0,105,31,01150
"Ames CDP, Nebraska",0,0,0,0,31,01220
"Amherst village, Nebraska",105,95,10,247,31,01290
"Anoka village, Nebraska",28,28,0,37,31,01465
"Anselmo village, Nebraska",57,57,0,111,31,01500
"Ansley village, Nebraska",262,258,4,576,31,01535
"Arapahoe city, Nebraska",484,484,0,976,31,01780
"Arcadia village, Nebraska",196,196,0,333,31,01850
"Archer CDP, Nebraska",17,17,0,53,31,01920
"Arlington village, Nebraska",822,814,8,1519,31,01990
"Arnold village, Nebraska",428,422,6,901,31,02095
"Arthur village, Nebraska",38,38,0,100,31,02200
"Ashland city, Nebraska",1716,1631,85,3130,31,02305
"Ashton village, Nebraska",153,148,5,256,31,02375
"Aten CDP, Nebraska",46,46,0,52,31,02480
"Atkinson city, Nebraska",727,695,32,1426,31,02550
"Atlanta village, Nebraska",60,60,0,124,31,02620
"Auburn city, Nebraska",1731,1658,73,3434,31,02655
"Aurora city, Nebraska",2172,2084,88,4656,31,02690
"Avoca village, Nebraska",116,110,6,187,31,02795
"Axtell village, Nebraska",394,388,6,781,31,02830
"Ayr village, Nebraska",52,52,0,119,31,02865
"Bancroft village, Nebraska",285,284,1,560,31,03005
"Barada village, Nebraska",8,8,0,21,31,03040
"Barneston village, Nebraska",25,25,0,127,31,03075
"Bartlett village, Nebraska",83,78,5,149,31,03145
"Bartley village, Nebraska",222,216,6,405,31,03180
"Bassett city, Nebraska",317,309,8,602,31,03215
"Battle Creek city, Nebraska",639,634,5,1405,31,03250
"Bayard city, Nebraska",750,732,18,1435,31,03285
"Bazile Mills village, Nebraska",8,8,0,12,31,03355
"Beacon View CDP, Nebraska",4,4,0,30,31,03377
"Beatrice city, Nebraska",5995,5817,178,12237,31,03390
"Beaver City city, Nebraska",233,218,15,500,31,03495
"Beaver Crossing village, Nebraska",164,158,6,353,31,03530
"Bee village, Nebraska",128,126,2,244,31,03600
"Beemer village, Nebraska",375,355,20,692,31,03635
"Belden village, Nebraska",71,69,2,118,31,03775
"Belgrade village, Nebraska",111,111,0,190,31,03810
"Bellevue city, Nebraska",32108,31179,929,63336,31,03950
"Bellwood village, Nebraska",258,250,8,513,31,04020
"Belmar CDP, Nebraska",33,33,0,84,31,04055
"Belvidere village, Nebraska",37,32,5,59,31,04160
"Benedict village, Nebraska",180,178,2,382,31,04195
"Benkelman city, Nebraska",451,451,0,921,31,04230
"Bennet village, Nebraska",638,635,3,1098,31,04300
"Bennington city, Nebraska",1227,1196,31,2432,31,04405
"Berea CDP, Nebraska",23,23,0,30,31,04545
"Bertrand village, Nebraska",344,337,7,681,31,04615
"Berwyn village, Nebraska",48,48,0,75,31,04650
"Big Springs village, Nebraska",231,223,8,479,31,04895
"Bladen village, Nebraska",100,100,0,197,31,05140
"Blair city, Nebraska",4029,3915,114,7813,31,05350
"Bloomfield city, Nebraska",430,425,5,847,31,05455
"Bloomington village, Nebraska",49,49,0,110,31,05490
"Blue Hill city, Nebraska",477,465,12,883,31,05560
"Blue Springs city, Nebraska",58,58,0,199,31,05630
"Bow Valley CDP, Nebraska",49,49,0,86,31,05980
"Boys Town village, Nebraska",143,116,27,720,31,06015
"Bradshaw village, Nebraska",153,139,14,397,31,06050
"Brady village, Nebraska",170,157,13,439,31,06085
"Brainard village, Nebraska",228,225,3,366,31,06120
"Brewster village, Nebraska",6,6,0,34,31,06260
"Bridgeport city, Nebraska",663,623,40,1384,31,06295
"Bristow village, Nebraska",15,15,0,64,31,06400
"Broadwater village, Nebraska",66,66,0,114,31,06470
"Brock village, Nebraska",49,39,10,107,31,06505
"Broken Bow city, Nebraska",1640,1604,36,3510,31,06610
"Brownlee CDP, Nebraska",0,0,0,7,31,06680
"Brownville village, Nebraska",64,58,6,138,31,06750
"Brule village, Nebraska",145,137,8,288,31,06785
"Bruning village, Nebraska",159,159,0,278,31,06820
"Bruno village, Nebraska",37,37,0,109,31,06855
"Brunswick village, Nebraska",98,97,1,171,31,06890
"Burchard village, Nebraska",60,60,0,78,31,07065
"Burr village, Nebraska",17,17,0,34,31,07205
"Burton village, Nebraska",0,0,0,0,31,07310
"Burwell city, Nebraska",457,446,11,938,31,07345
"Bushnell village, Nebraska",36,32,4,141,31,07415
"Butte village, Nebraska",245,238,7,362,31,07485
"Byron village, Nebraska",44,44,0,77,31,07555
"Cairo village, Nebraska",532,524,8,1082,31,07625
"Callaway village, Nebraska",281,278,3,518,31,07660
"Cambridge city, Nebraska",508,508,0,1170,31,07730
"Campbell village, Nebraska",127,124,3,316,31,07870
"Carleton village, Nebraska",114,114,0,178,31,07975
"Carroll village, Nebraska",128,127,1,278,31,08010
"Cedar Bluffs village, Nebraska",396,387,9,757,31,08150
"Cedar Creek village, Nebraska",220,214,6,412,31,08185
"Cedar Rapids village, Nebraska",278,278,0,585,31,08220
"Center village, Nebraska",112,94,18,199,31,08360
"Central City city, Nebraska",1399,1399,0,3035,31,08535
"Ceresco village, Nebraska",750,730,20,1414,31,08570
"Chadron city, Nebraska",3002,2949,53,5255,31,08605
"Chalco CDP, Nebraska",6571,6496,75,10457,31,08640
"Chambers village, Nebraska",213,210,3,419,31,08675
"Champion CDP, Nebraska",5,5,0,15,31,08745
"Chapman village, Nebraska",169,165,4,279,31,08780
"Chappell city, Nebraska",392,379,13,889,31,08885
"Cheney CDP, Nebraska",91,91,0,164,31,08990
"Chester village, Nebraska",127,126,1,229,31,09095
"Clarks village, Nebraska",222,210,12,372,31,09165
"Clarkson city, Nebraska",352,348,4,663,31,09200
"Clatonia village, Nebraska",175,175,0,304,31,09270
"Clay Center city, Nebraska",430,425,5,780,31,09375
"Clearwater village, Nebraska",163,158,5,277,31,09445
"Clinton village, Nebraska",32,32,0,57,31,09655
"Cody village, Nebraska",95,91,4,181,31,09760
"Coleridge village, Nebraska",225,224,1,584,31,09865
"Colon village, Nebraska",62,62,0,115,31,10005
"Columbus city, Nebraska",12605,12290,315,24035,31,10110
"Comstock village, Nebraska",60,53,7,99,31,10180
"Concord village, Nebraska",79,79,0,171,31,10250
"Cook village, Nebraska",248,246,2,450,31,10390
"Cordova village, Nebraska",48,48,0,110,31,10495
"Cornlea village, Nebraska",11,11,0,25,31,10600
"Cortland village, Nebraska",268,263,5,521,31,10635
"Cotesfield village, Nebraska",14,14,0,29,31,10740
"Cowles village, Nebraska",2,2,0,4,31,10985
"Cozad city, Nebraska",2014,1994,20,3943,31,11020
"Crab Orchard village, Nebraska",16,16,0,27,31,11055
"Craig village, Nebraska",75,74,1,143,31,11090
"Crawford city, Nebraska",369,365,4,962,31,11195
"Creighton city, Nebraska",563,549,14,1241,31,11230
"Creston village, Nebraska",77,77,0,167,31,11300
"Crete city, Nebraska",3608,3502,106,7093,31,11370
"Crofton city, Nebraska",427,417,10,907,31,11440
"Crookston village, Nebraska",17,16,1,24,31,11475
"Culbertson village, Nebraska",296,286,10,621,31,11615
"Curtis city, Nebraska",398,375,23,786,31,11825
"Cushing village, Nebraska",63,50,13,91,31,11860
"Dakota City city, Nebraska",1441,1377,64,2857,31,12000
"Dalton village, Nebraska",160,160,0,353,31,12070
"Danbury village, Nebraska",43,41,2,69,31,12105
"Dannebrog village, Nebraska",131,128,3,237,31,12140
"Davenport village, Nebraska",148,139,9,344,31,12245
"Davey village, Nebraska",81,80,1,149,31,12280
"David City city, Nebraska",1551,1548,3,3000,31,12315
"Dawson village, Nebraska",81,77,4,182,31,12420
"Daykin village, Nebraska",96,95,1,188,31,12455
"Decatur village, Nebraska",257,211,46,509,31,12525
"Denton village, Nebraska",90,89,1,152,31,12770
"Deshler city, Nebraska",345,321,24,774,31,12840
"Deweese village, Nebraska",13,13,0,35,31,12945
"De Witt village, Nebraska",290,287,3,512,31,13015
"Diller village, Nebraska",143,142,1,245,31,13085
"Dix village, Nebraska",159,148,11,320,31,13190
"Dixon village, Nebraska",26,26,0,84,31,13225
"Dodge village, Nebraska",176,174,2,416,31,13295
"Doniphan village, Nebraska",604,598,6,916,31,13365
"Dorchester village, Nebraska",288,283,5,547,31,13435
"Douglas village, Nebraska",115,114,1,237,31,13505
"Du Bois village, Nebraska",71,71,0,141,31,13750
"Dunbar village, Nebraska",141,104,37,201,31,13855
"Duncan village, Nebraska",252,251,1,633,31,13890
"Dunning village, Nebraska",36,34,2,67,31,13960
"Dwight village, Nebraska",167,167,0,253,31,14065
"Eagle village, Nebraska",633,609,24,999,31,14100
"Eddyville village, Nebraska",53,53,0,98,31,14380
"Edgar city, Nebraska",198,193,5,513,31,14450
"Edison village, Nebraska",53,49,4,157,31,14520
"Elba village, Nebraska",143,124,19,218,31,14555
"Elgin city, Nebraska",320,312,8,610,31,14730
"Elk Creek village, Nebraska",61,61,0,111,31,14975
"Elm Creek village, Nebraska",609,593,16,1176,31,15360
"Elmwood village, Nebraska",412,400,12,744,31,15430
"Elsie village, Nebraska",59,57,2,146,31,15500
"Elwood village, Nebraska",290,279,11,519,31,15570
"Elyria village, Nebraska",20,20,0,44,31,15605
"Emerald CDP, Nebraska",0,0,0,5,31,15675
"Emerson village, Nebraska",515,502,13,891,31,15710
"Emmet village, Nebraska",15,15,0,20,31,15815
"Enders CDP, Nebraska",0,0,0,0,31,15885
"Endicott village, Nebraska",110,107,3,194,31,15920
"Ericson village, Nebraska",46,46,0,90,31,16025
"Eustis village, Nebraska",223,219,4,409,31,16165
"Ewing village, Nebraska",174,160,14,384,31,16270
"Exeter village, Nebraska",324,321,3,524,31,16340
"Fairbury city, Nebraska",1908,1889,19,3913,31,16410
"Fairfield city, Nebraska",207,204,3,375,31,16445
"Fairmont village, Nebraska",244,236,8,621,31,16550
"Falls City city, Nebraska",1918,1808,110,4124,31,16655
"Farnam village, Nebraska",82,82,0,173,31,16725
"Farwell village, Nebraska",46,44,2,72,31,16760
"Filley village, Nebraska",52,52,0,95,31,16830
"Firth village, Nebraska",283,283,0,469,31,16935
"Fontanelle CDP, Nebraska",36,36,0,58,31,17040
"Fordyce village, Nebraska",128,110,18,237,31,17110
"Fort Calhoun city, Nebraska",535,528,7,1154,31,17145
"Foster village, Nebraska",14,14,0,34,31,17320
"Franklin city, Nebraska",368,364,4,809,31,17530
"Fremont city, Nebraska",13819,13135,684,27230,31,17670
"Friend city, Nebraska",622,613,9,1117,31,17775
"Fullerton city, Nebraska",615,578,37,1353,31,17810
"Funk village, Nebraska",77,77,0,172,31,17880
"Gandy village, Nebraska",11,11,0,26,31,17950
"Garland village, Nebraska",131,127,4,260,31,18230
"Garrison village, Nebraska",26,25,1,48,31,18300
"Geneva city, Nebraska",1158,1146,12,2097,31,18405
"Genoa city, Nebraska",333,316,17,761,31,18475
"Gering city, Nebraska",4231,4133,98,8582,31,18580
"Gibbon city, Nebraska",918,857,61,1785,31,18615
"Gilead village, Nebraska",10,10,0,18,31,18720
"Giltner village, Nebraska",258,251,7,463,31,18825
"Glenvil village, Nebraska",157,149,8,329,31,19070
"Glenwood CDP, Nebraska",377,377,0,637,31,19160
"Goehner village, Nebraska",122,120,2,242,31,19245
"Gordon city, Nebraska",741,717,24,1697,31,19350
"Gothenburg city, Nebraska",1917,1853,64,3463,31,19385
"Grafton village, Nebraska",89,88,1,148,31,19455
"Grand Island city, Nebraska",26785,25943,842,52822,31,19595
"Grant city, Nebraska",691,683,8,1398,31,19910
"Greeley Center village, Nebraska",154,148,6,421,31,20050
"Greenwood village, Nebraska",301,290,11,543,31,20190
"Gresham village, Nebraska",135,131,4,278,31,20225
"Gretna city, Nebraska",5343,5281,62,9019,31,20260
"Gross village, Nebraska",10,10,0,11,31,20295
"Guide Rock village, Nebraska",135,129,6,293,31,20365
"Gurley village, Nebraska",128,114,14,266,31,20435
"Hadar village, Nebraska",219,210,9,309,31,20470
"Haigler village, Nebraska",62,62,0,165,31,20540
"Hallam village, Nebraska",166,166,0,274,31,20610
"Halsey village, Nebraska",19,19,0,42,31,20680
"Hamlet village, Nebraska",17,17,0,35,31,20750
"Hampton village, Nebraska",276,270,6,431,31,20785
"Harbine village, Nebraska",23,23,0,71,31,20960
"Hardy village, Nebraska",67,67,0,158,31,20995
"Harrisburg CDP, Nebraska",31,30,1,59,31,21030
"Harrison village, Nebraska",96,91,5,241,31,21240
"Hartington city, Nebraska",766,742,24,1552,31,21275
"Harvard city, Nebraska",523,513,10,1056,31,21345
"Hastings city, Nebraska",12948,12561,387,25098,31,21415
"Hayes Center village, Nebraska",158,157,1,284,31,21660
"Hay Springs village, Nebraska",316,316,0,656,31,21730
"Hazard village, Nebraska",14,14,0,49,31,21765
"Heartwell village, Nebraska",60,57,3,100,31,21835
"Hebron city, Nebraska",760,747,13,1569,31,21905
"Hemingford village, Nebraska",294,294,0,620,31,22045
"Henderson city, Nebraska",380,380,0,958,31,22080
"Hendley village, Nebraska",8,8,0,25,31,22115
"Henry village, Nebraska",40,39,1,61,31,22150
"Herman village, Nebraska",240,236,4,360,31,22185
"Hershey village, Nebraska",313,307,6,668,31,22290
"Hickman city, Nebraska",1353,1348,5,2697,31,22325
"Hildreth village, Nebraska",196,191,5,427,31,22430
"Holbrook village, Nebraska",114,111,3,293,31,22605
"Holdrege city, Nebraska",2887,2863,24,5494,31,22640
"Holmesville CDP, Nebraska",33,33,0,73,31,22780
"Holstein village, Nebraska",118,110,8,197,31,22815
"Homer village, Nebraska",228,218,10,389,31,22920
"Hooper city, Nebraska",436,424,12,980,31,23025
"Hordville village, Nebraska",125,125,0,216,31,23200
"Hoskins village, Nebraska",215,215,0,333,31,23235
"Howard City (Boelus) village, Nebraska",105,104,1,193,31,23270
"Howells village, Nebraska",348,348,0,699,31,23340
"Hubbard village, Nebraska",122,115,7,199,31,23375
"Hubbell village, Nebraska",24,24,0,64,31,23410
"Humboldt city, Nebraska",445,411,34,876,31,23445
"Humphrey city, Nebraska",387,381,6,722,31,23480
"Huntley village, Nebraska",48,48,0,69,31,23550
"Hyannis village, Nebraska",83,83,0,127,31,23655
"Imperial city, Nebraska",1089,1057,32,2207,31,23690
"Inavale CDP, Nebraska",32,32,0,50,31,23725
"Indianola city, Nebraska",234,230,4,517,31,23830
"Inglewood village, Nebraska",282,279,3,585,31,23970
"Inland CDP, Nebraska",0,0,0,14,31,24005
"Inman village, Nebraska",41,41,0,129,31,24075
"Ithaca village, Nebraska",72,71,1,137,31,24285
"Jackson village, Nebraska",107,99,8,258,31,24355
"Jansen village, Nebraska",58,55,3,101,31,24530
"Johnson village, Nebraska",118,110,8,260,31,24670
"Johnstown village, Nebraska",14,14,0,14,31,24740
"Julian village, Nebraska",20,20,0,47,31,24915
"Juniata village, Nebraska",347,347,0,702,31,24950
"Kearney city, Nebraska",19540,18966,574,33809,31,25055
"Kenesaw village, Nebraska",405,391,14,826,31,25160
"Kennard village, Nebraska",268,267,1,429,31,25230
"Keystone CDP, Nebraska",10,10,0,21,31,25335
"Kilgore village, Nebraska",63,63,0,116,31,25405
"Kimball city, Nebraska",1064,1042,22,2149,31,25475
"King Lake CDP, Nebraska",20,10,10,71,31,25510
"Kramer CDP, Nebraska",0,0,0,10,31,25720
"Lakeview CDP, Nebraska",209,202,7,264,31,26150
"Lamar village, Nebraska",4,4,0,8,31,26175
"La Platte CDP, Nebraska",85,85,0,151,31,26315
"Laurel city, Nebraska",535,530,5,956,31,26350
"La Vista city, Nebraska",10369,9966,403,16713,31,26385
"Lawrence village, Nebraska",124,117,7,220,31,26420
"Lebanon village, Nebraska",43,31,12,78,31,26455
"Leigh village, Nebraska",206,204,2,429,31,26560
"Lemoyne CDP, Nebraska",16,16,0,57,31,26595
"Leshara village, Nebraska",121,121,0,148,31,26630
"Lewellen village, Nebraska",77,71,6,211,31,26805
"Lewiston village, Nebraska",14,14,0,39,31,26875
"Lexington city, Nebraska",5401,5257,144,10662,31,26910
"Liberty village, Nebraska",15,15,0,48,31,26980
"Lincoln city, Nebraska",165447,159993,5454,290531,31,28000
"Lindsay village, Nebraska",155,155,0,264,31,28105
"Lindy CDP, Nebraska",2,2,0,17,31,28140
"Linoma Beach CDP, Nebraska",13,13,0,24,31,28165
"Linwood village, Nebraska",44,44,0,117,31,28245
"Lisco CDP, Nebraska",6,6,0,16,31,28315
"Litchfield village, Nebraska",178,175,3,298,31,28350
"Lodgepole village, Nebraska",112,105,7,248,31,28420
"Long Pine city, Nebraska",150,150,0,292,31,29050
"Loomis village, Nebraska",173,167,6,371,31,29085
"Lorenzo CDP, Nebraska",12,12,0,12,31,29120
"Loretto CDP, Nebraska",53,53,0,93,31,29155
"Lorton village, Nebraska",34,34,0,66,31,29175
"Louisville city, Nebraska",827,796,31,1499,31,29260
"Loup City city, Nebraska",474,443,31,980,31,29470
"Lushton village, Nebraska",5,5,0,23,31,29645
"Lyman village, Nebraska",158,147,11,395,31,29715
"Lynch village, Nebraska",91,91,0,169,31,29750
"Lyons city, Nebraska",362,358,4,815,31,29855
"McCook city, Nebraska",3918,3815,103,7412,31,29925
"McCool Junction village, Nebraska",553,553,0,718,31,29960
"McGrew village, Nebraska",33,29,4,83,31,30030
"McLean village, Nebraska",76,76,0,99,31,30065
"Macy CDP, Nebraska",257,191,66,779,31,30170
"Madison city, Nebraska",1054,1005,49,2098,31,30240
"Madrid village, Nebraska",103,103,0,202,31,30275
"Magnet village, Nebraska",25,25,0,52,31,30310
"Malcolm village, Nebraska",301,294,7,466,31,30345
"Malmo village, Nebraska",76,76,0,124,31,30380
"Manley village, Nebraska",138,138,0,211,31,30415
"Marquette village, Nebraska",123,122,1,248,31,30730
"Martell CDP, Nebraska",103,103,0,119,31,30835
"Martin CDP, Nebraska",6,6,0,81,31,30905
"Martinsburg village, Nebraska",38,37,1,72,31,30940
"Maskell village, Nebraska",23,22,1,62,31,31045
"Mason City village, Nebraska",77,77,0,152,31,31115
"Max CDP, Nebraska",83,83,0,149,31,31150
"Maxwell village, Nebraska",127,123,4,245,31,31220
"Maywood village, Nebraska",142,116,26,258,31,31325
"Mead village, Nebraska",347,340,7,590,31,31395
"Meadow Grove village, Nebraska",128,126,2,197,31,31465
"Melbeta village, Nebraska",90,88,2,163,31,31570
"Melia CDP, Nebraska",51,51,0,76,31,31605
"Memphis village, Nebraska",47,47,0,92,31,31640
"Merna village, Nebraska",196,190,6,364,31,31780
"Merriman village, Nebraska",24,24,0,96,31,31815
"Milford city, Nebraska",1376,1371,5,2530,31,32060
"Miller village, Nebraska",58,58,0,137,31,32130
"Milligan village, Nebraska",127,127,0,256,31,32200
"Minatare city, Nebraska",445,361,84,891,31,32305
"Minden city, Nebraska",1545,1545,0,3099,31,32340
"Mitchell city, Nebraska",870,836,34,1930,31,32410
"Monowi village, Nebraska",0,0,0,1,31,32550
"Monroe village, Nebraska",160,157,3,314,31,32585
"Moorefield village, Nebraska",14,14,0,45,31,32760
"Morrill village, Nebraska",356,341,15,773,31,32830
"Morse Bluff village, Nebraska",42,42,0,75,31,32865
"Mullen village, Nebraska",236,236,0,453,31,33250
"Murdock village, Nebraska",123,123,0,240,31,33320
"Murray village, Nebraska",217,203,14,459,31,33425
"Naper village, Nebraska",42,42,0,156,31,33530
"Naponee village, Nebraska",77,77,0,135,31,33565
"Nebraska City city, Nebraska",3830,3724,106,7257,31,33705
"Nehawka village, Nebraska",106,103,3,188,31,33740
"Neligh city, Nebraska",796,764,32,1624,31,33775
"Nelson city, Nebraska",213,208,5,409,31,33880
"Nemaha village, Nebraska",50,44,6,99,31,33950
"Nenzel village, Nebraska",3,3,0,19,31,33985
"Newcastle village, Nebraska",213,213,0,384,31,34090
"Newman Grove city, Nebraska",456,395,61,946,31,34230
"Newport village, Nebraska",39,39,0,66,31,34265
"Nickerson village, Nebraska",283,272,11,542,31,34300
"Niobrara village, Nebraska",139,133,6,344,31,34370
"Nora village, Nebraska",15,15,0,25,31,34545
"Norfolk city, Nebraska",13723,13365,358,25883,31,34615
"Norman village, Nebraska",23,23,0,35,31,34650
"North Bend city, Nebraska",650,637,13,1250,31,34720
"North Loup village, Nebraska",118,117,1,221,31,34825
"North Platte city, Nebraska",11613,11173,440,23309,31,35000
"Oak village, Nebraska",12,12,0,43,31,35245
"Oakdale village, Nebraska",164,162,2,318,31,35385
"Oakland city, Nebraska",707,707,0,1578,31,35490
"Obert village, Nebraska",14,14,0,23,31,35560
"Oconto village, Nebraska",59,53,6,162,31,35665
"Octavia village, Nebraska",87,87,0,159,31,35700
"Odell village, Nebraska",138,138,0,290,31,35735
"Odessa CDP, Nebraska",50,50,0,129,31,35770
"Offutt AFB CDP, Nebraska",1877,1825,52,5627,31,35875
"Ogallala city, Nebraska",2384,2300,84,4835,31,35980
"Ohiowa village, Nebraska",61,59,2,120,31,36015
"Omaha city, Nebraska",265746,254583,11163,489201,31,37000
"O'Neill city, Nebraska",1786,1786,0,3584,31,37105
"Ong village, Nebraska",30,28,2,60,31,37140
"Orchard village, Nebraska",171,167,4,382,31,37210
"Ord city, Nebraska",1052,1041,11,2121,31,37280
"Orleans village, Nebraska",171,170,1,373,31,37420
"Osceola city, Nebraska",445,425,20,803,31,37525
"Oshkosh city, Nebraska",358,341,17,965,31,37560
"Osmond city, Nebraska",325,325,0,678,31,37595
"Otoe village, Nebraska",123,120,3,268,31,37630
"Overland CDP, Nebraska",35,35,0,194,31,37735
"Overton village, Nebraska",364,349,15,706,31,37770
"Oxford village, Nebraska",464,454,10,862,31,37910
"Page village, Nebraska",66,66,0,130,31,38085
"Palisade village, Nebraska",138,137,1,346,31,38130
"Palmer village, Nebraska",225,224,1,377,31,38160
"Palmyra village, Nebraska",402,395,7,735,31,38190
"Panama village, Nebraska",165,158,7,253,31,38225
"Papillion city, Nebraska",13112,12760,352,24016,31,38295
"Parks CDP, Nebraska",8,8,0,8,31,38365
"Pawnee City city, Nebraska",424,412,12,944,31,38575
"Paxton village, Nebraska",292,289,3,577,31,38610
"Pender village, Nebraska",677,662,15,1273,31,38750
"Peru city, Nebraska",417,368,49,727,31,38960
"Petersburg village, Nebraska",229,221,8,433,31,38995
"Phillips village, Nebraska",204,202,2,317,31,39030
"Pickrell village, Nebraska",99,99,0,221,31,39065
"Pierce city, Nebraska",1192,1168,24,2049,31,39100
"Pilger village, Nebraska",180,179,1,300,31,39135
"Plainview city, Nebraska",648,611,37,1326,31,39170
"Platte Center village, Nebraska",194,194,0,358,31,39310
"Plattsmouth city, Nebraska",3485,3459,26,6585,31,39345
"Pleasant Dale village, Nebraska",173,158,15,259,31,39380
"Pleasanton village, Nebraska",221,220,1,406,31,39450
"Plymouth village, Nebraska",190,186,4,371,31,39590
"Polk village, Nebraska",194,190,4,336,31,39660
"Ponca city, Nebraska",391,373,18,713,31,39695
"Poole CDP, Nebraska",11,11,0,14,31,39835
"Potter village, Nebraska",167,164,3,316,31,39870
"Prague village, Nebraska",216,203,13,342,31,39975
"Prairie Home CDP, Nebraska",0,0,0,0,31,40255
"Preston village, Nebraska",18,18,0,38,31,40325
"Primrose village, Nebraska",19,19,0,50,31,40360
"Princeton CDP, Nebraska",95,95,0,127,31,40395
"Prosser village, Nebraska",48,48,0,88,31,40430
"Raeville CDP, Nebraska",0,0,0,0,31,40535
"Ragan village, Nebraska",7,7,0,7,31,40570
"Ralston city, Nebraska",3827,3758,69,6462,31,40605
"Randolph city, Nebraska",518,514,4,1034,31,40675
"Ravenna city, Nebraska",763,742,21,1408,31,40710
"Raymond village, Nebraska",116,116,0,256,31,40780
"Red Cloud city, Nebraska",495,489,6,917,31,40920
"Republican City village, Nebraska",54,54,0,148,31,41130
"Reynolds village, Nebraska",40,34,6,68,31,41235
"Richfield CDP, Nebraska",25,25,0,40,31,41340
"Richland village, Nebraska",19,19,0,50,31,41375
"Rising City village, Nebraska",208,208,0,337,31,41480
"Riverdale village, Nebraska",146,143,3,313,31,41515
"Riverton village, Nebraska",64,64,0,101,31,41760
"Roca village, Nebraska",93,92,1,159,31,41830
"Rockville village, Nebraska",95,94,1,197,31,42075
"Rogers village, Nebraska",26,26,0,94,31,42145
"Rosalie village, Nebraska",108,95,13,233,31,42250
"Roscoe CDP, Nebraska",35,35,0,99,31,42285
"Roseland village, Nebraska",120,119,1,258,31,42355
"Royal village, Nebraska",45,45,0,62,31,42495
"Rulo village, Nebraska",75,71,4,134,31,42670
"Rushville city, Nebraska",434,407,27,1011,31,42775
"Ruskin village, Nebraska",94,94,0,172,31,42810
"St. Edward city, Nebraska",289,282,7,596,31,43055
"St. Helena village, Nebraska",67,65,2,111,31,43090
"St. Libory CDP, Nebraska",138,138,0,295,31,43160
"St. Paul city, Nebraska",1126,1092,34,2408,31,43265
"Salem village, Nebraska",21,21,0,88,31,43370
"Santee village, Nebraska",101,77,24,262,31,43475
"Sarben CDP, Nebraska",4,4,0,13,31,43650
"Sargent city, Nebraska",258,254,4,486,31,43685
"Saronville village, Nebraska",26,26,0,48,31,43755
"Schuyler city, Nebraska",3298,3233,65,6516,31,44035
"Scotia village, Nebraska",179,179,0,378,31,44070
"Scottsbluff city, Nebraska",7208,7040,168,14454,31,44245
"Scribner city, Nebraska",364,356,8,779,31,44280
"Seneca CDP, Nebraska",11,11,0,30,31,44385
"Seward city, Nebraska",3968,3891,77,7667,31,44420
"Shelby village, Nebraska",350,339,11,675,31,44595
"Shelton village, Nebraska",792,724,68,1333,31,44700
"Shickley village, Nebraska",195,195,0,374,31,45085
"Sholes village, Nebraska",10,10,0,25,31,45190
"Shubert village, Nebraska",154,144,10,226,31,45225
"Sidney city, Nebraska",3151,3096,55,6407,31,45295
"Silver Creek village, Nebraska",241,241,0,384,31,45400
"Smithfield village, Nebraska",43,40,3,96,31,45575
"Snyder village, Nebraska",185,181,4,328,31,45610
"South Bend village, Nebraska",50,49,1,92,31,45680
"South Sioux City city, Nebraska",7101,6940,161,13835,31,46030
"Spalding village, Nebraska",149,140,9,379,31,46135
"Spencer village, Nebraska",166,165,1,316,31,46275
"Sprague village, Nebraska",43,43,0,91,31,46380
"Springfield city, Nebraska",867,822,45,1555,31,46520
"Springview village, Nebraska",91,90,1,220,31,46625
"Stamford village, Nebraska",70,70,0,195,31,46695
"Stanton city, Nebraska",782,768,14,1673,31,46800
"Staplehurst village, Nebraska",204,202,2,313,31,46835
"Stapleton village, Nebraska",194,192,2,393,31,46870
"Steele City village, Nebraska",33,33,0,76,31,47010
"Steinauer village, Nebraska",35,35,0,100,31,47080
"Stella village, Nebraska",69,56,13,139,31,47115
"Sterling village, Nebraska",315,298,17,698,31,47150
"Stockham village, Nebraska",6,6,0,12,31,47220
"Stockville village, Nebraska",0,0,0,8,31,47290
"Strang village, Nebraska",10,10,0,22,31,47360
"Stratton village, Nebraska",143,141,2,353,31,47395
"Stromsburg city, Nebraska",457,447,10,970,31,47465
"Stuart village, Nebraska",373,373,0,536,31,47500
"Sumner village, Nebraska",272,272,0,406,31,47675
"Sunol CDP, Nebraska",77,49,28,146,31,47745
"Superior city, Nebraska",1035,1018,17,1905,31,47815
"Surprise village, Nebraska",14,13,1,35,31,47850
"Sutherland village, Nebraska",657,636,21,1184,31,47920
"Sutton city, Nebraska",761,751,10,1384,31,47955
"Swanton village, Nebraska",81,75,6,144,31,48060
"Syracuse city, Nebraska",867,867,0,1876,31,48235
"Table Rock village, Nebraska",154,154,0,334,31,48270
"Talmage village, Nebraska",83,82,1,197,31,48305
"Tamora CDP, Nebraska",12,12,0,12,31,48340
"Tarnov village, Nebraska",8,8,0,15,31,48410
"Taylor village, Nebraska",70,70,0,146,31,48445
"Tecumseh city, Nebraska",907,896,11,1878,31,48480
"Tekamah city, Nebraska",771,748,23,1847,31,48515
"Terrytown city, Nebraska",350,336,14,714,31,48585
"Thayer village, Nebraska",28,28,0,47,31,48690
"Thedford village, Nebraska",148,145,3,198,31,48760
"Thurston village, Nebraska",77,74,3,122,31,48900
"Tilden city, Nebraska",579,562,17,1110,31,48935
"Tobias village, Nebraska",59,58,1,96,31,49005
"Trenton village, Nebraska",182,179,3,442,31,49145
"Trumbull village, Nebraska",113,109,4,244,31,49285
"Tryon CDP, Nebraska",64,64,0,129,31,49320
"Uehling village, Nebraska",132,123,9,289,31,49425
"Ulysses village, Nebraska",117,102,15,192,31,49460
"Unadilla village, Nebraska",204,204,0,380,31,49530
"Union village, Nebraska",138,137,1,242,31,49635
"Upland village, Nebraska",73,73,0,126,31,49880
"Utica village, Nebraska",618,610,8,1117,31,49915
"Valentine city, Nebraska",1414,1414,0,2621,31,49950
"Valley city, Nebraska",1575,1530,45,3032,31,50020
"Valparaiso village, Nebraska",271,269,2,513,31,50125
"Venango village, Nebraska",67,60,7,152,31,50230
"Venice CDP, Nebraska",18,18,0,26,31,50265
"Verdel village, Nebraska",15,15,0,38,31,50335
"Verdigre village, Nebraska",265,251,14,609,31,50370
"Verdon village, Nebraska",151,146,5,235,31,50510
"Virginia village, Nebraska",39,39,0,62,31,50790
"Waco village, Nebraska",83,83,0,171,31,50895
"Wahoo city, Nebraska",2446,2377,69,4832,31,50965
"Wakefield city, Nebraska",625,590,35,1354,31,51070
"Wallace village, Nebraska",131,131,0,287,31,51175
"Walthill village, Nebraska",382,329,53,911,31,51245
"Walton CDP, Nebraska",340,340,0,474,31,51280
"Wann CDP, Nebraska",64,53,11,93,31,51350
"Washington village, Nebraska",132,129,3,206,31,51595
"Waterbury village, Nebraska",46,46,0,68,31,51630
"Waterloo village, Nebraska",473,467,6,931,31,51665
"Wauneta village, Nebraska",210,195,15,546,31,51700
"Wausa village, Nebraska",345,335,10,604,31,51735
"Waverly city, Nebraska",1943,1938,5,4289,31,51770
"Wayne city, Nebraska",3561,3403,158,5973,31,51840
"Weeping Water city, Nebraska",585,533,52,1201,31,52015
"Wellfleet village, Nebraska",36,36,0,79,31,52085
"Western village, Nebraska",96,89,7,213,31,52295
"Westerville CDP, Nebraska",0,0,0,17,31,52330
"Weston village, Nebraska",127,123,4,254,31,52540
"West Point city, Nebraska",1871,1843,28,3481,31,52575
"White Clay CDP, Nebraska",0,0,0,0,31,52855
"Whitney village, Nebraska",32,30,2,62,31,52925
"Wilber city, Nebraska",1040,1023,17,1967,31,52960
"Wilcox village, Nebraska",182,176,6,346,31,52995
"Willow Island CDP, Nebraska",0,0,0,0,31,53205
"Wilsonville village, Nebraska",41,41,0,69,31,53240
"Winnebago village, Nebraska",329,271,58,869,31,53275
"Winnetoon village, Nebraska",19,17,2,44,31,53345
"Winside village, Nebraska",318,318,0,582,31,53380
"Winslow village, Nebraska",87,87,0,109,31,53415
"Wisner city, Nebraska",793,788,5,1389,31,53450
"Wolbach village, Nebraska",107,104,3,248,31,53520
"Wood Lake village, Nebraska",9,9,0,23,31,53555
"Woodland Hills CDP, Nebraska",159,159,0,300,31,53575
"Woodland Park CDP, Nebraska",974,967,7,1655,31,53580
"Wood River city, Nebraska",752,713,39,1405,31,53660
"Wymore city, Nebraska",627,601,26,1287,31,53835
"Wynot village, Nebraska",117,116,1,211,31,53905
"Yankee Hill CDP, Nebraska",133,133,0,221,31,54020
"York city, Nebraska",4171,4007,164,8101,31,54045
"Yutan city, Nebraska",763,733,30,1451,31,54115
"Alamo CDP, Nevada",433,433,0,1019,32,00500
"Amargosa Valley CDP, Nevada",329,328,1,1355,32,01000
"Austin CDP, Nevada",16,16,0,16,32,03700
"Baker CDP, Nevada",10,10,0,21,32,04100
"Battle Mountain CDP, Nevada",1952,1655,297,4187,32,04900
"Beatty CDP, Nevada",262,262,0,596,32,05100
"Beaverdam CDP, Nevada",8,8,0,18,32,05125
"Bennett Springs CDP, Nevada",64,64,0,85,32,05275
"Blue Diamond CDP, Nevada",169,144,25,247,32,05700
"Boulder City city, Nevada",6290,5878,412,14868,32,06500
"Bunkerville CDP, Nevada",243,243,0,1008,32,08100
"Caliente city, Nevada",361,346,15,840,32,08500
"Cal-Nev-Ari CDP, Nevada",25,14,11,254,32,08600
"Carlin city, Nevada",1248,1185,63,2366,32,08900
"Carson City, Nevada",28674,27340,1334,58249,32,09700
"Carter Springs CDP, Nevada",225,217,8,450,32,10200
"Cold Springs CDP, Nevada",5129,4959,170,11029,32,14090
"Crescent Valley CDP, Nevada",155,155,0,456,32,16300
"Crystal Bay CDP, Nevada",13,13,0,184,32,16700
"Dayton CDP, Nevada",8286,7592,694,15415,32,17500
"Denio CDP, Nevada",7,7,0,15,32,18500
"Double Spring CDP, Nevada",87,75,12,276,32,19150
"Dry Valley CDP, Nevada",0,0,0,0,32,19800
"Dyer CDP, Nevada",144,144,0,343,32,20700
"East Valley CDP, Nevada",427,393,34,1294,32,21520
"Elko city, Nevada",10950,10457,493,20513,32,22500
"Ely city, Nevada",2155,2070,85,3957,32,23500
"Empire CDP, Nevada",81,81,0,162,32,23700
"Enterprise CDP, Nevada",129316,120761,8555,225461,32,23770
"Eureka CDP, Nevada",163,163,0,315,32,23900
"Fallon city, Nevada",4259,4072,187,9243,32,24100
"Fallon Station CDP, Nevada",230,230,0,938,32,24500
"Fernley city, Nevada",11580,11042,538,23035,32,24900
"Fish Springs CDP, Nevada",215,212,3,549,32,25000
"Fort McDermitt CDP, Nevada",68,56,12,254,32,25490
"Gabbs CDP, Nevada",21,21,0,65,32,25900
"Gardnerville CDP, Nevada",3057,2919,138,6147,32,26300
"Gardnerville Ranchos CDP, Nevada",5610,5419,191,12057,32,26500
"Genoa CDP, Nevada",448,431,17,1013,32,27100
"Gerlach CDP, Nevada",21,21,0,21,32,27300
"Glenbrook CDP, Nevada",75,75,0,214,32,27900
"Golconda CDP, Nevada",75,75,0,178,32,28500
"Golden Valley CDP, Nevada",455,445,10,1184,32,28860
"Goldfield CDP, Nevada",88,80,8,212,32,28900
"Goodsprings CDP, Nevada",106,17,89,123,32,29500
"Grass Valley CDP, Nevada",608,534,74,1190,32,30220
"Hawthorne CDP, Nevada",1143,1117,26,2739,32,31300
"Henderson city, Nevada",157149,146088,11061,318063,32,31900
"Hiko CDP, Nevada",0,0,0,11,32,32900
"Humboldt River Ranch CDP, Nevada",26,26,0,213,32,34100
"Imlay CDP, Nevada",0,0,0,68,32,34700
"Incline Village CDP, Nevada",4993,4817,176,9163,32,35100
"Indian Hills CDP, Nevada",2965,2891,74,5955,32,35275
"Indian Springs CDP, Nevada",394,371,23,837,32,35300
"Jackpot CDP, Nevada",866,741,125,1215,32,36500
"Johnson Lane CDP, Nevada",2520,2520,0,6499,32,37190
"Kingsbury CDP, Nevada",1000,987,13,1920,32,38000
"Kingston CDP, Nevada",46,46,0,142,32,38100
"Lakeridge CDP, Nevada",72,72,0,278,32,39100
"Lamoille CDP, Nevada",0,0,0,55,32,39300
"Las Vegas city, Nevada",318751,295026,23725,644835,32,40000
"Laughlin CDP, Nevada",2992,2643,349,8184,32,41000
"Lemmon Valley CDP, Nevada",2874,2847,27,5221,32,41800
"Logan Creek CDP, Nevada",0,0,0,28,32,42350
"Lovelock city, Nevada",681,584,97,1675,32,43000
"Lund CDP, Nevada",12,12,0,133,32,43400
"McDermitt CDP, Nevada",59,59,0,78,32,44000
"McGill CDP, Nevada",375,349,26,879,32,44200
"Mesquite city, Nevada",6870,6351,519,20659,32,46000
"Mina CDP, Nevada",35,35,0,136,32,46800
"Minden CDP, Nevada",1491,1483,8,3140,32,47000
"Moapa Town CDP, Nevada",325,314,11,775,32,47840
"Moapa Valley CDP, Nevada",3102,2728,374,7144,32,47880
"Mogul CDP, Nevada",567,553,14,1315,32,48000
"Montello CDP, Nevada",0,0,0,22,32,48400
"Mountain City CDP, Nevada",0,0,0,12,32,49200
"Mount Charleston CDP, Nevada",185,185,0,474,32,49310
"Mount Wilson CDP, Nevada",0,0,0,0,32,49425
"Nellis AFB CDP, Nevada",896,695,201,4278,32,50400
"Nelson CDP, Nevada",11,11,0,17,32,50600
"Nixon CDP, Nevada",122,77,45,348,32,51200
"North Las Vegas city, Nevada",128906,118043,10863,264022,32,51800
"Oasis CDP, Nevada",0,0,0,0,32,52200
"Orovada CDP, Nevada",9,9,0,89,32,53000
"Osino CDP, Nevada",277,277,0,1051,32,53200
"Owyhee CDP, Nevada",416,393,23,1012,32,53600
"Pahrump CDP, Nevada",15353,13782,1571,44711,32,53800
"Panaca CDP, Nevada",343,343,0,1039,32,54200
"Paradise CDP, Nevada",103232,94013,9219,189733,32,54600
"Paradise Valley CDP, Nevada",58,58,0,141,32,55400
"Pioche CDP, Nevada",367,312,55,1111,32,57400
"Preston CDP, Nevada",38,38,0,203,32,58000
"Rachel CDP, Nevada",0,0,0,20,32,58820
"Reno city, Nevada",147378,140038,7340,265196,32,60600
"Round Hill Village CDP, Nevada",438,417,21,936,32,62170
"Ruhenstroth CDP, Nevada",779,776,3,1691,32,63450
"Ruth CDP, Nevada",83,60,23,189,32,63800
"Sandy Valley CDP, Nevada",700,625,75,1914,32,64600
"Schurz CDP, Nevada",366,308,58,896,32,65400
"Searchlight CDP, Nevada",67,67,0,278,32,65600
"Silver City CDP, Nevada",35,35,0,105,32,66800
"Silver Peak CDP, Nevada",156,151,5,213,32,67000
"Silver Springs CDP, Nevada",1921,1748,173,5117,32,67200
"Skyland CDP, Nevada",119,119,0,396,32,67600
"Smith Valley CDP, Nevada",575,569,6,1646,32,68050
"Spanish Springs CDP, Nevada",8945,8660,285,16418,32,68350
"Sparks city, Nevada",57992,54467,3525,108025,32,68400
"Spring Creek CDP, Nevada",7471,7191,280,15062,32,68550
"Spring Valley CDP, Nevada",123458,114059,9399,220114,32,68585
"Stagecoach CDP, Nevada",898,830,68,1904,32,68800
"Stateline CDP, Nevada",550,539,11,938,32,69200
"Summerlin South CDP, Nevada",14591,14111,480,29724,32,70900
"Sunrise Manor CDP, Nevada",91324,82987,8337,198325,32,71400
"Sun Valley CDP, Nevada",10962,10408,554,22775,32,71600
"Sutcliffe CDP, Nevada",112,105,7,291,32,71800
"Tonopah CDP, Nevada",763,740,23,1777,32,73600
"Topaz Lake CDP, Nevada",73,70,3,201,32,74200
"Topaz Ranch Estates CDP, Nevada",709,651,58,1695,32,74400
"Unionville CDP, Nevada",0,0,0,0,32,76400
"Ursine CDP, Nevada",0,0,0,0,32,77200
"Valmy CDP, Nevada",0,0,0,35,32,78200
"Verdi CDP, Nevada",562,542,20,1134,32,79400
"Virginia City CDP, Nevada",289,289,0,904,32,80000
"Wadsworth CDP, Nevada",379,337,42,716,32,81000
"Walker Lake CDP, Nevada",95,83,12,385,32,81100
"Washoe Valley CDP, Nevada",1568,1493,75,3235,32,82250
"Wells city, Nevada",551,549,2,1057,32,83000
"West Wendover city, Nevada",2489,2415,74,4513,32,83730
"Whitney CDP, Nevada",22903,21117,1786,44720,32,83800
"Winchester CDP, Nevada",18741,17167,1574,37531,32,84600
"Winnemucca city, Nevada",4267,4079,188,8354,32,84800
"Yerington city, Nevada",1117,1060,57,3108,32,85400
"Zephyr Cove CDP, Nevada",246,246,0,637,32,86200
"Alton CDP, New Hampshire",48,48,0,170,33,00980
"Amherst CDP, New Hampshire",333,333,0,682,33,01220
"Antrim CDP, New Hampshire",679,664,15,1320,33,01620
"Ashland CDP, New Hampshire",720,701,19,1520,33,01940
"Bartlett CDP, New Hampshire",61,61,0,259,33,03620
"Belmont CDP, New Hampshire",619,619,0,1252,33,04660
"Bennington CDP, New Hampshire",130,122,8,253,33,04820
"Berlin city, New Hampshire",4058,3849,209,9485,33,05140
"Bethlehem CDP, New Hampshire",512,503,9,957,33,05380
"Blodgett Landing CDP, New Hampshire",66,60,6,103,33,06020
"Bradford CDP, New Hampshire",239,235,4,387,33,06900
"Bristol CDP, New Hampshire",1047,1026,21,2095,33,07620
"Canaan CDP, New Hampshire",118,118,0,173,33,08900
"Center Ossipee CDP, New Hampshire",456,395,61,679,33,10820
"Center Sandwich CDP, New Hampshire",110,110,0,172,33,10900
"Charlestown CDP, New Hampshire",278,278,0,934,33,11300
"Claremont city, New Hampshire",5941,5809,132,13018,33,12900
"Colebrook CDP, New Hampshire",491,490,1,1100,33,13700
"Concord city, New Hampshire",23139,21923,1216,44049,33,14200
"Contoocook CDP, New Hampshire",817,799,18,1295,33,14340
"Conway CDP, New Hampshire",2089,1770,319,3847,33,14580
"Derry CDP, New Hampshire",12945,12250,695,23027,33,17860
"Dover city, New Hampshire",20090,19347,743,32849,33,18820
"Durham CDP, New Hampshire",5484,5272,212,10789,33,19620
"East Merrimack CDP, New Hampshire",2621,2621,0,4643,33,21780
"Enfield CDP, New Hampshire",977,977,0,2079,33,24260
"Epping CDP, New Hampshire",1435,1411,24,2754,33,24580
"Exeter CDP, New Hampshire",6512,6339,173,9918,33,25300
"Farmington CDP, New Hampshire",2094,2005,89,3722,33,25940
"Francestown CDP, New Hampshire",55,55,0,129,33,27060
"Franklin city, New Hampshire",4726,4564,162,8746,33,27380
"Goffstown CDP, New Hampshire",1952,1952,0,3028,33,29780
"Gorham CDP, New Hampshire",1072,1061,11,2043,33,30180
"Greenville CDP, New Hampshire",530,466,64,1061,33,31860
"Groveton CDP, New Hampshire",410,395,15,839,33,32260
"Hampton CDP, New Hampshire",5381,5261,120,10050,33,32980
"Hampton Beach CDP, New Hampshire",1601,1494,107,2650,33,33140
"Hancock CDP, New Hampshire",102,102,0,199,33,33620
"Hanover CDP, New Hampshire",3095,2955,140,8234,33,33780
"Henniker CDP, New Hampshire",1384,1384,0,2741,33,35460
"Hillsborough CDP, New Hampshire",778,778,0,1567,33,36020
"Hinsdale CDP, New Hampshire",794,780,14,1432,33,36580
"Hooksett CDP, New Hampshire",3044,2913,131,5268,33,37220
"Hudson CDP, New Hampshire",4378,4289,89,7003,33,37860
"Jaffrey CDP, New Hampshire",1666,1542,124,3036,33,38420
"Keene city, New Hampshire",12247,11923,324,22907,33,39300
"Klondike Corner CDP, New Hampshire",455,455,0,939,33,40120
"Laconia city, New Hampshire",9096,8814,282,16898,33,40180
"Lancaster CDP, New Hampshire",1134,1105,29,2260,33,40340
"Lebanon city, New Hampshire",8905,8847,58,14515,33,41300
"Lincoln CDP, New Hampshire",535,522,13,1017,33,41780
"Lisbon CDP, New Hampshire",446,410,36,872,33,41940
"Littleton CDP, New Hampshire",2353,2234,119,4587,33,42500
"Londonderry CDP, New Hampshire",7124,6789,335,12143,33,43140
"Loudon CDP, New Hampshire",241,241,0,654,33,43300
"Manchester city, New Hampshire",68658,65804,2854,115037,33,45140
"Marlborough CDP, New Hampshire",538,534,4,991,33,45380
"Melvin Village CDP, New Hampshire",48,48,0,108,33,46980
"Meredith CDP, New Hampshire",1252,1170,82,2758,33,47060
"Milford CDP, New Hampshire",4842,4606,236,8530,33,47940
"Milton CDP, New Hampshire",229,229,0,349,33,48580
"Milton Mills CDP, New Hampshire",31,31,0,121,33,48740
"Mountain Lakes CDP, New Hampshire",300,296,4,597,33,49600
"Nashua city, New Hampshire",54246,51482,2764,90943,33,50260
"New Boston CDP, New Hampshire",172,112,60,215,33,50660
"Newfields CDP, New Hampshire",174,171,3,291,33,51300
"New Hampton CDP, New Hampshire",151,151,0,324,33,51460
"New London CDP, New Hampshire",384,381,3,1340,33,52020
"Newmarket CDP, New Hampshire",3914,3875,39,5829,33,52260
"Newport CDP, New Hampshire",2688,2583,105,5228,33,52500
"North Conway CDP, New Hampshire",1272,1206,66,2079,33,53860
"North Haverhill CDP, New Hampshire",303,303,0,819,33,54740
"North Walpole CDP, New Hampshire",312,304,8,558,33,56420
"North Woodstock CDP, New Hampshire",290,282,8,532,33,57220
"Peterborough CDP, New Hampshire",1357,1317,40,2247,33,60500
"Pinardville CDP, New Hampshire",2868,2844,24,4851,33,61220
"Pittsfield CDP, New Hampshire",978,930,48,1784,33,61860
"Plainfield CDP, New Hampshire",103,103,0,179,33,62260
"Plymouth CDP, New Hampshire",2402,2244,158,4428,33,62580
"Portsmouth city, New Hampshire",13113,12785,328,22138,33,62900
"Raymond CDP, New Hampshire",2167,2026,141,4006,33,63940
"Rochester city, New Hampshire",17702,17032,670,32573,33,65140
"Sanbornville CDP, New Hampshire",525,525,0,919,33,67460
"Seabrook Beach CDP, New Hampshire",443,406,37,864,33,68340
"Somersworth city, New Hampshire",7189,6987,202,11994,33,69940
"South Hooksett CDP, New Hampshire",3452,3316,136,5808,33,71220
"Suissevale CDP, New Hampshire",200,200,0,406,33,74780
"Suncook CDP, New Hampshire",3087,3056,31,5235,33,75140
"Tilton Northfield CDP, New Hampshire",1620,1591,29,3035,33,77100
"Troy CDP, New Hampshire",533,523,10,920,33,77300
"Union CDP, New Hampshire",313,313,0,384,33,77780
"Walpole CDP, New Hampshire",189,189,0,465,33,78340
"Warner CDP, New Hampshire",170,170,0,425,33,78500
"West Stewartstown CDP, New Hampshire",194,177,17,465,33,83620
"West Swanzey CDP, New Hampshire",534,505,29,1200,33,83700
"Whitefield CDP, New Hampshire",701,665,36,1332,33,84340
"Wilton CDP, New Hampshire",811,769,42,1333,33,85140
"Winchester CDP, New Hampshire",638,600,38,1369,33,85460
"Wolfeboro CDP, New Hampshire",1004,1002,2,2813,33,86340
"Woodsville CDP, New Hampshire",638,620,18,1329,33,87140
"Absecon city, New Jersey",4314,3937,377,9086,34,00100
"Absecon Highlands CDP, New Jersey",827,677,150,1285,34,00160
"Allamuchy CDP, New Jersey",64,63,1,102,34,00640
"Allendale borough, New Jersey",3090,2980,110,6817,34,00700
"Allenhurst borough, New Jersey",257,229,28,412,34,00730
"Allentown borough, New Jersey",1055,1005,50,1817,34,00760
"Allenwood CDP, New Jersey",412,386,26,623,34,00790
"Alloway CDP, New Jersey",807,737,70,1428,34,00850
"Alpha borough, New Jersey",1231,1187,44,2223,34,01030
"Alpine borough, New Jersey",637,580,57,1449,34,01090
"Ampere North CDP, New Jersey",2936,2688,248,5164,34,01184
"Anderson CDP, New Jersey",336,317,19,664,34,01300
"Andover borough, New Jersey",463,443,20,747,34,01330
"Annandale CDP, New Jersey",1039,914,125,1853,34,01480
"Arrowhead Lake CDP, New Jersey",57,57,0,103,34,01825
"Asbury CDP, New Jersey",110,95,15,203,34,01900
"Asbury Park city, New Jersey",9508,8716,792,15245,34,01960
"Ashland CDP, New Jersey",5160,4908,252,9383,34,01990
"Atco CDP, New Jersey",4613,4254,359,8049,34,02020
"Atlantic City city, New Jersey",17779,15456,2323,38487,34,02080
"Atlantic Highlands borough, New Jersey",2414,2264,150,4409,34,02110
"Auburn CDP, New Jersey",603,587,16,1064,34,02170
"Audubon borough, New Jersey",4974,4723,251,8695,34,02200
"Audubon Park borough, New Jersey",594,534,60,1031,34,02230
"Avalon borough, New Jersey",545,529,16,1459,34,02320
"Avenel CDP, New Jersey",7407,6915,492,17211,34,02350
"Avon-by-the-Sea borough, New Jersey",957,903,54,1792,34,02440
"Barclay CDP, New Jersey",2370,2289,81,4504,34,02880
"Bargaintown CDP, New Jersey",2904,2536,368,5234,34,02920
"Barnegat CDP, New Jersey",1792,1706,86,3284,34,03040
"Barnegat Light borough, New Jersey",127,105,22,435,34,03130
"Barrington borough, New Jersey",4410,4108,302,7022,34,03250
"Basking Ridge CDP, New Jersey",3745,3484,261,7905,34,03340
"Bay Head borough, New Jersey",590,574,16,1096,34,03520
"Bayonne city, New Jersey",36447,34262,2185,70497,34,03580
"Beach Haven borough, New Jersey",507,484,23,1061,34,03940
"Beach Haven West CDP, New Jersey",2778,2707,71,4920,34,04120
"Beachwood borough, New Jersey",6400,6130,270,10933,34,04180
"Beattystown CDP, New Jersey",3178,3065,113,5040,34,04252
"Beckett CDP, New Jersey",3212,3072,140,5496,34,04400
"Bedminster CDP, New Jersey",693,662,31,1386,34,04420
"Beesleys Point CDP, New Jersey",807,807,0,1413,34,04540
"Belford CDP, New Jersey",949,864,85,1935,34,04600
"Belle Mead CDP, New Jersey",3167,3071,96,5867,34,04630
"Belleplain CDP, New Jersey",172,172,0,463,34,04660
"Bellmawr borough, New Jersey",5976,5650,326,11677,34,04750
"Belmar borough, New Jersey",3710,3459,251,5877,34,04930
"Belvidere town, New Jersey",1504,1376,128,2532,34,04990
"Bergenfield borough, New Jersey",15682,14746,936,28223,34,05170
"Berlin borough, New Jersey",4119,4043,76,7489,34,05440
"Bernardsville borough, New Jersey",4112,3884,228,7888,34,05590
"Beverly city, New Jersey",1233,1138,95,2502,34,05740
"Blackwells Mills CDP, New Jersey",5411,5132,279,10047,34,06025
"Blackwood CDP, New Jersey",2530,2364,166,4588,34,06040
"Blairstown CDP, New Jersey",186,172,14,267,34,06130
"Blawenburg CDP, New Jersey",112,99,13,112,34,06190
"Bloomingdale borough, New Jersey",4580,4383,197,7726,34,06340
"Bloomsbury borough, New Jersey",480,460,20,860,34,06370
"Bogota borough, New Jersey",5003,4677,326,8940,34,06490
"Boonton town, New Jersey",5045,4846,199,8781,34,06610
"Bordentown city, New Jersey",2366,2295,71,3989,34,06670
"Bound Brook borough, New Jersey",7092,6624,468,11906,34,06790
"Bradley Beach borough, New Jersey",2288,2211,77,4268,34,06970
"Bradley Gardens CDP, New Jersey",8345,8084,261,14345,34,07000
"Brainards CDP, New Jersey",128,118,10,166,34,07120
"Branchville borough, New Jersey",454,451,3,708,34,07300
"Brass Castle CDP, New Jersey",702,621,81,1471,34,07360
"Bridgeport CDP, New Jersey",114,114,0,216,34,07570
"Bridgeton city, New Jersey",9535,8959,576,26895,34,07600
"Bridgeville CDP, New Jersey",158,158,0,257,34,07660
"Bridgewater Center CDP, New Jersey",3005,2899,106,6106,34,07728
"Brielle borough, New Jersey",2605,2447,158,4957,34,07750
"Brigantine city, New Jersey",4186,3979,207,7784,34,07810
"Broadway CDP, New Jersey",22,22,0,37,34,08020
"Brookdale CDP, New Jersey",5675,5387,288,10312,34,08110
"Brookfield CDP, New Jersey",99,99,0,774,34,08140
"Brooklawn borough, New Jersey",912,843,69,1894,34,08170
"Brookside CDP, New Jersey",734,681,53,1302,34,08260
"Browns Mills CDP, New Jersey",4834,4386,448,10060,34,08455
"Brownville CDP, New Jersey",1550,1468,82,2183,34,08492
"Budd Lake CDP, New Jersey",5718,5393,325,9983,34,08620
"Buena borough, New Jersey",2512,2314,198,4504,34,08680
"Burleigh CDP, New Jersey",145,145,0,331,34,08890
"Burlington city, New Jersey",5185,4680,505,9833,34,08920
"Butler borough, New Jersey",5013,4786,227,8045,34,09040
"Buttzville CDP, New Jersey",52,52,0,103,34,09100
"Byram Center CDP, New Jersey",1355,1283,72,1969,34,09170
"Caldwell borough, New Jersey",5219,5010,209,8897,34,09250
"Califon borough, New Jersey",592,570,22,939,34,09280
"Camden city, New Jersey",30414,25964,4450,71799,34,10000
"Cape May city, New Jersey",931,887,44,2815,34,10270
"Cape May Court House CDP, New Jersey",2394,2229,165,5557,34,10300
"Cape May Point borough, New Jersey",50,46,4,155,34,10330
"Carlls Corner CDP, New Jersey",435,365,70,894,34,10450
"Carlstadt borough, New Jersey",3811,3627,184,6341,34,10480
"Carneys Point CDP, New Jersey",4447,4134,313,8136,34,10600
"Carteret borough, New Jersey",12706,11783,923,25161,34,10750
"Cedar Glen Lakes CDP, New Jersey",290,268,22,1461,34,11140
"Cedar Glen West CDP, New Jersey",898,855,43,1990,34,11155
"Cedar Knolls CDP, New Jersey",2516,2437,79,4181,34,11290
"Cedarville CDP, New Jersey",180,162,18,526,34,11410
"Centre Grove CDP, New Jersey",825,797,28,1460,34,11770
"Chatham borough, New Jersey",4751,4434,317,9199,34,12100
"Cherry Hill Mall CDP, New Jersey",7722,7263,459,13070,34,12385
"Chesilhurst borough, New Jersey",750,702,48,1384,34,12550
"Chester borough, New Jersey",819,795,24,1480,34,12580
"Clayton borough, New Jersey",4478,4111,367,8801,34,13360
"Clearbrook CDP, New Jersey",789,656,133,2604,34,13395
"Clementon borough, New Jersey",3006,2877,129,5312,34,13420
"Cliffside Park borough, New Jersey",13753,13258,495,25546,34,13570
"Cliffwood Beach CDP, New Jersey",1737,1648,89,3008,34,13630
"Clifton city, New Jersey",50362,47153,3209,89451,34,13690
"Clinton town, New Jersey",1619,1560,59,2775,34,13720
"Closter borough, New Jersey",4624,4448,176,8555,34,13810
"Clyde CDP, New Jersey",11,11,0,76,34,13990
"Collings Lakes CDP, New Jersey",1160,1100,60,2111,34,14230
"Collingswood borough, New Jersey",8618,7921,697,14135,34,14260
"Cologne CDP, New Jersey",643,592,51,1280,34,14350
"Colonia CDP, New Jersey",9832,9547,285,18581,34,14380
"Columbia CDP, New Jersey",89,89,0,209,34,14590
"Concordia CDP, New Jersey",893,792,101,2710,34,14758
"Connecticut Farms CDP, New Jersey",281,273,8,503,34,14815
"Cookstown CDP, New Jersey",385,366,19,609,34,14980
"Corbin City city, New Jersey",359,331,28,697,34,15160
"Country Lake Estates CDP, New Jersey",2393,2324,69,4179,34,15250
"Cranbury CDP, New Jersey",1513,1447,66,2430,34,15520
"Crandon Lakes CDP, New Jersey",558,526,32,1141,34,15610
"Cranford CDP, New Jersey",1055,1040,15,1728,34,15638
"Cream Ridge CDP, New Jersey",199,199,0,470,34,15730
"Cresskill borough, New Jersey",4597,4421,176,9105,34,15820
"Crestwood Village CDP, New Jersey",1933,1682,251,8479,34,15910
"Crosswicks CDP, New Jersey",614,614,0,944,34,16060
"Cumberland-Hesstown CDP, New Jersey",139,108,31,207,34,16278
"Dayton CDP, New Jersey",4616,4261,355,8361,34,16630
"Deal borough, New Jersey",287,272,15,645,34,16660
"Deans CDP, New Jersey",584,553,31,1049,34,16720
"Deerfield Street CDP, New Jersey",10,10,0,50,34,16960
"Delaware CDP, New Jersey",76,56,20,125,34,17200
"Delaware Park CDP, New Jersey",242,242,0,344,34,17260
"Delmont CDP, New Jersey",252,252,0,390,34,17410
"Demarest borough, New Jersey",2329,2217,112,4930,34,17530
"Dennisville CDP, New Jersey",545,535,10,824,34,17590
"Diamond Beach CDP, New Jersey",50,41,9,226,34,17815
"Dividing Creek CDP, New Jersey",165,159,6,524,34,17890
"Dorchester CDP, New Jersey",35,35,0,163,34,18010
"Dorothy CDP, New Jersey",473,383,90,1144,34,18040
"Dover town, New Jersey",10095,9467,628,18426,34,18070
"Dover Beaches North CDP, New Jersey",718,662,56,1696,34,18148
"Dover Beaches South CDP, New Jersey",667,637,30,1474,34,18151
"Dumont borough, New Jersey",10501,9966,535,18014,34,18400
"Dunellen borough, New Jersey",3806,3643,163,7598,34,18490
"Dutch Neck CDP, New Jersey",61,61,0,118,34,18632
"East Franklin CDP, New Jersey",4988,4785,203,9309,34,19130
"East Freehold CDP, New Jersey",3098,2913,185,5150,34,19150
"East Millstone CDP, New Jersey",358,358,0,541,34,19330
"East Newark borough, New Jersey",1504,1380,124,2718,34,19360
"East Orange city, New Jersey",36022,31838,4184,68879,34,19390
"East Rocky Hill CDP, New Jersey",299,277,22,411,34,19490
"East Rutherford borough, New Jersey",5900,5652,248,10020,34,19510
"East Vineland CDP, New Jersey",706,686,20,1346,34,19690
"Eatontown borough, New Jersey",7615,7032,583,13522,34,19840
"Echelon CDP, New Jersey",7520,7026,494,13553,34,19900
"Edgewater borough, New Jersey",9102,8726,376,14394,34,20020
"Egg Harbor City city, New Jersey",2190,1970,220,4376,34,20350
"Elizabeth city, New Jersey",69340,65283,4057,135665,34,21000
"Ellisburg CDP, New Jersey",2503,2240,263,5476,34,21120
"Elmer borough, New Jersey",732,702,30,1268,34,21240
"Elmwood Park borough, New Jersey",11518,10759,759,21261,34,21300
"Elwood CDP, New Jersey",465,413,52,919,34,21420
"Emerson borough, New Jersey",3964,3666,298,7281,34,21450
"Encore at Monroe CDP, New Jersey",43,43,0,550,34,21473
"Englewood city, New Jersey",16482,15155,1327,29109,34,21480
"Englewood Cliffs borough, New Jersey",2843,2649,194,5347,34,21510
"English Creek CDP, New Jersey",1001,963,38,2142,34,21540
"Englishtown borough, New Jersey",1167,1070,97,2129,34,21570
"Erma CDP, New Jersey",988,873,115,1844,34,21660
"Essex Fells borough, New Jersey",1044,1000,44,2290,34,21840
"Estell Manor city, New Jersey",885,852,33,1729,34,21870
"Fair Haven borough, New Jersey",3147,3033,114,6221,34,22440
"Fair Lawn borough, New Jersey",18565,17589,976,34948,34,22470
"Fairton CDP, New Jersey",505,444,61,929,34,22530
"Fairview borough, New Jersey",8517,7961,556,14935,34,22560
"Fairview CDP, New Jersey",2318,2163,155,4234,34,22740
"Fanwood borough, New Jersey",4307,4103,204,7723,34,22860
"Far Hills borough, New Jersey",586,531,55,1047,34,22890
"Farmingdale borough, New Jersey",738,656,82,1326,34,22950
"Fieldsboro borough, New Jersey",385,370,15,732,34,23250
"Finderne CDP, New Jersey",3258,3096,162,5881,34,23310
"Finesville CDP, New Jersey",163,139,24,331,34,23340
"Flagtown CDP, New Jersey",759,727,32,1147,34,23610
"Flanders CDP, New Jersey",5444,5200,244,9164,34,23640
"Flemington borough, New Jersey",2922,2812,110,4864,34,23700
"Florence CDP, New Jersey",3013,2832,181,4815,34,23820
"Florham Park borough, New Jersey",7013,6774,239,12790,34,23910
"Folsom borough, New Jersey",1036,954,82,1761,34,23940
"Fords CDP, New Jersey",6827,6489,338,12663,34,24030
"Forked River CDP, New Jersey",2463,2337,126,5003,34,24180
"Forsgate CDP, New Jersey",1117,1117,0,2300,34,24285
"Fort Dix CDP, New Jersey",499,464,35,7781,34,24300
"Fortescue CDP, New Jersey",31,31,0,87,34,24360
"Fort Lee borough, New Jersey",20851,19841,1010,39799,34,24420
"Franklin borough, New Jersey",2614,2429,185,4933,34,24930
"Franklin Center CDP, New Jersey",2791,2580,211,5583,34,24965
"Franklin Lakes borough, New Jersey",4845,4634,211,11007,34,24990
"Franklin Park CDP, New Jersey",8105,7573,532,13425,34,25020
"Franklinville CDP, New Jersey",826,762,64,1621,34,25050
"Freehold borough, New Jersey",6905,6339,566,12498,34,25200
"Frenchtown borough, New Jersey",839,808,31,1639,34,25350
"Gandys Beach CDP, New Jersey",24,24,0,30,34,25590
"Garfield city, New Jersey",17528,16705,823,32472,34,25770
"Garwood borough, New Jersey",2718,2556,162,4542,34,25800
"Germania CDP, New Jersey",282,275,7,933,34,26010
"Gibbsboro borough, New Jersey",994,908,86,2278,34,26070
"Gibbstown CDP, New Jersey",1893,1827,66,3471,34,26100
"Gillette CDP, New Jersey",1476,1402,74,2552,34,26220
"Glassboro borough, New Jersey",12265,11291,974,23014,34,26340
"Glendora CDP, New Jersey",3346,2888,458,5817,34,26520
"Glen Gardner borough, New Jersey",978,938,40,1610,34,26550
"Glen Ridge borough, New Jersey",4016,3769,247,7797,34,26610
"Glen Rock borough, New Jersey",5880,5546,334,12086,34,26640
"Gloucester City city, New Jersey",5602,5258,344,11435,34,26820
"Golden Triangle CDP, New Jersey",2729,2611,118,4960,34,26902
"Goshen CDP, New Jersey",206,199,7,267,34,27030
"Gouldtown CDP, New Jersey",873,759,114,1733,34,27060
"Great Meadows CDP, New Jersey",139,126,13,310,34,27360
"Great Notch CDP, New Jersey",2579,2349,230,4018,34,27390
"Green Knoll CDP, New Jersey",3497,3388,109,6635,34,27840
"Greentree CDP, New Jersey",5627,5269,358,11016,34,27995
"Green Village CDP, New Jersey",505,489,16,1242,34,28020
"Greenwich CDP (Cumberland County), New Jersey",69,62,7,167,34,28140
"Greenwich CDP (Warren County), New Jersey",1697,1574,123,2866,34,28250
"Grenloch CDP, New Jersey",407,387,20,648,34,28380
"Griggstown CDP, New Jersey",675,618,57,1102,34,28470
"Groveville CDP, New Jersey",1877,1653,224,3335,34,28620
"Guttenberg town, New Jersey",6764,6212,552,11765,34,28650
"Hackensack city, New Jersey",27370,25483,1887,45758,34,28680
"Hackettstown town, New Jersey",5683,5213,470,10111,34,28710
"Haddonfield borough, New Jersey",6226,6013,213,12456,34,28770
"Haddon Heights borough, New Jersey",4176,3985,191,7484,34,28800
"Hainesburg CDP, New Jersey",95,95,0,257,34,28920
"Haledon borough, New Jersey",4959,4672,287,8945,34,29070
"Hamburg borough, New Jersey",1972,1871,101,3274,34,29220
"Hamilton Square CDP, New Jersey",6315,6079,236,11894,34,29370
"Hammonton town, New Jersey",8132,7531,601,14732,34,29430
"Hampton borough, New Jersey",527,502,25,1064,34,29460
"Hancocks Bridge CDP, New Jersey",243,229,14,348,34,29520
"Harlingen CDP, New Jersey",295,285,10,429,34,29940
"Harmony CDP, New Jersey",161,161,0,329,34,30060
"Harrington Park borough, New Jersey",2415,2353,62,4826,34,30150
"Harrison town, New Jersey",11217,10658,559,19217,34,30210
"Harrisonville CDP, New Jersey",185,185,0,314,34,30270
"Harvey Cedars borough, New Jersey",199,190,9,479,34,30390
"Hasbrouck Heights borough, New Jersey",6948,6517,431,12080,34,30420
"Haworth borough, New Jersey",1645,1589,56,3342,34,30540
"Hawthorne borough, New Jersey",11777,11134,643,19456,34,30570
"Heathcote CDP, New Jersey",3296,3229,67,6773,34,30738
"Heislerville CDP, New Jersey",69,69,0,253,34,30810
"Helmetta borough, New Jersey",1411,1320,91,2302,34,30840
"Hewitt CDP, New Jersey",1559,1091,468,2540,34,31110
"Hibernia CDP, New Jersey",10,10,0,17,34,31170
"High Bridge borough, New Jersey",1970,1851,119,3564,34,31320
"Highland Lakes CDP, New Jersey",2642,2392,250,4089,34,31410
"Highland Park borough, New Jersey",9146,8587,559,14996,34,31470
"Highlands borough, New Jersey",2630,2463,167,4646,34,31500
"Hightstown borough, New Jersey",3660,3517,143,5864,34,31620
"Hillsborough CDP, New Jersey",13583,13067,516,21865,34,31880
"Hillsdale borough, New Jersey",5990,5819,171,10125,34,31920
"Hi-Nella borough, New Jersey",597,565,32,883,34,32220
"Hoboken city, New Jersey",40406,39002,1404,58754,34,32250
"Ho-Ho-Kus borough, New Jersey",2147,2103,44,4234,34,32310
"Holiday City-Berkeley CDP, New Jersey",3553,3257,296,12639,34,32415
"Holiday City South CDP, New Jersey",1463,1421,42,4412,34,32418
"Holiday Heights CDP, New Jersey",510,468,42,2049,34,32424
"Hopatcong borough, New Jersey",8855,8581,274,14411,34,32910
"Hope CDP, New Jersey",163,163,0,219,34,33030
"Hopelawn CDP, New Jersey",1643,1602,41,2910,34,33090
"Hopewell borough, New Jersey",1020,1001,19,1825,34,33150
"Hutchinson CDP, New Jersey",80,73,7,115,34,33690
"Interlaken borough, New Jersey",356,341,15,762,34,34200
"Iselin CDP, New Jersey",9936,9634,302,18511,34,34470
"Island Heights borough, New Jersey",810,784,26,1521,34,34530
"Jamesburg borough, New Jersey",3252,3096,156,5783,34,34890
"Jersey City city, New Jersey",163634,154210,9424,287899,34,36000
"Jobstown CDP, New Jersey",158,134,24,286,34,36120
"Johnsonburg CDP, New Jersey",241,203,38,470,34,36150
"Juliustown CDP, New Jersey",31,31,0,67,34,36300
"Keansburg borough, New Jersey",5020,4845,175,9761,34,36480
"Kean University CDP, New Jersey",666,647,19,1312,34,36484
"Kearny town, New Jersey",22725,21451,1274,41157,34,36510
"Keasbey CDP, New Jersey",1533,1491,42,2745,34,36570
"Kendall Park CDP, New Jersey",6147,5751,396,10624,34,36660
"Kenilworth borough, New Jersey",4499,4119,380,8345,34,36690
"Kenvil CDP, New Jersey",839,830,9,1636,34,36720
"Keyport borough, New Jersey",3904,3499,405,7188,34,36810
"Kingston CDP, New Jersey",647,589,58,1289,34,36930
"Kingston Estates CDP, New Jersey",3779,3637,142,6999,34,36960
"Kinnelon borough, New Jersey",5529,5037,492,9986,34,37110
"Lake Como borough, New Jersey",1183,1094,89,1710,34,37560
"Lake Hiawatha CDP, New Jersey",5845,5523,322,10064,34,37680
"Lake Hopatcong CDP, New Jersey",5783,5649,134,10480,34,37710
"Lakehurst borough, New Jersey",1404,1338,66,2653,34,37770
"Lake Mohawk CDP, New Jersey",5174,5074,100,9703,34,38040
"Lakeside-Beebe Run CDP, New Jersey",132,132,0,176,34,38296
"Lake Telemark CDP, New Jersey",812,792,20,1301,34,38430
"Lakewood CDP, New Jersey",19588,18331,1257,68555,34,38580
"Lambertville city, New Jersey",2710,2552,158,4127,34,38610
"Lamington CDP, New Jersey",43,43,0,209,34,38670
"Landing CDP, New Jersey",2703,2661,42,4801,34,38700
"Laurel Heights CDP, New Jersey",181,159,22,482,34,39045
"Laurel Lake CDP, New Jersey",1069,996,73,2346,34,39120
"Laurel Springs borough, New Jersey",1106,1056,50,2004,34,39210
"Laurence Harbor CDP, New Jersey",3697,3407,290,6418,34,39360
"Lavallette borough, New Jersey",867,857,10,2036,34,39390
"Lawnside borough, New Jersey",1547,1365,182,3059,34,39420
"Lawrenceville CDP, New Jersey",2113,1960,153,3759,34,39570
"Layton CDP, New Jersey",501,476,25,998,34,39600
"Lebanon borough, New Jersey",1129,1097,32,1864,34,39630
"Ledgewood CDP, New Jersey",3067,2540,527,5110,34,39750
"Leeds Point CDP, New Jersey",77,77,0,77,34,39810
"Leesburg CDP, New Jersey",181,174,7,320,34,39870
"Leisure Knoll CDP, New Jersey",820,784,36,2622,34,39883
"Leisuretowne CDP, New Jersey",726,667,59,3211,34,39885
"Leisure Village CDP, New Jersey",1982,1879,103,5866,34,39900
"Leisure Village East CDP, New Jersey",1122,929,193,4653,34,39910
"Leisure Village West CDP, New Jersey",1046,978,68,3817,34,39916
"Leonardo CDP, New Jersey",1341,1266,75,2336,34,39990
"Leonia borough, New Jersey",5063,4828,235,9273,34,40020
"Liberty Corner CDP, New Jersey",679,642,37,1759,34,40140
"Lincoln Park borough, New Jersey",6401,5712,689,10884,34,40290
"Lincroft CDP, New Jersey",3443,3146,297,6793,34,40320
"Linden city, New Jersey",24706,22750,1956,43478,34,40350
"Lindenwold borough, New Jersey",11485,11084,401,21337,34,40440
"Linwood city, New Jersey",3685,3485,200,6952,34,40530
"Little Ferry borough, New Jersey",6674,6123,551,10954,34,40680
"Little Silver borough, New Jersey",3339,3229,110,6104,34,40770
"Llewellyn Park CDP, New Jersey",410,410,0,681,34,40990
"Loch Arbour village, New Jersey",107,98,9,220,34,41010
"Lodi borough, New Jersey",14270,13356,914,25969,34,41100
"Long Branch city, New Jersey",16853,15661,1192,31932,34,41310
"Longport borough, New Jersey",301,275,26,776,34,41370
"Long Valley CDP, New Jersey",1007,962,45,2046,34,41400
"Lopatcong Overlook CDP, New Jersey",423,423,0,718,34,41495
"Lower Berkshire Valley CDP, New Jersey",298,298,0,471,34,41700
"Lyons CDP, New Jersey",2556,2451,105,5584,34,42180
"McGuire AFB CDP, New Jersey",1019,965,54,4886,34,42390
"McKee City CDP, New Jersey",5460,5028,432,9566,34,42420
"Macopin CDP, New Jersey",1204,1117,87,2363,34,42450
"Madison borough, New Jersey",9201,8569,632,16521,34,42510
"Madison Park CDP, New Jersey",4244,4031,213,8291,34,42540
"Magnolia borough, New Jersey",2623,2425,198,4342,34,42630
"Malaga CDP, New Jersey",803,748,55,1570,34,42840
"Manahawkin CDP, New Jersey",1233,1146,87,2197,34,42930
"Manasquan borough, New Jersey",3268,3122,146,5921,34,43050
"Mantoloking borough, New Jersey",204,197,7,417,34,43380
"Manville borough, New Jersey",6295,6059,236,10892,34,43620
"Margate City city, New Jersey",2579,2477,102,5331,34,43890
"Marksboro CDP, New Jersey",68,68,0,165,34,43980
"Marlboro CDP, New Jersey",36,31,5,75,34,44010
"Marlton CDP, New Jersey",5970,5754,216,10403,34,44100
"Marmora CDP, New Jersey",1060,1046,14,2153,34,44280
"Marshallville CDP, New Jersey",133,133,0,226,34,44345
"Martinsville CDP, New Jersey",6309,6129,180,12370,34,44430
"Matawan borough, New Jersey",5714,5471,243,9546,34,44520
"Mauricetown CDP, New Jersey",126,111,15,544,34,44670
"Mays Landing CDP, New Jersey",3112,2703,409,6183,34,44820
"Maywood borough, New Jersey",5569,5124,445,10040,34,44880
"Medford Lakes borough, New Jersey",2166,2092,74,4263,34,45210
"Mendham borough, New Jersey",2602,2522,80,4968,34,45330
"Menlo Park Terrace CDP, New Jersey",1657,1546,111,3117,34,45450
"Mercerville CDP, New Jersey",7188,6945,243,14364,34,45480
"Merchantville borough, New Jersey",2143,2089,54,3800,34,45510
"Metuchen borough, New Jersey",8155,7745,410,14958,34,45690
"Mickleton CDP, New Jersey",939,929,10,1943,34,45780
"Middlebush CDP, New Jersey",881,818,63,2302,34,45870
"Middlesex borough, New Jersey",8170,7710,460,14525,34,45900
"Midland Park borough, New Jersey",3911,3554,357,7022,34,46110
"Milford borough, New Jersey",696,645,51,1244,34,46260
"Millington CDP, New Jersey",1583,1415,168,2940,34,46470
"Millstone borough, New Jersey",374,357,17,584,34,46590
"Milltown borough, New Jersey",4161,3957,204,7017,34,46620
"Millville city, New Jersey",13904,12680,1224,27523,34,46680
"Milmay CDP, New Jersey",403,370,33,1042,34,46710
"Mizpah CDP, New Jersey",131,131,0,297,34,46980
"Money Island CDP, New Jersey",4,4,0,10,34,47006
"Monmouth Beach borough, New Jersey",1705,1633,72,3199,34,47130
"Monmouth Junction CDP, New Jersey",5695,5527,168,9750,34,47190
"Monroe Manor CDP, New Jersey",1370,1318,52,2549,34,47380
"Montclair State University CDP, New Jersey",1099,1068,31,1714,34,47524
"Montvale borough, New Jersey",4336,4210,126,8413,34,47610
"Moonachie borough, New Jersey",1651,1593,58,3093,34,47700
"Moorestown-Lenola CDP, New Jersey",7436,7136,300,14379,34,47895
"Morganville CDP, New Jersey",2723,2675,48,5153,34,48030
"Morris Plains borough, New Jersey",3607,3420,187,6104,34,48210
"Morristown town, New Jersey",13093,12473,620,20126,34,48300
"Mountain Lake CDP, New Jersey",407,401,6,543,34,48450
"Mountain Lakes borough, New Jersey",2148,2093,55,4499,34,48480
"Mountainside borough, New Jersey",3218,3108,110,6991,34,48510
"Mount Arlington borough, New Jersey",3437,3350,87,5863,34,48690
"Mount Ephraim borough, New Jersey",2623,2409,214,4638,34,48750
"Mount Hermon CDP, New Jersey",122,122,0,230,34,48840
"Mount Hope CDP, New Jersey",1317,1264,53,3092,34,48930
"Mount Royal CDP, New Jersey",309,251,58,1012,34,49200
"Mount Tabor CDP, New Jersey",539,527,12,1116,34,49290
"Mullica Hill CDP, New Jersey",2161,2055,106,4454,34,49440
"Mystic Island CDP, New Jersey",3435,3173,262,7635,34,49560
"National Park borough, New Jersey",1674,1554,120,3028,34,49680
"Navesink CDP, New Jersey",1064,945,119,1727,34,49740
"Neptune City borough, New Jersey",3052,2844,208,4619,34,49920
"Nesco CDP, New Jersey",225,225,0,461,34,50010
"Neshanic CDP, New Jersey",203,203,0,530,34,50040
"Neshanic Station CDP, New Jersey",3497,3248,249,5317,34,50100
"Netcong borough, New Jersey",2134,2090,44,3484,34,50130
"Newark city, New Jersey",149817,133755,16062,307355,34,51000
"New Brunswick city, New Jersey",27470,25683,1787,55718,34,51210
"New Egypt CDP, New Jersey",946,882,64,1552,34,51360
"Newfield borough, New Jersey",1008,990,18,1830,34,51390
"Newfoundland CDP, New Jersey",751,751,0,1256,34,51420
"New Gretna CDP, New Jersey",107,103,4,231,34,51450
"New Milford borough, New Jersey",9594,9005,589,16888,34,51660
"Newport CDP, New Jersey",231,210,21,529,34,51750
"New Providence borough, New Jersey",6641,6377,264,13595,34,51810
"Newton town, New Jersey",4505,4162,343,8370,34,51930
"Newtonville CDP, New Jersey",378,378,0,566,34,51990
"New Vernon CDP, New Jersey",266,266,0,869,34,52020
"New Village CDP, New Jersey",243,224,19,474,34,52050
"North Arlington borough, New Jersey",9449,8897,552,16352,34,52320
"North Beach Haven CDP, New Jersey",1089,972,117,2250,34,52410
"North Caldwell borough, New Jersey",3471,3270,201,6625,34,52620
"North Cape May CDP, New Jersey",1759,1672,87,3832,34,52650
"Northfield city, New Jersey",4505,4242,263,8432,34,52950
"North Haledon borough, New Jersey",4450,4166,284,8801,34,53040
"North Middletown CDP, New Jersey",1948,1909,39,3158,34,53205
"North Plainfield borough, New Jersey",13367,12082,1285,22695,34,53280
"Northvale borough, New Jersey",2395,2298,97,4769,34,53430
"North Wildwood city, New Jersey",1492,1447,45,3639,34,53490
"Norwood borough, New Jersey",2807,2737,70,5657,34,53610
"Oakhurst CDP, New Jersey",1862,1736,126,3912,34,53790
"Oakland borough, New Jersey",7278,6889,389,12734,34,53850
"Oaklyn borough, New Jersey",2332,2257,75,3937,34,53880
"Oak Ridge CDP, New Jersey",6254,5887,367,10997,34,53910
"Oak Valley CDP, New Jersey",2106,2025,81,4346,34,54060
"Ocean Acres CDP, New Jersey",10589,9958,631,18229,34,54315
"Ocean City city, New Jersey",5282,5131,151,11260,34,54360
"Ocean Gate borough, New Jersey",828,800,28,1682,34,54450
"Ocean Grove CDP, New Jersey",1767,1639,128,3129,34,54480
"Oceanport borough, New Jersey",3157,2919,238,6119,34,54570
"Ocean View CDP, New Jersey",405,403,2,898,34,54600
"Oceanville CDP, New Jersey",511,489,22,826,34,54630
"Ogdensburg borough, New Jersey",1392,1217,175,2215,34,54660
"Old Bridge CDP, New Jersey",15903,14809,1094,28094,34,54690
"Old Tappan borough, New Jersey",2905,2807,98,5863,34,54870
"Oldwick CDP, New Jersey",239,239,0,334,34,54900
"Olivet CDP, New Jersey",855,797,58,1535,34,54960
"Oradell borough, New Jersey",4359,4205,154,8208,34,54990
"Othello CDP, New Jersey",50,45,5,110,34,55320
"Oxford CDP, New Jersey",806,740,66,1249,34,55500
"Packanack Lake CDP, New Jersey",3144,3010,134,5982,34,55620
"Palermo CDP, New Jersey",1419,1397,22,2998,34,55710
"Palisades Park borough, New Jersey",11998,11304,694,20231,34,55770
"Palmyra borough, New Jersey",4605,4254,351,7437,34,55800
"Panther Valley CDP, New Jersey",2518,2309,209,4562,34,55895
"Paramus borough, New Jersey",13201,12194,1007,26582,34,55950
"Park Ridge borough, New Jersey",5176,5019,157,9098,34,56130
"Parsippany CDP, New Jersey",12518,11856,662,21806,34,56430
"Passaic city, New Jersey",33691,29704,3987,70048,34,56550
"Paterson city, New Jersey",75352,67470,7882,157864,34,57000
"Paulsboro borough, New Jersey",3156,2734,422,6195,34,57150
"Peapack and Gladstone borough, New Jersey",1237,1215,22,2561,34,57300
"Pedricktown CDP, New Jersey",157,132,25,367,34,57360
"Pemberton borough, New Jersey",711,670,41,1338,34,57480
"Pemberton Heights CDP, New Jersey",1485,1485,0,2776,34,57540
"Pennington borough, New Jersey",1514,1471,43,2780,34,57600
"Penns Grove borough, New Jersey",1573,1329,244,4841,34,57750
"Pennsville CDP, New Jersey",6178,5464,714,12256,34,57840
"Perth Amboy city, New Jersey",28708,25452,3256,55226,34,58200
"Phillipsburg town, New Jersey",8134,7449,685,15206,34,58350
"Pine Beach borough, New Jersey",1316,1274,42,2402,34,58590
"Pine Brook CDP, New Jersey",3408,3300,108,6147,34,58650
"Pine Hill borough, New Jersey",6109,5603,506,10698,34,58770
"Pine Lake Park CDP, New Jersey",4965,4789,176,9711,34,58830
"Pine Ridge at Crestwood CDP, New Jersey",909,819,90,2674,34,58852
"Pines Lake CDP, New Jersey",1598,1432,166,3034,34,58860
"Pitman borough, New Jersey",4924,4599,325,8805,34,59070
"Plainfield city, New Jersey",29564,26528,3036,54358,34,59190
"Plainsboro Center CDP, New Jersey",1766,1718,48,2766,34,59285
"Pleasantdale CDP, New Jersey",1294,1221,73,2462,34,59385
"Pleasant Plains CDP, New Jersey",314,279,35,525,34,59500
"Pleasantville city, New Jersey",10096,9154,942,20562,34,59640
"Pluckemin CDP, New Jersey",115,115,0,428,34,59730
"Point Pleasant borough, New Jersey",11416,11096,320,19024,34,59880
"Point Pleasant Beach borough, New Jersey",2728,2496,232,4786,34,59910
"Pomona CDP, New Jersey",3944,3852,92,8878,34,60030
"Pompton Lakes borough, New Jersey",6529,6278,251,11052,34,60090
"Pompton Plains CDP, New Jersey",5358,5046,312,10941,34,60120
"Port Colden CDP, New Jersey",69,69,0,225,34,60210
"Port Elizabeth CDP, New Jersey",78,78,0,292,34,60240
"Port Monmouth CDP, New Jersey",1920,1780,140,3173,34,60360
"Port Morris CDP, New Jersey",382,332,50,957,34,60390
"Port Murray CDP, New Jersey",0,0,0,0,34,60450
"Port Norris CDP, New Jersey",797,742,55,1711,34,60510
"Port Reading CDP, New Jersey",2372,2241,131,4040,34,60540
"Port Republic city, New Jersey",516,491,25,980,34,60600
"Pottersville CDP, New Jersey",262,262,0,388,34,60750
"Preakness CDP, New Jersey",9575,9218,357,18591,34,60810
"Presidential Lakes Estates CDP, New Jersey",1272,1112,160,2460,34,60840
"Princeton, New Jersey",15615,14868,747,30450,34,60900
"Princeton Junction CDP, New Jersey",1245,1148,97,2022,34,60960
"Princeton Meadows CDP, New Jersey",8813,8344,469,15585,34,60975
"Prospect Park borough, New Jersey",3163,2877,286,6299,34,61170
"Quinton CDP, New Jersey",263,263,0,464,34,61440
"Rahway city, New Jersey",16287,14934,1353,29664,34,61530
"Rainbow Lakes CDP, New Jersey",857,811,46,1187,34,61560
"Ramapo College of New Jersey CDP, New Jersey",1020,902,118,2243,34,61632
"Ramblewood CDP, New Jersey",3462,3262,200,6320,34,61650
"Ramsey borough, New Jersey",7496,7274,222,14739,34,61680
"Ramtown CDP, New Jersey",3481,3358,123,6506,34,61725
"Raritan borough, New Jersey",5514,5210,304,8301,34,61980
"Red Bank borough, New Jersey",7280,7048,232,12868,34,62430
"Regency at Monroe CDP, New Jersey",568,527,41,2140,34,62585
"Renaissance at Monroe CDP, New Jersey",146,146,0,691,34,62605
"Richland CDP, New Jersey",357,308,49,518,34,62790
"Richwood CDP, New Jersey",1919,1777,142,3656,34,62820
"Ridgefield borough, New Jersey",6573,6120,453,11465,34,62910
"Ridgefield Park village, New Jersey",7776,6973,803,13161,34,62940
"Ridgewood village, New Jersey",12915,12430,485,26043,34,63000
"Ringoes CDP, New Jersey",373,355,18,832,34,63120
"Ringwood borough, New Jersey",6853,6519,334,11692,34,63150
"Rio Grande CDP, New Jersey",1436,1143,293,3364,34,63180
"Riverdale borough, New Jersey",2289,2234,55,4081,34,63300
"River Edge borough, New Jersey",6666,6421,245,12022,34,63360
"Riverton borough, New Jersey",1593,1529,64,2764,34,63660
"Roadstown CDP, New Jersey",71,71,0,164,34,63810
"Robbinsville Center CDP, New Jersey",1811,1659,152,3235,34,63858
"Robertsville CDP, New Jersey",6627,6351,276,12646,34,63900
"Rockaway borough, New Jersey",4164,3784,380,6589,34,64050
"Rockleigh borough, New Jersey",121,120,1,567,34,64170
"Rocky Hill borough, New Jersey",420,400,20,794,34,64320
"Roebling CDP, New Jersey",2320,2239,81,4146,34,64350
"Roosevelt borough, New Jersey",476,459,17,1037,34,64410
"Roseland borough, New Jersey",3312,3133,179,6221,34,64590
"Roselle borough, New Jersey",13215,12160,1055,22500,34,64620
"Roselle Park borough, New Jersey",8581,8208,373,13964,34,64650
"Rosenhayn CDP, New Jersey",577,538,39,1508,34,64740
"Ross Corner CDP, New Jersey",38,38,0,66,34,64860
"Rossmoor CDP, New Jersey",629,567,62,2772,34,64865
"Rumson borough, New Jersey",3446,3266,180,7285,34,65130
"Runnemede borough, New Jersey",4568,4215,353,8307,34,65160
"Rutgers University-Busch Campus CDP, New Jersey",2684,2571,113,6663,34,65249
"Rutgers University-Livingston Campus CDP, New Jersey",1435,1390,45,2571,34,65260
"Rutherford borough, New Jersey",10575,10224,351,18754,34,65280
"Saddle River borough, New Jersey",1649,1490,159,3363,34,65400
"Salem city, New Jersey",2090,1828,262,5285,34,65490
"Sayreville borough, New Jersey",25469,24089,1380,45136,34,65790
"Sea Bright borough, New Jersey",989,939,50,1629,34,66240
"Seabrook Farms CDP, New Jersey",663,519,144,1447,34,66300
"Sea Girt borough, New Jersey",875,836,39,2031,34,66330
"Sea Isle City city, New Jersey",730,688,42,2047,34,66390
"Seaside Heights borough, New Jersey",806,760,46,2027,34,66450
"Seaside Park borough, New Jersey",855,805,50,1799,34,66480
"Seaville CDP, New Jersey",1406,1380,26,2532,34,66540
"Secaucus town, New Jersey",11946,11174,772,21470,34,66570
"Seeley CDP, New Jersey",0,0,0,80,34,66615
"Sewaren CDP, New Jersey",1577,1488,89,2695,34,66720
"Sewell CDP, New Jersey",2007,1978,29,3132,34,66750
"Shark River Hills CDP, New Jersey",1668,1622,46,3010,34,66840
"Sheppards Mill CDP, New Jersey",46,45,1,79,34,66970
"Shiloh borough, New Jersey",160,145,15,305,34,67020
"Ship Bottom borough, New Jersey",430,420,10,995,34,67110
"Short Hills CDP, New Jersey",6837,6510,327,14448,34,67320
"Shrewsbury borough, New Jersey",1840,1766,74,4138,34,67350
"Sicklerville CDP, New Jersey",25367,23313,2054,45853,34,67470
"Silver Lake CDP (Cumberland County), New Jersey",909,909,0,1433,34,67583
"Silver Lake CDP (Essex County), New Jersey",2039,1974,65,4407,34,67590
"Silver Lake CDP (Warren County), New Jersey",179,165,14,324,34,67650
"Silver Ridge CDP, New Jersey",279,279,0,1063,34,67665
"Singac CDP, New Jersey",2869,2763,106,4253,34,67770
"Six Mile Run CDP, New Jersey",2043,1996,47,3535,34,67820
"Skillman CDP, New Jersey",181,181,0,297,34,67860
"Smithville CDP, New Jersey",4767,4563,204,9135,34,68190
"Somerdale borough, New Jersey",3110,2845,265,5524,34,68340
"Somerset CDP, New Jersey",14128,13371,757,24246,34,68370
"Somers Point city, New Jersey",5830,5296,534,10482,34,68430
"Somerville borough, New Jersey",7621,7348,273,12467,34,68460
"South Amboy city, New Jersey",5613,5293,320,9336,34,68550
"South Bound Brook borough, New Jersey",3019,2799,220,4838,34,68730
"South Dennis CDP, New Jersey",758,731,27,1375,34,68850
"South Plainfield borough, New Jersey",13867,12873,994,24273,34,69390
"South River borough, New Jersey",8779,7873,906,16081,34,69420
"South Seaville CDP, New Jersey",485,387,98,736,34,69480
"South Toms River borough, New Jersey",1948,1790,158,3662,34,69510
"Spotswood borough, New Jersey",4509,4080,429,8136,34,69810
"Springdale CDP, New Jersey",7807,7277,530,15247,34,69900
"Springfield CDP, New Jersey",1055,997,58,1461,34,70018
"Spring Lake borough, New Jersey",1082,1054,28,2788,34,70110
"Spring Lake Heights borough, New Jersey",2807,2631,176,4864,34,70140
"Stanhope borough, New Jersey",2189,2118,71,3533,34,70380
"Stewartsville CDP, New Jersey",368,348,20,616,34,70800
"Stirling CDP, New Jersey",1584,1491,93,3138,34,70920
"Stockton borough, New Jersey",279,267,12,475,34,70980
"Stockton University CDP, New Jersey",1318,1219,99,2834,34,70984
"Stonebridge CDP, New Jersey",330,313,17,1847,34,70987
"Stone Harbor borough, New Jersey",361,348,13,887,34,71010
"Stratford borough, New Jersey",3905,3703,202,6962,34,71220
"Strathmere CDP, New Jersey",76,45,31,121,34,71250
"Strathmore CDP, New Jersey",4107,3892,215,6904,34,71280
"Succasunna CDP, New Jersey",5706,5456,250,9835,34,71370
"Summit city, New Jersey",12195,11497,698,22555,34,71430
"Sunset Lake CDP, New Jersey",549,517,32,849,34,71628
"Surf City borough, New Jersey",514,490,24,1325,34,71640
"Sussex borough, New Jersey",1073,1028,45,1918,34,71670
"Swedesboro borough, New Jersey",1548,1489,59,2706,34,71850
"Sweetwater CDP, New Jersey",309,309,0,649,34,71880
"Tavistock borough, New Jersey",10,10,0,12,34,72240
"Tenafly borough, New Jersey",7419,6879,540,15299,34,72420
"Ten Mile Run CDP, New Jersey",1320,1273,47,2241,34,72435
"Teterboro borough, New Jersey",40,38,2,91,34,72480
"The College of New Jersey CDP, New Jersey",1682,1408,274,4299,34,72580
"The Hills CDP, New Jersey",6501,6198,303,10937,34,72635
"The Ponds CDP, New Jersey",422,422,0,917,34,72726
"Thorofare CDP, New Jersey",1159,1129,30,2389,34,72810
"Three Bridges CDP, New Jersey",321,300,21,569,34,72870
"Tinton Falls borough, New Jersey",10126,9494,632,19180,34,73020
"Titusville CDP, New Jersey",385,385,0,671,34,73050
"Toms River CDP, New Jersey",48230,45484,2746,92827,34,73110
"Totowa borough, New Jersey",5840,5525,315,10975,34,73140
"Towaco CDP, New Jersey",2896,2798,98,5553,34,73170
"Trenton city, New Jersey",40452,36327,4125,90055,34,74000
"Troy Hills CDP, New Jersey",2687,2569,118,5206,34,74150
"Tuckahoe CDP, New Jersey",78,78,0,153,34,74180
"Tuckerton borough, New Jersey",1861,1700,161,3582,34,74210
"Turnersville CDP, New Jersey",1749,1678,71,2989,34,74270
"Twin Rivers CDP, New Jersey",4978,4898,80,8144,34,74330
"Union CDP, New Jersey",2102,1754,348,2974,34,74478
"Union Beach borough, New Jersey",3716,3584,132,5751,34,74540
"Union City city, New Jersey",36647,33787,2860,67258,34,74630
"Upper Greenwood Lake CDP, New Jersey",2199,2112,87,3418,34,74930
"Upper Montclair CDP, New Jersey",6510,6102,408,12441,34,75020
"Upper Pohatcong CDP, New Jersey",1012,971,41,1773,34,75120
"Upper Saddle River borough, New Jersey",4301,3969,332,8313,34,75140
"Upper Stewartsville CDP, New Jersey",168,153,15,344,34,75145
"Vauxhall CDP, New Jersey",2635,2487,148,5331,34,75590
"Ventnor City city, New Jersey",4815,4466,349,9285,34,75620
"Vernon Center CDP, New Jersey",1186,1165,21,1493,34,75745
"Vernon Valley CDP, New Jersey",713,688,25,1084,34,75750
"Victory Gardens borough, New Jersey",1057,970,87,1761,34,75890
"Victory Lakes CDP, New Jersey",762,681,81,1322,34,75920
"Vienna CDP, New Jersey",488,488,0,766,34,75950
"Villas CDP, New Jersey",4656,4315,341,9925,34,76010
"Vincentown CDP, New Jersey",261,251,10,389,34,76040
"Vineland city, New Jersey",28750,26376,2374,60796,34,76070
"Vista Center CDP, New Jersey",1164,1144,20,2457,34,76107
"Voorhees CDP, New Jersey",956,857,99,1798,34,76250
"Waldwick borough, New Jersey",5539,5416,123,10068,34,76400
"Wallington borough, New Jersey",6533,6039,494,11838,34,76490
"Wanamassa CDP, New Jersey",2553,2505,48,4344,34,76700
"Wanaque borough, New Jersey",6303,6038,265,11217,34,76730
"Waretown CDP, New Jersey",1098,998,100,2257,34,76820
"Washington borough, New Jersey",3829,3621,208,7240,34,77270
"Washington Crossing CDP, New Jersey",330,330,0,463,34,77330
"Watchung borough, New Jersey",3546,3306,240,6417,34,77600
"Watsessing CDP, New Jersey",5101,4734,367,7720,34,77750
"Wenonah borough, New Jersey",1218,1161,57,2213,34,78110
"West Belmar CDP, New Jersey",1314,1263,51,2279,34,78350
"West Berlin CDP, New Jersey",1636,1616,20,2568,34,78410
"West Cape May borough, New Jersey",435,424,11,927,34,78530
"Westfield town, New Jersey",15615,14991,624,30839,34,79040
"West Freehold CDP, New Jersey",7713,7432,281,14448,34,79100
"West Long Branch borough, New Jersey",4526,4187,339,8547,34,79310
"Westmont CDP, New Jersey",8313,7498,815,14138,34,79520
"West New York town, New Jersey",30047,27802,2245,52438,34,79610
"Weston CDP, New Jersey",657,626,31,2144,34,79715
"West Park CDP, New Jersey",752,727,25,1560,34,79810
"Westville borough, New Jersey",2385,2234,151,4276,34,80120
"West Wildwood borough, New Jersey",179,155,24,427,34,80210
"Westwood borough, New Jersey",6961,6781,180,11241,34,80270
"Wharton borough, New Jersey",4157,4001,156,7217,34,80390
"Whippany CDP, New Jersey",4954,4789,165,8888,34,80540
"White Horse CDP, New Jersey",5274,5117,157,9692,34,80630
"White House Station CDP, New Jersey",1859,1665,194,3788,34,80720
"White Meadow Lake CDP, New Jersey",5023,4905,118,9223,34,80750
"Whitesboro CDP, New Jersey",1123,1015,108,2497,34,80840
"Whittingham CDP, New Jersey",382,373,9,2423,34,81042
"Wildwood city, New Jersey",2514,2283,231,5164,34,81170
"Wildwood Crest borough, New Jersey",1409,1203,206,3104,34,81200
"William Paterson University of New Jersey CDP, New Jersey",740,647,93,1421,34,81365
"Williamstown CDP, New Jersey",7720,7277,443,14770,34,81380
"Windsor CDP, New Jersey",143,143,0,328,34,81620
"Woodbine borough, New Jersey",877,818,59,2264,34,81890
"Woodbridge CDP, New Jersey",11679,10927,752,20927,34,81950
"Woodbury city, New Jersey",5489,5051,438,9981,34,82120
"Woodbury Heights borough, New Jersey",1690,1671,19,3092,34,82180
"Woodcliff Lake borough, New Jersey",2973,2655,318,6096,34,82300
"Woodland Park borough, New Jersey",6961,6538,423,13291,34,82423
"Woodlynne borough, New Jersey",1454,1303,151,2904,34,82450
"Wood-Ridge borough, New Jersey",6239,5977,262,9978,34,82570
"Woodstown borough, New Jersey",1997,1928,69,3680,34,82720
"Wrightstown borough, New Jersey",218,210,8,467,34,82960
"Yardville CDP, New Jersey",3311,3192,119,6405,34,83170
"Yorketown CDP, New Jersey",3769,3632,137,7206,34,83245
"Zarephath CDP, New Jersey",44,44,0,74,34,83290
"Abeytas CDP, New Mexico",57,57,0,159,35,00240
"Abiquiu CDP, New Mexico",0,0,0,0,35,00310
"Acomita Lake CDP, New Mexico",372,372,0,728,35,00765
"Adelino CDP, New Mexico",392,392,0,790,35,00940
"Agua Fria CDP, New Mexico",1239,1229,10,2523,35,01220
"Alamillo CDP, New Mexico",70,70,0,173,35,01640
"Alamo CDP, New Mexico",377,292,85,1081,35,01710
"Alamogordo city, New Mexico",12331,11507,824,30996,35,01780
"Albuquerque city, New Mexico",292276,276323,15953,562551,35,02000
"Alcalde CDP, New Mexico",92,90,2,235,35,02070
"Algodones CDP, New Mexico",469,439,30,1063,35,02210
"Alma CDP, New Mexico",0,0,0,0,35,02560
"Angel Fire village, New Mexico",547,522,25,963,35,03400
"Angustura CDP, New Mexico",631,616,15,1884,35,03680
"Animas CDP, New Mexico",55,50,5,109,35,03750
"Anthony city, New Mexico",3328,2953,375,8708,35,03820
"Anton Chico CDP, New Mexico",34,15,19,188,35,03890
"Anzac Village CDP, New Mexico",38,38,0,38,35,03970
"Apache Creek CDP, New Mexico",0,0,0,12,35,04030
"Aragon CDP, New Mexico",24,24,0,142,35,04450
"Arenas Valley CDP, New Mexico",380,360,20,1060,35,04660
"Arrey CDP, New Mexico",0,0,0,0,35,04870
"Arroyo Hondo CDP (Santa Fe County), New Mexico",63,63,0,229,35,05002
"Arroyo Hondo CDP (Taos County), New Mexico",85,85,0,127,35,05010
"Arroyo Seco CDP, New Mexico",1073,849,224,1858,35,05150
"Artesia city, New Mexico",6067,5792,275,12632,35,05220
"Atoka CDP, New Mexico",387,377,10,1280,35,05430
"Aztec city, New Mexico",2638,2596,42,6214,35,05780
"Barton CDP, New Mexico",577,549,28,1538,35,06220
"Bayard city, New Mexico",602,556,46,2152,35,06270
"Becenti CDP, New Mexico",78,66,12,275,35,06340
"Beclabito CDP, New Mexico",110,92,18,238,35,06425
"Belen city, New Mexico",2888,2657,231,7367,35,06480
"Bent CDP, New Mexico",186,186,0,186,35,06760
"Berino CDP, New Mexico",475,428,47,1250,35,06830
"Bernalillo town, New Mexico",4197,3935,262,9286,35,06970
"Bibo CDP, New Mexico",0,0,0,0,35,07145
"Black Hat CDP, New Mexico",0,0,0,0,35,07492
"Black Rock CDP, New Mexico",517,458,59,1259,35,07670
"Blanco CDP, New Mexico",223,223,0,427,35,07810
"Bloomfield city, New Mexico",3122,3029,93,7430,35,07880
"Bluewater CDP, New Mexico",168,168,0,224,35,08180
"Bluewater Village CDP, New Mexico",0,0,0,25,35,08190
"Boles Acres CDP, New Mexico",864,858,6,2137,35,08440
"Borrego Pass CDP, New Mexico",28,18,10,107,35,08493
"Bosque Farms village, New Mexico",1844,1782,62,4001,35,08580
"Brazos CDP, New Mexico",0,0,0,0,35,08860
"Brimhall Nizhoni CDP, New Mexico",217,194,23,585,35,09035
"Broadview CDP, New Mexico",180,180,0,225,35,09202
"Buckhorn CDP, New Mexico",0,0,0,36,35,09630
"Butterfield Park CDP, New Mexico",256,176,80,596,35,09980
"Caballo CDP, New Mexico",0,0,0,72,35,10050
"Cañada de los Alamos CDP, New Mexico",289,280,9,631,35,10470
"Candy Kitchen CDP, New Mexico",10,10,0,72,35,10592
"Canjilon CDP, New Mexico",128,128,0,138,35,10610
"Cannon AFB CDP, New Mexico",531,448,83,2682,35,10750
"Cañon CDP, New Mexico",105,105,0,325,35,10770
"Cañoncito CDP, New Mexico",465,465,0,984,35,11256
"Cañones CDP, New Mexico",58,58,0,82,35,11310
"Canova CDP, New Mexico",296,296,0,589,35,11520
"Capitan village, New Mexico",555,539,16,1381,35,11800
"Capulin CDP, New Mexico",12,12,0,74,35,12010
"Carlsbad city, New Mexico",14772,14322,450,31755,35,12150
"Carnuel CDP, New Mexico",229,229,0,626,35,12430
"Carrizozo town, New Mexico",392,360,32,1035,35,12500
"Casa Colorada CDP, New Mexico",143,133,10,259,35,12786
"Casas Adobes CDP, New Mexico",63,63,0,146,35,12833
"Catalpa Canyon CDP, New Mexico",26,26,0,126,35,12844
"Causey village, New Mexico",59,59,0,203,35,12850
"Cedar Crest CDP, New Mexico",452,422,30,919,35,13200
"Cedar Grove CDP, New Mexico",300,263,37,886,35,13270
"Cedar Hill CDP, New Mexico",436,380,56,931,35,13340
"Cedro CDP, New Mexico",233,233,0,577,35,13450
"Center Point CDP, New Mexico",1247,1133,114,2576,35,13540
"Chama village, New Mexico",357,292,65,801,35,13970
"Chamberino CDP, New Mexico",317,302,15,720,35,14040
"Chamisal CDP, New Mexico",159,157,2,358,35,14110
"Chamita CDP, New Mexico",374,346,28,841,35,14180
"Chamizal CDP, New Mexico",0,0,0,50,35,14200
"Chaparral CDP, New Mexico",6217,5720,497,15290,35,14250
"Chical CDP, New Mexico",72,72,0,212,35,14670
"Chili CDP, New Mexico",121,121,0,220,35,14810
"Chilili CDP, New Mexico",0,0,0,17,35,14880
"Chimayo CDP, New Mexico",1376,1364,12,2955,35,14950
"Chupadero CDP, New Mexico",192,183,9,285,35,15300
"Church Rock CDP, New Mexico",477,442,35,1395,35,15370
"Cimarron village, New Mexico",343,314,29,816,35,15440
"City of the Sun CDP, New Mexico",0,0,0,42,35,15560
"Clayton town, New Mexico",880,803,77,2825,35,15720
"Cliff CDP, New Mexico",52,52,0,165,35,15860
"Cloudcroft village, New Mexico",257,257,0,862,35,16280
"Clovis city, New Mexico",16332,14961,1371,38453,35,16420
"Cobre CDP, New Mexico",0,0,0,32,35,16490
"Cochiti CDP, New Mexico",241,232,9,484,35,16560
"Cochiti Lake CDP, New Mexico",172,164,8,466,35,16585
"Columbus village, New Mexico",474,409,65,1281,35,17050
"Conchas Dam CDP, New Mexico",29,29,0,147,35,17260
"Conejo CDP, New Mexico",323,311,12,541,35,17295
"Continental Divide CDP, New Mexico",54,54,0,141,35,17330
"Cordova CDP, New Mexico",79,79,0,180,35,17610
"Corona village, New Mexico",27,27,0,90,35,17680
"Corrales village, New Mexico",4091,3903,188,8495,35,17960
"Costilla CDP, New Mexico",259,259,0,414,35,18240
"Cotton City CDP, New Mexico",186,186,0,402,35,18310
"Coyote CDP, New Mexico",0,0,0,32,35,18660
"Crestview CDP, New Mexico",126,126,0,193,35,18770
"Crouch Mesa CDP, New Mexico",1994,1900,94,4834,35,18905
"Crownpoint CDP, New Mexico",1140,994,146,2823,35,18940
"Cruzville CDP, New Mexico",63,63,0,279,35,19010
"Crystal CDP, New Mexico",104,100,4,285,35,19080
"Cuartelez CDP, New Mexico",179,179,0,433,35,19110
"Cuba village, New Mexico",236,216,20,547,35,19150
"Cubero CDP, New Mexico",0,0,0,75,35,19220
"Cundiyo CDP, New Mexico",0,0,0,0,35,19500
"Cuyamungue CDP, New Mexico",218,210,8,512,35,19640
"Cuyamungue Grant CDP, New Mexico",257,239,18,361,35,19645
"Datil CDP, New Mexico",13,13,0,13,35,19920
"Deer Canyon CDP, New Mexico",13,13,0,24,35,20015
"Deming city, New Mexico",5042,4664,378,14756,35,20270
"Des Moines village, New Mexico",24,24,0,103,35,20480
"Dexter town, New Mexico",447,404,43,1025,35,20620
"Dixon CDP, New Mexico",306,306,0,1049,35,20830
"Doña Ana CDP, New Mexico",536,536,0,1344,35,21110
"Dora village, New Mexico",35,35,0,63,35,21180
"Dulce CDP, New Mexico",1077,871,206,2261,35,21390
"Duran CDP, New Mexico",4,4,0,18,35,21810
"Eagle Nest village, New Mexico",93,71,22,249,35,22020
"East Pecos CDP, New Mexico",119,119,0,344,35,22230
"Edgewood town, New Mexico",2873,2683,190,6113,35,22380
"Edith Enclave CDP, New Mexico",99,99,0,228,35,22389
"El Cerro CDP, New Mexico",1345,1305,40,3244,35,22580
"El Cerro Mission CDP, New Mexico",2070,1740,330,4999,35,22582
"Eldorado at Santa Fe CDP, New Mexico",2647,2566,81,5471,35,22625
"El Duende CDP, New Mexico",285,285,0,1113,35,22650
"Elephant Butte city, New Mexico",445,433,12,1573,35,22720
"Elida town, New Mexico",107,105,2,225,35,23000
"El Morro Valley CDP, New Mexico",13,13,0,60,35,23497
"El Rancho CDP, New Mexico",692,687,5,1513,35,23840
"El Rito CDP, New Mexico",262,262,0,975,35,24120
"El Valle de Arroyo Seco CDP, New Mexico",816,767,49,1744,35,24347
"Encantado CDP, New Mexico",9,9,0,77,35,24453
"Encinal CDP, New Mexico",76,76,0,230,35,24540
"Encino village, New Mexico",25,25,0,35,35,24610
"Ensenada CDP, New Mexico",90,90,0,294,35,24960
"Escondida CDP, New Mexico",17,17,0,17,35,25100
"Escudilla Bonita CDP, New Mexico",0,0,0,61,35,25135
"Española city, New Mexico",4446,4209,237,10473,35,25170
"Estancia town, New Mexico",707,460,247,1591,35,25380
"Eunice city, New Mexico",1334,1228,106,3020,35,25450
"Fairacres CDP, New Mexico",357,271,86,937,35,25590
"Farmington city, New Mexico",19758,18230,1528,46457,35,25800
"Faywood CDP, New Mexico",35,35,0,35,35,25870
"Fence Lake CDP, New Mexico",0,0,0,115,35,26010
"Flora Vista CDP, New Mexico",934,934,0,2346,35,26360
"Floyd village, New Mexico",42,42,0,87,35,26570
"Folsom village, New Mexico",15,15,0,48,35,26780
"Fort Sumner village, New Mexico",538,484,54,1206,35,27340
"Fort Wingate CDP, New Mexico",154,154,0,378,35,27410
"Fruitland CDP, New Mexico",236,189,47,344,35,27760
"Galisteo CDP, New Mexico",75,65,10,177,35,27970
"Gallina CDP, New Mexico",72,46,26,270,35,28180
"Gallup city, New Mexico",8749,8410,339,21672,35,28460
"Gamerco CDP, New Mexico",309,309,0,1489,35,28530
"Garfield CDP, New Mexico",77,77,0,77,35,28670
"Gila CDP, New Mexico",25,25,0,189,35,29160
"Gila Hot Springs CDP, New Mexico",0,0,0,0,35,29230
"Glen Acres CDP, New Mexico",155,142,13,306,35,29540
"Glenwood CDP, New Mexico",20,20,0,54,35,29790
"Glorieta CDP, New Mexico",386,252,134,549,35,29860
"Golden CDP, New Mexico",0,0,0,21,35,30000
"Golden Acres CDP, New Mexico",98,98,0,149,35,30035
"Grady village, New Mexico",85,84,1,153,35,30210
"Grants city, New Mexico",3400,3248,152,9177,35,30490
"Grenville village, New Mexico",31,29,2,40,35,30770
"Hachita CDP, New Mexico",0,0,0,15,35,31190
"Hagerman town, New Mexico",335,330,5,730,35,31330
"Hanover CDP, New Mexico",51,51,0,260,35,31540
"Happy Valley CDP, New Mexico",252,194,58,629,35,31680
"Hatch village, New Mexico",845,675,170,1673,35,31820
"Haystack CDP, New Mexico",53,40,13,174,35,31925
"Hernandez CDP, New Mexico",295,261,34,902,35,32100
"Highland Meadows CDP, New Mexico",74,74,0,411,35,32148
"High Rolls CDP, New Mexico",457,457,0,1611,35,32160
"Hillsboro CDP, New Mexico",45,45,0,175,35,32380
"Hobbs city, New Mexico",18714,17337,1377,39782,35,32520
"Holloman AFB CDP, New Mexico",619,582,37,4182,35,32940
"Homer C Jones CDP, New Mexico",3,0,3,349,35,33122
"Homestead CDP, New Mexico",0,0,0,0,35,33130
"Hope village, New Mexico",39,28,11,105,35,33290
"Hot Springs Landing CDP, New Mexico",0,0,0,59,35,33640
"House village, New Mexico",9,9,0,57,35,33710
"Hurley town, New Mexico",675,635,40,1561,35,33850
"Hyde Park CDP, New Mexico",233,233,0,420,35,33920
"Indian Hills CDP, New Mexico",542,437,105,1197,35,34430
"Isleta CDP, New Mexico",350,328,22,745,35,34620
"Iyanbito CDP, New Mexico",418,368,50,1119,35,34830
"Jacona CDP, New Mexico",122,114,8,360,35,34900
"Jaconita CDP, New Mexico",214,211,3,413,35,34925
"Jal city, New Mexico",1047,901,146,2258,35,35040
"Jamestown CDP, New Mexico",28,28,0,229,35,35070
"Jarales CDP, New Mexico",559,495,64,1690,35,35110
"Jemez Pueblo CDP, New Mexico",901,868,33,2070,35,35250
"Jemez Springs village, New Mexico",192,170,22,352,35,35320
"Keeler Farm CDP, New Mexico",503,396,107,1716,35,35595
"Kingston CDP, New Mexico",0,0,0,93,35,36090
"Kirtland town, New Mexico",248,235,13,546,35,36230
"Kirtland AFB CDP, New Mexico",804,678,126,3837,35,36300
"La Bajada CDP, New Mexico",13,13,0,16,35,36555
"La Boca CDP, New Mexico",49,49,0,77,35,36567
"La Cienega CDP, New Mexico",2282,2146,136,3948,35,36720
"La Cueva CDP (Sandoval County), New Mexico",43,34,9,120,35,36880
"La Cueva CDP (Santa Fe County), New Mexico",481,481,0,694,35,36930
"Laguna CDP, New Mexico",212,183,29,655,35,37070
"La Hacienda CDP, New Mexico",133,133,0,656,35,37407
"La Huerta CDP, New Mexico",606,606,0,1274,35,37420
"La Jara CDP, New Mexico",74,65,9,361,35,37490
"La Joya CDP, New Mexico",63,63,0,143,35,37700
"Lake Arthur town, New Mexico",288,275,13,527,35,37840
"Lake Roberts CDP, New Mexico",0,0,0,49,35,37860
"Lake Roberts Heights CDP, New Mexico",0,0,0,23,35,37862
"Lake Sumner CDP, New Mexico",27,13,14,79,35,37875
"Lake Valley CDP, New Mexico",48,43,5,98,35,37910
"La Luz CDP, New Mexico",1343,798,545,1858,35,38330
"La Madera CDP (Rio Arriba County), New Mexico",0,0,0,214,35,38470
"La Madera CDP (Sandoval County), New Mexico",123,86,37,403,35,38540
"La Mesa CDP, New Mexico",165,165,0,650,35,38680
"La Mesilla CDP, New Mexico",1054,1026,28,2456,35,38820
"Lamy CDP, New Mexico",104,104,0,118,35,38890
"La Plata CDP, New Mexico",738,675,63,2063,35,39030
"La Puebla CDP, New Mexico",451,369,82,1036,35,39170
"Las Campanas CDP, New Mexico",523,495,28,1521,35,39332
"Las Cruces city, New Mexico",52473,48558,3915,111273,35,39380
"Las Maravillas CDP, New Mexico",1011,964,47,1796,35,39430
"Las Nutrias CDP, New Mexico",36,0,36,90,35,39450
"Las Palomas CDP, New Mexico",127,127,0,288,35,39520
"Las Tusas CDP, New Mexico",84,84,0,749,35,39792
"Las Vegas city, New Mexico",5614,5173,441,13194,35,39940
"La Tierra CDP, New Mexico",34,34,0,132,35,40074
"La Union CDP, New Mexico",475,447,28,869,35,40220
"La Villita CDP, New Mexico",805,805,0,1504,35,40360
"Lee Acres CDP, New Mexico",1738,1351,387,4858,35,40525
"Lemitar CDP, New Mexico",131,131,0,533,35,40570
"Lindrith CDP, New Mexico",122,107,15,140,35,41130
"Little Walnut Village CDP, New Mexico",712,712,0,1745,35,41340
"Livingston Wheeler CDP, New Mexico",309,280,29,1070,35,41420
"Llano del Medio CDP, New Mexico",0,0,0,0,35,41620
"Lobo Canyon CDP, New Mexico",25,25,0,357,35,41953
"Loco Hills CDP, New Mexico",72,72,0,72,35,41970
"Logan village, New Mexico",159,142,17,942,35,42040
"Lordsburg city, New Mexico",734,696,38,2114,35,42180
"Los Alamos CDP, New Mexico",7633,7493,140,13460,35,42320
"Los Cerrillos CDP, New Mexico",27,27,0,100,35,42600
"Los Chaves CDP, New Mexico",2188,2109,79,4840,35,42740
"Los Luceros CDP, New Mexico",431,429,2,731,35,43300
"Los Lunas village, New Mexico",6861,6498,363,17452,35,43370
"Los Ojos CDP, New Mexico",0,0,0,19,35,43510
"Los Ranchos de Albuquerque village, New Mexico",2397,2364,33,5894,35,43930
"Loving village, New Mexico",512,477,35,1413,35,44420
"Lovington city, New Mexico",4542,4162,380,11495,35,44490
"Lower Frisco CDP, New Mexico",0,0,0,0,35,44595
"Luis Lopez CDP, New Mexico",22,22,0,48,35,45190
"Lumberton CDP, New Mexico",67,9,58,81,35,45260
"Luna CDP, New Mexico",27,27,0,96,35,45330
"Lybrook CDP, New Mexico",184,184,0,340,35,45365
"Lyden CDP, New Mexico",52,52,0,95,35,45400
"McCartys Village CDP, New Mexico",142,142,0,574,35,45690
"McGaffey CDP, New Mexico",0,0,0,0,35,45890
"McIntosh CDP, New Mexico",219,171,48,502,35,46030
"Madrid CDP, New Mexico",76,76,0,287,35,46100
"Madrone CDP, New Mexico",64,58,6,174,35,46170
"Magdalena village, New Mexico",278,278,0,791,35,46310
"Malaga CDP, New Mexico",91,91,0,183,35,46380
"Manuelito CDP, New Mexico",16,14,2,41,35,46660
"Manzano CDP, New Mexico",0,0,0,0,35,46730
"Manzano Springs CDP, New Mexico",16,16,0,49,35,46770
"Maxwell village, New Mexico",119,119,0,482,35,47080
"Mayhill CDP, New Mexico",23,23,0,29,35,47150
"Meadow Lake CDP, New Mexico",1665,1492,173,4745,35,47220
"Medanales CDP, New Mexico",39,39,0,170,35,47360
"Melrose village, New Mexico",161,146,15,473,35,47570
"Mescalero CDP, New Mexico",447,396,51,891,35,47920
"Mesilla town, New Mexico",777,767,10,1647,35,48060
"Mesita CDP, New Mexico",499,471,28,1270,35,48200
"Mesquite CDP, New Mexico",523,523,0,597,35,48270
"Middle Frisco CDP, New Mexico",0,0,0,0,35,48425
"Middle Mesa CDP, New Mexico",94,89,5,244,35,48435
"Midway CDP, New Mexico",184,184,0,645,35,48480
"Milan village, New Mexico",876,724,152,2375,35,48620
"Mimbres CDP, New Mexico",218,218,0,586,35,48830
"Mogollon CDP, New Mexico",0,0,0,6,35,49180
"Monterey Park CDP, New Mexico",215,162,53,584,35,49515
"Monument CDP, New Mexico",62,62,0,129,35,49950
"Moquino CDP, New Mexico",0,0,0,0,35,50020
"Mora CDP, New Mexico",371,371,0,793,35,50090
"Moriarty city, New Mexico",940,765,175,2154,35,50160
"Morningside CDP, New Mexico",195,195,0,573,35,50195
"Mosquero village, New Mexico",1,1,0,24,35,50300
"Mountainair town, New Mexico",355,316,39,1071,35,50370
"Mountain View CDP (Cibola County), New Mexico",18,18,0,67,35,50512
"Mountain View CDP (Luna County), New Mexico",0,0,0,0,35,50515
"Mount Taylor CDP, New Mexico",64,64,0,199,35,50615
"Nadine CDP, New Mexico",163,163,0,265,35,50720
"Nageezi CDP, New Mexico",132,113,19,319,35,50790
"Nakaibito CDP, New Mexico",80,68,12,215,35,50860
"Nambe CDP, New Mexico",892,797,95,2165,35,50930
"Napi Headquarters CDP, New Mexico",289,275,14,628,35,51035
"Nara Visa CDP, New Mexico",46,41,5,146,35,51140
"Naschitti CDP, New Mexico",80,57,23,343,35,51280
"Navajo CDP, New Mexico",575,464,111,2071,35,51420
"Navajo Dam CDP, New Mexico",221,158,63,330,35,51490
"Nenahnezad CDP, New Mexico",183,160,23,438,35,51715
"Newcomb CDP, New Mexico",164,155,9,435,35,51770
"Newkirk CDP, New Mexico",0,0,0,0,35,51840
"Nogal CDP, New Mexico",71,71,0,103,35,52190
"North Acomita Village CDP, New Mexico",79,70,9,229,35,52300
"North Hobbs CDP, New Mexico",2653,2354,299,5863,35,52500
"North Hurley CDP, New Mexico",26,26,0,91,35,52540
"North Light Plant CDP, New Mexico",307,292,15,716,35,52560
"North San Ysidro CDP, New Mexico",125,125,0,214,35,52680
"North Valley CDP, New Mexico",5192,4951,241,11256,35,52750
"Oasis CDP, New Mexico",0,0,0,116,35,53010
"Ohkay Owingeh CDP, New Mexico",552,513,39,1173,35,53150
"Ojo Amarillo CDP, New Mexico",134,108,26,413,35,53485
"Ojo Caliente CDP, New Mexico",0,0,0,47,35,53590
"Ojo Encino CDP, New Mexico",101,55,46,445,35,53620
"Ojo Sarco CDP, New Mexico",72,72,0,281,35,53730
"Old Town CDP, New Mexico",0,0,0,0,35,54097
"Organ CDP, New Mexico",84,84,0,98,35,54430
"Orogrande CDP, New Mexico",0,0,0,0,35,54500
"Paa-Ko CDP, New Mexico",260,252,8,620,35,54675
"Paguate CDP, New Mexico",153,153,0,481,35,54710
"Pajarito Mesa CDP, New Mexico",118,58,60,225,35,54940
"Paradise Hills CDP, New Mexico",2102,2008,94,4441,35,55270
"Paraje CDP, New Mexico",456,456,0,1362,35,55340
"Pastura CDP, New Mexico",0,0,0,3,35,55550
"Peak Place CDP, New Mexico",217,199,18,473,35,55595
"Pecan Park CDP, New Mexico",271,271,0,471,35,55605
"Pecos village, New Mexico",378,367,11,885,35,55620
"Peña Blanca CDP, New Mexico",395,373,22,688,35,55830
"Peñasco CDP, New Mexico",266,251,15,708,35,55900
"Peralta town, New Mexico",1575,1397,178,3379,35,56180
"Picacho Hills CDP, New Mexico",722,710,12,1822,35,56748
"Picuris Pueblo CDP, New Mexico",31,31,0,75,35,56810
"Pie Town CDP, New Mexico",57,57,0,178,35,56950
"Pinedale CDP, New Mexico",226,163,63,755,35,57160
"Pinehaven CDP, New Mexico",0,0,0,7,35,57175
"Pinehill CDP, New Mexico",147,123,24,391,35,57190
"Pinon CDP, New Mexico",0,0,0,0,35,57440
"Pinos Altos CDP, New Mexico",29,18,11,185,35,57510
"Placitas CDP (Doña Ana County), New Mexico",218,172,46,515,35,57990
"Placitas CDP (Sandoval County), New Mexico",1821,1766,55,4066,35,58070
"Playas CDP, New Mexico",0,0,0,48,35,58210
"Pleasanton CDP, New Mexico",111,111,0,248,35,58420
"Pojoaque CDP, New Mexico",1273,1214,59,2336,35,58630
"Polvadera CDP, New Mexico",99,89,10,573,35,58910
"Ponderosa CDP, New Mexico",67,67,0,160,35,58980
"Ponderosa Pine CDP, New Mexico",437,387,50,1246,35,59120
"Portales city, New Mexico",5778,5230,548,12085,35,59260
"Prewitt CDP, New Mexico",162,120,42,689,35,59540
"Pueblito CDP, New Mexico",27,27,0,57,35,59750
"Pueblitos CDP, New Mexico",270,222,48,422,35,59820
"Pueblo CDP, New Mexico",0,0,0,0,35,59840
"Pueblo of Sandia Village CDP, New Mexico",192,189,3,515,35,59950
"Pueblo Pintado CDP, New Mexico",63,51,12,217,35,60000
"Puerto de Luna CDP, New Mexico",224,224,0,391,35,60170
"Pulpotio Bareas CDP, New Mexico",15,15,0,93,35,60205
"Punta de Agua CDP, New Mexico",13,13,0,46,35,60310
"Purty Rock CDP, New Mexico",2,2,0,2,35,60327
"Quemado CDP, New Mexico",133,133,0,250,35,60730
"Questa village, New Mexico",997,991,6,2179,35,60870
"Radium Springs CDP, New Mexico",647,557,90,1657,35,61010
"Ramah CDP, New Mexico",273,273,0,391,35,61220
"Rancho Grande CDP, New Mexico",0,0,0,33,35,61675
"Ranchos de Taos CDP, New Mexico",612,612,0,2313,35,61710
"Raton city, New Mexico",2692,2670,22,6046,35,62060
"Red River town, New Mexico",260,260,0,512,35,62200
"Redrock CDP, New Mexico",12,12,0,18,35,62270
"Red Rock Ranch CDP, New Mexico",0,0,0,0,35,62295
"Regina CDP, New Mexico",30,20,10,71,35,62340
"Reserve village, New Mexico",71,54,17,369,35,62620
"Ribera CDP, New Mexico",164,126,38,330,35,62760
"Rincon CDP, New Mexico",109,109,0,267,35,62900
"Rio Chiquito CDP, New Mexico",90,90,0,211,35,63110
"Rio Communities city, New Mexico",1940,1658,282,4913,35,63145
"Rio en Medio CDP, New Mexico",67,67,0,190,35,63168
"Rio Lucio CDP, New Mexico",229,212,17,621,35,63250
"Rio Rancho city, New Mexico",51146,48339,2807,104351,35,63460
"Rio Rancho Estates CDP, New Mexico",897,884,13,1473,35,63530
"Rivers CDP, New Mexico",0,0,0,35,35,63660
"Rock Springs CDP, New Mexico",499,480,19,999,35,64230
"Rodeo CDP, New Mexico",0,0,0,50,35,64370
"Rodey CDP, New Mexico",130,130,0,390,35,64440
"Rosedale CDP, New Mexico",30,18,12,302,35,64900
"Roswell city, New Mexico",20732,19604,1128,48035,35,64930
"Rowe CDP, New Mexico",274,274,0,582,35,65000
"Roy village, New Mexico",169,147,22,278,35,65070
"Ruidoso village, New Mexico",3728,3528,200,7696,35,65210
"Ruidoso Downs city, New Mexico",1048,1027,21,2635,35,65280
"Sacramento CDP, New Mexico",0,0,0,0,35,65560
"Sagar CDP, New Mexico",130,104,26,316,35,65595
"Salem CDP, New Mexico",441,348,93,844,35,65840
"San Acacia CDP, New Mexico",35,35,0,35,35,65910
"San Antonio CDP, New Mexico",0,0,0,70,35,66120
"San Antonito CDP (Bernalillo County), New Mexico",328,308,20,772,35,66330
"San Antonito CDP (Socorro County), New Mexico",0,0,0,0,35,66400
"San Cristobal CDP, New Mexico",84,84,0,84,35,66540
"Sandia Heights CDP, New Mexico",1185,1165,20,3205,35,66765
"Sandia Knolls CDP, New Mexico",789,764,25,1410,35,66890
"Sandia Park CDP, New Mexico",231,231,0,411,35,66960
"San Felipe Pueblo CDP, New Mexico",613,466,147,1430,35,67450
"San Fidel CDP, New Mexico",0,0,0,4,35,67520
"San Ildefonso Pueblo CDP, New Mexico",392,365,27,722,35,68010
"San Jon village, New Mexico",92,92,0,188,35,68150
"San Jose CDP (Rio Arriba County), New Mexico",353,327,26,845,35,68430
"San Jose CDP (San Miguel County), New Mexico",21,21,0,109,35,68500
"San Lorenzo CDP, New Mexico",40,40,0,260,35,68920
"San Luis CDP, New Mexico",0,0,0,165,35,69060
"San Mateo CDP, New Mexico",12,12,0,21,35,69270
"San Miguel CDP, New Mexico",284,284,0,594,35,69410
"Sanostee CDP, New Mexico",65,59,6,276,35,69620
"San Pablo CDP, New Mexico",224,219,5,449,35,69645
"San Pedro CDP, New Mexico",52,52,0,232,35,69825
"San Rafael CDP, New Mexico",551,518,33,2322,35,69875
"Santa Ana Pueblo CDP, New Mexico",502,478,24,1006,35,70250
"Santa Clara village, New Mexico",550,519,31,1744,35,70270
"Santa Clara Pueblo CDP, New Mexico",298,294,4,957,35,70390
"Santa Cruz CDP, New Mexico",100,91,9,219,35,70460
"Santa Fe city, New Mexico",45266,42877,2389,87617,35,70500
"Santa Fe Foothills CDP, New Mexico",324,324,0,747,35,70505
"Santa Rosa city, New Mexico",933,859,74,2741,35,70670
"Santa Teresa CDP, New Mexico",2745,2687,58,6396,35,70700
"Santo Domingo Pueblo CDP, New Mexico",868,798,70,2021,35,70810
"San Ysidro CDP, New Mexico",1328,1198,130,2205,35,71015
"San Ysidro village, New Mexico",96,91,5,219,35,71020
"Sausal CDP, New Mexico",236,190,46,497,35,71145
"Seama CDP, New Mexico",149,130,19,392,35,71440
"Seboyeta CDP, New Mexico",272,223,49,516,35,71510
"Sedillo CDP, New Mexico",261,261,0,656,35,71700
"Sena CDP, New Mexico",88,88,0,158,35,71790
"Seton Village CDP, New Mexico",5,5,0,29,35,72140
"Sheep Springs CDP, New Mexico",124,101,23,362,35,72600
"Shiprock CDP, New Mexico",3570,3017,553,8275,35,72770
"Silver City town, New Mexico",4110,3702,408,9650,35,73260
"Skyline-Ganipa CDP, New Mexico",475,450,25,1132,35,73440
"Socorro city, New Mexico",3293,3195,98,8605,35,73540
"Soham CDP, New Mexico",93,93,0,242,35,73680
"Sombrillo CDP, New Mexico",40,40,0,120,35,73890
"South Acomita Village CDP, New Mexico",18,18,0,125,35,73925
"South River CDP, New Mexico",712,683,29,1584,35,74275
"South Valley CDP, New Mexico",16171,15243,928,37601,35,74520
"Spencerville CDP, New Mexico",499,484,15,1174,35,74660
"Springer town, New Mexico",392,380,12,927,35,74800
"Stanley CDP, New Mexico",26,26,0,44,35,75010
"Stoneridge CDP, New Mexico",2,2,0,2,35,75465
"Sundance CDP, New Mexico",223,216,7,526,35,75605
"Sunland Park city, New Mexico",7396,7265,131,16773,35,75640
"Sunlit Hills CDP, New Mexico",180,180,0,785,35,75650
"Sunshine CDP, New Mexico",239,239,0,734,35,75710
"Tajique CDP, New Mexico",69,69,0,180,35,76060
"Talpa CDP, New Mexico",646,646,0,1559,35,76130
"Tano Road CDP, New Mexico",486,465,21,1506,35,76165
"Taos town, New Mexico",3135,2855,280,6458,35,76200
"Taos Pueblo CDP, New Mexico",624,536,88,1422,35,76410
"Taos Ski Valley village, New Mexico",50,45,5,64,35,76480
"Tatum town, New Mexico",389,389,0,794,35,76620
"Tecolote CDP, New Mexico",24,24,0,24,35,76760
"Tecolotito CDP, New Mexico",173,145,28,496,35,76830
"Tesuque CDP, New Mexico",355,326,29,1123,35,77040
"Tesuque Pueblo CDP, New Mexico",213,167,46,481,35,77100
"Texico city, New Mexico",447,435,12,873,35,77250
"Thoreau CDP, New Mexico",831,680,151,2361,35,77530
"Thunder Mountain CDP, New Mexico",592,592,0,1462,35,77635
"Tierra Amarilla CDP, New Mexico",173,117,56,405,35,77670
"Tijeras village, New Mexico",237,221,16,539,35,77880
"Timberlake CDP, New Mexico",32,32,0,341,35,77930
"Timberon CDP, New Mexico",116,54,62,116,35,77950
"Tohatchi CDP, New Mexico",256,223,33,684,35,78440
"Tome CDP, New Mexico",545,534,11,1013,35,78650
"Torreon CDP (Sandoval County), New Mexico",172,154,18,489,35,79070
"Torreon CDP (Torrance County), New Mexico",102,102,0,232,35,79140
"Tortugas CDP, New Mexico",270,270,0,708,35,79210
"Totah Vista CDP, New Mexico",168,146,22,456,35,79264
"Tres Arroyos CDP, New Mexico",988,968,20,1980,35,79500
"Trout Valley CDP, New Mexico",0,0,0,18,35,79680
"Truchas CDP, New Mexico",74,74,0,320,35,79700
"Truth or Consequences city, New Mexico",2170,2106,64,6030,35,79840
"Tse Bonito CDP, New Mexico",38,35,3,140,35,79885
"Tucumcari city, New Mexico",2470,2361,109,5206,35,79910
"Tularosa village, New Mexico",855,673,182,2590,35,79980
"Turley CDP, New Mexico",188,188,0,354,35,80120
"Twin Forks CDP, New Mexico",25,25,0,237,35,80470
"Twin Lakes CDP, New Mexico",336,300,36,959,35,80540
"Tyrone CDP, New Mexico",278,257,21,716,35,80820
"University Park CDP, New Mexico",1358,1058,300,2744,35,81030
"Upper Fruitland CDP, New Mexico",545,489,56,1533,35,81177
"Ute Park CDP, New Mexico",48,48,0,104,35,81450
"Vadito CDP, New Mexico",150,148,2,362,35,81520
"Vado CDP, New Mexico",1333,1246,87,3386,35,81590
"Valencia CDP (Santa Fe County), New Mexico",67,39,28,86,35,81775
"Valencia CDP (Valencia County), New Mexico",993,911,82,2012,35,81800
"Valle Vista CDP, New Mexico",420,400,20,796,35,82332
"Vanderwagen CDP, New Mexico",25,25,0,57,35,82430
"Vaughn town, New Mexico",296,296,0,496,35,82570
"Veguita CDP, New Mexico",0,0,0,31,35,82640
"Velarde CDP, New Mexico",172,172,0,287,35,82710
"Ventura CDP, New Mexico",143,143,0,808,35,82800
"Villanueva CDP, New Mexico",175,175,0,433,35,83130
"Virden village, New Mexico",93,81,12,192,35,83200
"Wagon Mound village, New Mexico",179,166,13,491,35,83340
"Waterflow CDP, New Mexico",570,522,48,1325,35,83760
"Watrous CDP, New Mexico",30,30,0,59,35,83830
"Weed CDP, New Mexico",44,44,0,88,35,83970
"West Hammond CDP, New Mexico",975,891,84,2410,35,84200
"White Cliffs CDP, New Mexico",354,354,0,610,35,84505
"White Rock CDP, New Mexico",2662,2602,60,5592,35,84740
"White Sands CDP, New Mexico",332,332,0,1449,35,84845
"Whites City CDP, New Mexico",0,0,0,0,35,84950
"White Signal CDP, New Mexico",85,85,0,172,35,84975
"Willard village, New Mexico",150,125,25,360,35,85160
"Williams Acres CDP, New Mexico",215,195,20,682,35,85230
"Williamsburg village, New Mexico",388,357,31,800,35,85300
"Windmill CDP, New Mexico",23,23,0,60,35,85485
"Winston CDP, New Mexico",0,0,0,32,35,85720
"Yah-ta-hey CDP, New Mexico",210,195,15,709,35,85860
"Youngsville CDP, New Mexico",0,0,0,52,35,86210
"Zia Pueblo CDP, New Mexico",441,397,44,899,35,86420
"Zuni Pueblo CDP, New Mexico",2508,2152,356,6789,35,86595
"Accord CDP, New York",246,225,21,350,36,00155
"Adams village, New York",842,823,19,1923,36,00199
"Adams Center CDP, New York",584,567,17,1022,36,00232
"Addison village, New York",796,738,58,1841,36,00276
"Afton village, New York",491,399,92,1159,36,00342
"Airmont village, New York",3748,3474,274,10020,36,00408
"Akron village, New York",1343,1218,125,2911,36,00441
"Akwesasne CDP, New York",1612,1428,184,4196,36,00457
"Albany city, New York",55372,50931,4441,99692,36,01000
"Albertson CDP, New York",2814,2730,84,5095,36,01011
"Albion village, New York",2595,2209,386,5428,36,01033
"Alden village, New York",1533,1434,99,2606,36,01088
"Alexander village, New York",297,282,15,507,36,01154
"Alexandria Bay village, New York",550,496,54,1131,36,01187
"Alfred village, New York",1814,1516,298,4577,36,01198
"Allegany village, New York",966,949,17,1867,36,01286
"Almond village, New York",192,183,9,418,36,01440
"Altamont village, New York",948,940,8,1745,36,01517
"Altmar CDP, New York",139,130,9,310,36,01550
"Altona CDP, New York",173,146,27,657,36,01572
"Amagansett CDP, New York",321,321,0,678,36,01594
"Amenia CDP, New York",478,478,0,831,36,01682
"Ames village, New York",93,93,0,166,36,01737
"Amityville village, New York",4841,4615,226,9507,36,02044
"Amsterdam city, New York",8594,7806,788,18244,36,02066
"Andes CDP, New York",57,51,6,115,36,02121
"Andover village, New York",510,459,51,1018,36,02143
"Angelica village, New York",292,273,19,625,36,02176
"Angola village, New York",1464,1424,40,2688,36,02198
"Angola on the Lake CDP, New York",853,778,75,1640,36,02220
"Antwerp village, New York",271,220,51,744,36,02286
"Apalachin CDP, New York",1462,1399,63,2356,36,02308
"Aquebogue CDP, New York",1188,1167,21,1937,36,02374
"Arcade village, New York",1183,1118,65,2095,36,02407
"Ardsley village, New York",2497,2280,217,5013,36,02506
"Argyle village, New York",127,127,0,366,36,02550
"Arkport village, New York",525,521,4,1041,36,02583
"Arlington CDP, New York",1455,1344,111,2405,36,02616
"Armonk CDP, New York",2124,2096,28,4378,36,02649
"Asharoken village, New York",262,252,10,652,36,02737
"Athens village, New York",1015,965,50,1821,36,02902
"Atlantic Beach village, New York",677,660,17,1321,36,02968
"Attica village, New York",1062,1015,47,2135,36,03001
"Auburn city, New York",11737,11038,699,26674,36,03078
"Aurora village, New York",410,407,3,692,36,03188
"Au Sable Forks CDP, New York",313,294,19,590,36,03254
"Averill Park CDP, New York",1008,961,47,1608,36,03320
"Avoca village, New York",484,453,31,923,36,03331
"Avon village, New York",1735,1682,53,3388,36,03353
"Babylon village, New York",7222,6920,302,12185,36,03408
"Bainbridge village, New York",555,514,41,1125,36,04033
"Baiting Hollow CDP, New York",1448,1375,73,2899,36,04055
"Baldwin CDP, New York",19378,18539,839,33776,36,04143
"Baldwinsville village, New York",4053,3824,229,7746,36,04198
"Ballston Spa village, New York",3124,3045,79,5288,36,04253
"Balmville CDP, New York",1914,1807,107,3781,36,04286
"Bard College CDP, New York",588,562,26,1312,36,04388
"Bardonia CDP, New York",1837,1758,79,3503,36,04396
"Barker village, New York",266,259,7,712,36,04440
"Barneveld CDP, New York",59,59,0,191,36,04528
"Barnum Island CDP, New York",1210,1180,30,2353,36,04550
"Barrytown CDP, New York",49,41,8,111,36,04605
"Barryville CDP, New York",154,143,11,314,36,04616
"Batavia city, New York",7928,7610,318,15510,36,04715
"Bath village, New York",2565,2389,176,5606,36,04759
"Baxter Estates village, New York",614,597,17,1148,36,04803
"Bay Park CDP, New York",666,622,44,1389,36,04891
"Bayport CDP, New York",4882,4788,94,8918,36,04913
"Bay Shore CDP, New York",15457,14920,537,30553,36,04935
"Bayville village, New York",3709,3590,119,6763,36,05034
"Baywood CDP, New York",4046,3792,254,7185,36,05039
"Beacon city, New York",8063,7787,276,13876,36,05100
"Beaver Dam Lake CDP, New York",1711,1605,106,3296,36,05188
"Bedford CDP, New York",1007,973,34,2052,36,05309
"Bedford Hills CDP, New York",1218,1136,82,2304,36,05342
"Belfast CDP, New York",348,333,15,654,36,05562
"Bellerose village, New York",421,395,26,999,36,05639
"Bellerose Terrace CDP, New York",1264,1118,146,2135,36,05661
"Belle Terre village, New York",319,302,17,811,36,05672
"Belleville CDP, New York",113,113,0,289,36,05683
"Bellmore CDP, New York",9107,8847,260,15937,36,05738
"Bellport village, New York",965,936,29,1844,36,05771
"Belmont village, New York",373,367,6,865,36,05815
"Bemus Point village, New York",113,109,4,189,36,05848
"Bergen village, New York",647,636,11,1125,36,06046
"Bethpage CDP, New York",8977,8469,508,17281,36,06387
"Big Flats CDP, New York",2834,2765,69,5842,36,06464
"Billington Heights CDP, New York",1057,938,119,1965,36,06574
"Binghamton city, New York",23086,20753,2333,47617,36,06607
"Binghamton University CDP, New York",1643,1227,416,6405,36,06644
"Black River village, New York",775,605,170,1660,36,06794
"Blasdell village, New York",1491,1314,177,2551,36,06849
"Blauvelt CDP, New York",2697,2543,154,5154,36,06860
"Bliss CDP, New York",184,182,2,445,36,06904
"Blodgett Mills CDP, New York",152,139,13,221,36,06937
"Bloomfield village, New York",839,814,25,1362,36,06945
"Bloomingburg village, New York",245,236,9,962,36,06959
"Bloomville CDP, New York",219,192,27,290,36,07025
"Blue Point CDP, New York",2586,2368,218,4616,36,07069
"Bohemia CDP, New York",5484,5320,164,9534,36,07157
"Bolivar village, New York",469,440,29,1050,36,07190
"Bolton Landing CDP, New York",165,156,9,325,36,07245
"Boonville village, New York",883,812,71,1912,36,07355
"Brasher Falls CDP, New York",185,185,0,510,36,07960
"Breesport CDP, New York",292,292,0,864,36,08004
"Brentwood CDP, New York",35744,34093,1651,65042,36,08026
"Brewerton CDP, New York",2155,2017,138,4717,36,08059
"Brewster village, New York",1376,1360,16,2506,36,08070
"Brewster Heights CDP, New York",643,634,9,1262,36,08081
"Brewster Hill CDP, New York",1264,1189,75,2568,36,08092
"Briarcliff Manor village, New York",3812,3661,151,7395,36,08103
"Bridgehampton CDP, New York",668,668,0,1418,36,08136
"Bridgeport CDP, New York",627,625,2,1551,36,08147
"Bridgeville CDP, New York",68,68,0,112,36,08158
"Bridgewater CDP, New York",211,205,6,537,36,08169
"Brighton CDP, New York",19709,18850,859,36819,36,08257
"Brightwaters village, New York",1652,1601,51,3181,36,08323
"Brinckerhoff CDP, New York",1391,1332,59,2519,36,08334
"Broadalbin village, New York",1033,985,48,1815,36,08422
"Brockport village, New York",4079,3867,212,7192,36,08466
"Brocton village, New York",597,561,36,1573,36,08488
"Bronxville village, New York",2874,2774,100,6570,36,08532
"Brookhaven CDP, New York",1661,1483,178,3408,36,09000
"Brooktondale CDP, New York",291,291,0,467,36,10077
"Brookville village, New York",1539,1452,87,2988,36,10132
"Brownville village, New York",359,359,0,586,36,10231
"Brushton village, New York",293,250,43,564,36,10286
"Buchanan village, New York",1208,1177,31,2272,36,10341
"Buffalo city, New York",133080,123732,9348,276688,36,11000
"Burdett village, New York",239,201,38,413,36,11132
"Burke village, New York",77,77,0,199,36,11154
"Burlington Flats CDP, New York",101,93,8,169,36,11220
"Busti CDP, New York",175,175,0,260,36,11440
"Byersville CDP, New York",37,33,4,46,36,11550
"Cadyville CDP, New York",284,284,0,549,36,11616
"Cairo CDP, New York",742,742,0,1353,36,11638
"Calcium CDP, New York",1129,1082,47,3622,36,11671
"Caledonia village, New York",1406,1368,38,2385,36,11704
"Callicoon CDP, New York",122,100,22,225,36,11748
"Calverton CDP, New York",2664,2512,152,6245,36,11781
"Cambridge village, New York",1122,1060,62,2390,36,11825
"Camden village, New York",1117,1092,25,2578,36,11847
"Camillus village, New York",693,646,47,1316,36,11902
"Campbell CDP, New York",189,155,34,685,36,11935
"Canajoharie village, New York",859,824,35,1916,36,12111
"Canandaigua city, New York",5773,5565,208,10562,36,12144
"Canaseraga village, New York",171,153,18,431,36,12177
"Canastota village, New York",2454,2373,81,4550,36,12188
"Candor village, New York",406,400,6,859,36,12210
"Canisteo village, New York",960,840,120,2094,36,12254
"Canton village, New York",2814,2596,218,7245,36,12331
"Cape Vincent village, New York",273,254,19,572,36,12353
"Captree CDP, New York",175,175,0,272,36,12402
"Carle Place CDP, New York",2934,2833,101,5375,36,12419
"Carmel CDP, New York",3193,3044,149,7260,36,12518
"Caroga Lake CDP, New York",276,276,0,577,36,12584
"Carthage village, New York",1170,1107,63,3399,36,12683
"Cassadaga village, New York",250,235,15,518,36,12749
"Castile village, New York",327,313,14,734,36,12771
"Castleton-on-Hudson village, New York",822,640,182,1480,36,12870
"Castorland village, New York",171,162,9,403,36,12881
"Cato village, New York",207,202,5,403,36,12958
"Catskill village, New York",2104,1972,132,3830,36,13002
"Cattaraugus village, New York",483,444,39,1111,36,13024
"Cayuga village, New York",230,228,2,387,36,13068
"Cayuga Heights village, New York",1668,1633,35,4044,36,13079
"Cazenovia village, New York",1206,1138,68,2765,36,13145
"Cedarhurst village, New York",3401,3161,240,7307,36,13233
"Celoron village, New York",521,508,13,1310,36,13288
"Cementon CDP, New York",86,74,12,195,36,13299
"Centereach CDP, New York",16785,15852,933,31889,36,13376
"Center Moriches CDP, New York",4140,3993,147,7890,36,13420
"Centerport CDP, New York",3472,3177,295,6040,36,13442
"Central Bridge CDP, New York",352,336,16,561,36,13530
"Central Islip CDP, New York",19247,18386,861,36519,36,13552
"Central Square village, New York",1069,1030,39,2079,36,13585
"Centre Island village, New York",184,180,4,362,36,13618
"Chadwicks CDP, New York",665,651,14,880,36,13662
"Champlain village, New York",627,604,23,1185,36,13739
"Chappaqua CDP, New York",1555,1453,102,2812,36,13805
"Chateaugay village, New York",356,326,30,781,36,13981
"Chatham village, New York",1098,1067,31,1763,36,14003
"Chaumont village, New York",281,271,10,686,36,14036
"Chautauqua CDP, New York",64,52,12,271,36,14058
"Chazy CDP, New York",213,213,0,476,36,14102
"Cheektowaga CDP, New York",41852,40217,1635,76483,36,15000
"Chelsea Cove CDP, New York",696,669,27,1233,36,15060
"Chenango Bridge CDP, New York",1637,1478,159,3224,36,15121
"Cherry Creek CDP, New York",163,144,19,309,36,15187
"Cherry Valley village, New York",301,284,17,516,36,15242
"Chester village, New York",2373,2320,53,4064,36,15297
"Chestertown CDP, New York",372,288,84,558,36,15363
"Chestnut Ridge village, New York",3803,3590,213,10339,36,15400
"Chittenango village, New York",2188,2086,102,4884,36,15561
"Churchville village, New York",1020,984,36,1887,36,15638
"Clarence CDP, New York",1163,1124,39,2523,36,15814
"Clarence Center CDP, New York",1678,1581,97,3264,36,15836
"Clark Mills CDP, New York",883,873,10,1749,36,15902
"Clarkson CDP, New York",2534,2493,41,5022,36,15946
"Claverack-Red Mills CDP, New York",661,661,0,1042,36,16050
"Clayton village, New York",845,815,30,1738,36,16089
"Clayville village, New York",174,170,4,276,36,16111
"Cleveland village, New York",441,412,29,849,36,16188
"Clifton Gardens CDP, New York",1156,1108,48,2213,36,16298
"Clifton Knolls-Mill Creek CDP, New York",2161,2118,43,3962,36,16322
"Clifton Springs village, New York",847,806,41,2042,36,16375
"Clinton village, New York",1046,1021,25,1928,36,16419
"Clintondale CDP, New York",760,711,49,1493,36,16452
"Clyde village, New York",930,826,104,1955,36,16573
"Cobleskill village, New York",2105,1946,159,4152,36,16628
"Cohocton village, New York",518,471,47,1101,36,16727
"Cohoes city, New York",8675,8040,635,17960,36,16749
"Cold Brook village, New York",112,110,2,217,36,16815
"Cold Spring village, New York",1003,947,56,1844,36,16936
"Cold Spring Harbor CDP, New York",1612,1572,40,2979,36,16958
"Colonie village, New York",3866,3763,103,7767,36,17332
"Colton CDP, New York",134,134,0,274,36,17398
"Commack CDP, New York",19550,18803,747,35770,36,17530
"Conesus CDP, New York",66,59,7,124,36,17607
"Conesus Lake CDP, New York",949,889,60,1925,36,17622
"Congers CDP, New York",4230,4025,205,7882,36,17739
"Constableville village, New York",150,138,12,307,36,17882
"Constantia CDP, New York",872,774,98,1577,36,17893
"Coopers Plains CDP, New York",257,250,7,432,36,18036
"Cooperstown village, New York",1016,960,56,2034,36,18047
"Copake CDP, New York",145,145,0,235,36,18091
"Copake Falls CDP, New York",95,95,0,179,36,18113
"Copake Lake CDP, New York",398,389,9,817,36,18124
"Copenhagen village, New York",373,361,12,723,36,18135
"Copiague CDP, New York",12655,11984,671,23442,36,18146
"Coram CDP, New York",22832,21986,846,42169,36,18157
"Corfu village, New York",510,487,23,852,36,18201
"Corinth village, New York",1283,1197,86,2569,36,18212
"Corning city, New York",5870,5471,399,10685,36,18256
"Cornwall-on-Hudson village, New York",1632,1620,12,3044,36,18333
"Cortland city, New York",9307,8699,608,17574,36,18388
"Cortland West CDP, New York",674,638,36,1168,36,18443
"Country Knolls CDP, New York",3113,3076,37,5811,36,18542
"Cove Neck village, New York",134,131,3,255,36,18597
"Coxsackie village, New York",1096,1009,87,2766,36,18718
"Cragsmoor CDP, New York",285,285,0,472,36,18762
"Cranberry Lake CDP, New York",33,33,0,124,36,18817
"Crest View Heights CDP, New York",988,961,27,1858,36,18993
"Croghan village, New York",322,310,12,661,36,19070
"Crompond CDP, New York",1014,940,74,2211,36,19092
"Croton-on-Hudson village, New York",4531,4183,348,8237,36,19213
"Crown Heights CDP, New York",1675,1509,166,3030,36,19229
"Crugers CDP, New York",569,546,23,1466,36,19290
"Crystal Beach CDP, New York",378,378,0,746,36,19308
"Cuba village, New York",905,849,56,1802,36,19356
"Cumberland Head CDP, New York",628,614,14,1357,36,19408
"Cumminsville CDP, New York",8,8,0,86,36,19411
"Cutchogue CDP, New York",1377,1361,16,2792,36,19466
"Cuylerville CDP, New York",171,171,0,324,36,19510
"Dalton CDP, New York",194,194,0,347,36,19587
"Danby CDP, New York",141,141,0,318,36,19609
"Dannemora village, New York",436,416,20,3373,36,19642
"Dansville village, New York",2491,2301,190,4774,36,19664
"Davenport Center CDP, New York",172,172,0,489,36,19774
"Deer Park CDP, New York",15742,15211,531,27304,36,19972
"Deferiet village, New York",154,154,0,331,36,19994
"DeKalb Junction CDP, New York",265,258,7,645,36,20049
"Delanson village, New York",205,180,25,329,36,20082
"Delevan village, New York",546,501,45,1175,36,20115
"Delhi village, New York",1325,1252,73,3148,36,20126
"Depauville CDP, New York",217,151,66,388,36,20302
"Depew village, New York",8195,7795,400,15141,36,20313
"Deposit village, New York",588,578,10,1403,36,20346
"Dering Harbor village, New York",0,0,0,0,36,20379
"DeRuyter village, New York",153,149,4,324,36,20390
"De Witt CDP, New York",5317,5056,261,11261,36,20467
"Dexter village, New York",316,299,17,763,36,20500
"Dix Hills CDP, New York",13204,12670,534,24652,36,20687
"Dobbs Ferry village, New York",6236,5874,362,11431,36,20698
"Dolgeville village, New York",1028,1003,25,2180,36,20731
"Dover Plains CDP, New York",562,542,20,1154,36,20841
"Downsville CDP, New York",137,131,6,315,36,20852
"Dresden village, New York",198,198,0,433,36,20896
"Dryden village, New York",868,821,47,1838,36,20951
"Duane Lake CDP, New York",88,76,12,217,36,20989
"Duanesburg CDP, New York",228,228,0,326,36,20995
"Dundee village, New York",844,821,23,2080,36,21050
"Dunkirk city, New York",5837,5568,269,12668,36,21105
"Durhamville CDP, New York",363,304,59,761,36,21226
"Eagle Bay CDP, New York",18,18,0,18,36,21380
"Earlville village, New York",352,349,3,629,36,21523
"East Atlantic Beach CDP, New York",1135,1024,111,1767,36,21578
"East Aurora village, New York",3007,2891,116,5996,36,21589
"East Avon CDP, New York",291,273,18,568,36,21600
"Eastchester CDP, New York",10366,10032,334,20633,36,21809
"East Durham CDP, New York",289,289,0,693,36,21919
"East Farmingdale CDP, New York",3377,3117,260,6043,36,21985
"East Frankfort CDP, New York",152,138,14,499,36,22029
"East Glenville CDP, New York",5528,5158,370,11477,36,22084
"East Greenbush CDP, New York",3617,3539,78,6571,36,22106
"East Hampton village, New York",560,554,6,1270,36,22183
"East Hampton North CDP, New York",3202,3192,10,5587,36,22200
"East Herkimer CDP, New York",412,377,35,792,36,22238
"East Hills village, New York",4080,3933,147,7242,36,22260
"East Islip CDP, New York",6953,6766,187,13576,36,22315
"East Ithaca CDP, New York",1216,1176,40,2135,36,22326
"East Kingston CDP, New York",233,180,53,326,36,22370
"East Marion CDP, New York",709,703,6,1564,36,22447
"East Massapequa CDP, New York",10602,10086,516,19508,36,22480
"East Meadow CDP, New York",17556,16961,595,36856,36,22502
"East Moriches CDP, New York",2714,2653,61,5581,36,22546
"East Nassau village, New York",248,243,5,444,36,22557
"East Northport CDP, New York",11547,11041,506,20287,36,22612
"East Norwich CDP, New York",1486,1456,30,2829,36,22623
"East Patchogue CDP, New York",12186,11615,571,21449,36,22733
"Eastport CDP, New York",1042,1013,29,2136,36,22810
"East Quogue CDP, New York",2920,2828,92,5620,36,22832
"East Randolph CDP, New York",209,195,14,551,36,22843
"East Rochester village, New York",3696,3443,253,6321,36,22865
"East Rockaway village, New York",5607,5255,352,10070,36,22876
"East Setauket CDP, New York",5720,5430,290,10234,36,22964
"East Shoreham CDP, New York",3726,3589,137,7367,36,22980
"East Syracuse village, New York",1703,1675,28,3065,36,23052
"East Williston village, New York",1165,1146,19,2630,36,23217
"East Worcester CDP, New York",160,138,22,209,36,23283
"Eatons Neck CDP, New York",741,736,5,1258,36,23316
"Eden CDP, New York",1491,1433,58,3157,36,23404
"Edmeston CDP, New York",250,250,0,574,36,23602
"Edwards CDP, New York",227,190,37,540,36,23635
"Eggertsville CDP, New York",8457,8136,321,15076,36,23701
"Elba village, New York",272,258,14,491,36,23745
"Elbridge village, New York",646,601,45,1384,36,23789
"Eldred CDP, New York",131,101,30,191,36,23811
"Elizabethtown CDP, New York",219,207,12,553,36,23822
"Ellenville village, New York",1698,1687,11,4213,36,23965
"Ellicottville village, New York",208,190,18,374,36,24020
"Ellisburg village, New York",52,45,7,188,36,24075
"Elma Center CDP, New York",1451,1370,81,3434,36,24141
"Elmira city, New York",11395,10275,1120,26494,36,24229
"Elmira Heights village, New York",2045,1996,49,4239,36,24251
"Elmont CDP, New York",21679,20024,1655,37866,36,24273
"Elmsford village, New York",2799,2652,147,5192,36,24295
"Elwood CDP, New York",6263,6114,149,11124,36,24405
"Endicott village, New York",6231,5766,465,13540,36,24515
"Endwell CDP, New York",6043,5846,197,11826,36,24526
"Erin CDP, New York",239,206,33,538,36,24625
"Esperance village, New York",140,136,4,277,36,24713
"Evans Mills village, New York",157,146,11,503,36,24823
"Fabius village, New York",204,187,17,357,36,24867
"Fair Haven village, New York",615,600,15,1151,36,24988
"Fairmount CDP, New York",5533,5393,140,9978,36,25043
"Fairport village, New York",2795,2668,127,5442,36,25076
"Fairview CDP (Dutchess County), New York",4017,3756,261,6701,36,25109
"Fairview CDP (Westchester County), New York",1921,1732,189,3263,36,25120
"Falconer village, New York",1088,1009,79,2193,36,25164
"Fallsburg CDP, New York",262,248,14,1996,36,25230
"Farmingdale village, New York",5088,4861,227,8428,36,25384
"Farmingville CDP, New York",9731,9340,391,16889,36,25417
"Farnham village, New York",209,190,19,424,36,25428
"Fayetteville village, New York",2358,2297,61,4248,36,25527
"Felts Mills CDP, New York",99,99,0,430,36,25571
"Fillmore CDP, New York",309,286,23,652,36,25747
"Fire Island CDP, New York",163,163,0,298,36,25839
"Firthcliffe CDP, New York",2808,2706,102,5264,36,25857
"Fishers Island CDP, New York",39,39,0,53,36,25923
"Fishers Landing CDP, New York",4,4,0,54,36,25934
"Fishkill village, New York",1269,1184,85,2177,36,25967
"Flanders CDP, New York",3163,3080,83,6411,36,26121
"Fleischmanns village, New York",156,150,6,260,36,26209
"Floral Park village, New York",8861,8524,337,15892,36,26264
"Florida village, New York",1588,1538,50,2937,36,26319
"Flower Hill village, New York",2515,2435,80,4787,36,26352
"Fly Creek CDP, New York",116,116,0,217,36,26418
"Fonda village, New York",282,276,6,495,36,26462
"Forest Home CDP, New York",550,516,34,1107,36,26561
"Forestville CDP, New York",213,213,0,532,36,26649
"Fort Ann village, New York",302,302,0,511,36,26704
"Fort Covington CDP, New York",562,560,2,1202,36,26726
"Fort Drum CDP, New York",2668,2410,258,16298,36,26759
"Fort Edward village, New York",1784,1749,35,3189,36,26770
"Fort Johnson village, New York",264,236,28,510,36,26880
"Fort Montgomery CDP, New York",1478,1422,56,2453,36,26902
"Fort Plain village, New York",999,931,68,2015,36,26924
"Fort Salonga CDP, New York",5195,4905,290,9836,36,26946
"Fowlerville CDP, New York",67,60,7,267,36,27133
"Frankfort village, New York",1164,1157,7,2367,36,27188
"Franklin village, New York",230,203,27,385,36,27221
"Franklin Square CDP, New York",17869,17177,692,31969,36,27309
"Franklinville village, New York",985,923,62,2035,36,27331
"Fredonia village, New York",4392,4250,142,9710,36,27419
"Freedom Plains CDP, New York",453,453,0,641,36,27452
"Freeport village, New York",24714,23237,1477,44210,36,27485
"Freeville village, New York",226,224,2,468,36,27529
"Frewsburg CDP, New York",801,801,0,1891,36,27672
"Friendship CDP, New York",367,342,25,833,36,27694
"Fulton city, New York",5245,4771,474,11381,36,27815
"Fultonville village, New York",320,310,10,670,36,27859
"Gainesville village, New York",121,115,6,216,36,27969
"Galeville CDP, New York",2155,1940,215,4591,36,28035
"Galway village, New York",75,73,2,174,36,28101
"Gananda CDP, New York",3714,3615,99,6869,36,28138
"Gang Mills CDP, New York",2360,2299,61,4562,36,28145
"Garden City village, New York",11037,10656,381,22871,36,28178
"Garden City Park CDP, New York",3924,3691,233,7775,36,28189
"Garden City South CDP, New York",2186,2120,66,4113,36,28200
"Gardiner CDP, New York",317,317,0,637,36,28244
"Gardnertown CDP, New York",2077,1982,95,3943,36,28310
"Garrattsville CDP, New York",54,54,0,150,36,28376
"Gasport CDP, New York",810,752,58,1400,36,28431
"Gates CDP, New York",2481,2353,128,4716,36,28453
"Geneseo village, New York",3196,2969,227,7713,36,28618
"Geneva city, New York",6420,6224,196,12670,36,28640
"Germantown CDP, New York",500,453,47,1068,36,28761
"Ghent CDP, New York",263,263,0,477,36,28860
"Gilbertsville village, New York",182,169,13,337,36,28959
"Gilgo CDP, New York",96,96,0,209,36,28990
"Glasco CDP, New York",1080,1077,3,2134,36,29014
"Glen Aubrey CDP, New York",135,129,6,219,36,29058
"Glen Cove city, New York",14463,13944,519,28132,36,29113
"Glen Head CDP, New York",2369,2316,53,4801,36,29245
"Glen Park village, New York",321,307,14,661,36,29322
"Glens Falls city, New York",8005,7548,457,14743,36,29333
"Glens Falls North CDP, New York",4548,4322,226,8996,36,29338
"Glenwood Landing CDP, New York",1620,1568,52,3694,36,29421
"Gloversville city, New York",6843,6347,496,15113,36,29443
"Golden's Bridge CDP, New York",958,946,12,1556,36,29476
"Gordon Heights CDP, New York",2352,2253,99,4466,36,29509
"Gorham CDP, New York",304,304,0,474,36,29520
"Goshen village, New York",2955,2922,33,5736,36,29542
"Gouverneur village, New York",1477,1328,149,3646,36,29597
"Gowanda village, New York",1282,1216,66,3211,36,29630
"Grahamsville CDP, New York",224,224,0,427,36,29707
"Grand View-on-Hudson village, New York",91,87,4,212,36,29872
"Grandyle Village CDP, New York",2602,2475,127,5053,36,29894
"Granville village, New York",1007,967,40,2370,36,30026
"Great Bend CDP, New York",591,420,171,1208,36,30136
"Great Neck village, New York",4207,4010,197,11060,36,30169
"Great Neck Estates village, New York",1356,1337,19,2936,36,30191
"Great Neck Gardens CDP, New York",623,623,0,1139,36,30202
"Great Neck Plaza village, New York",3869,3600,269,7443,36,30213
"Great River CDP, New York",1233,1193,40,1992,36,30235
"Greece CDP, New York",7630,7250,380,14406,36,30279
"Greene village, New York",758,704,54,1574,36,30411
"Green Island village, New York",1496,1302,194,2968,36,30521
"Greenlawn CDP, New York",8001,7667,334,15169,36,30543
"Greenport village, New York",1494,1412,82,2569,36,30576
"Greenport West CDP, New York",989,920,69,2230,36,30581
"Greenvale CDP, New York",506,450,56,1164,36,30598
"Greenville CDP (Greene County), New York",245,245,0,746,36,30609
"Greenville CDP (Westchester County), New York",5076,4807,269,9585,36,30642
"Greenwich village, New York",1051,1027,24,1819,36,30675
"Greenwood Lake village, New York",1396,1330,66,3027,36,30752
"Greigsville CDP, New York",66,66,0,166,36,30807
"Groton village, New York",1053,1026,27,2036,36,30961
"Groveland Station CDP, New York",219,207,12,413,36,31022
"Guilford CDP, New York",93,79,14,159,36,31137
"Hadley CDP, New York",536,504,32,1072,36,31258
"Hagaman village, New York",585,569,16,1156,36,31291
"Hailesboro CDP, New York",287,268,19,627,36,31346
"Haines Falls CDP, New York",30,30,0,282,36,31357
"Halesite CDP, New York",1317,1212,105,2416,36,31445
"Hall CDP, New York",210,199,11,302,36,31533
"Hamburg village, New York",5886,5740,146,9749,36,31643
"Hamilton village, New York",1525,1516,9,3882,36,31709
"Hamilton College CDP, New York",675,653,22,1906,36,31746
"Hamlin CDP, New York",2300,2196,104,4817,36,31786
"Hammond village, New York",94,92,2,269,36,31830
"Hammondsport village, New York",281,274,7,569,36,31852
"Hampton Bays CDP, New York",8854,8554,300,16939,36,31896
"Hampton Manor CDP, New York",3323,3217,106,5344,36,31918
"Hancock village, New York",343,302,41,878,36,31940
"Hankins CDP, New York",64,64,0,133,36,31973
"Hannawa Falls CDP, New York",418,406,12,892,36,32006
"Hannibal village, New York",371,345,26,708,36,32017
"Harbor Hills CDP, New York",234,234,0,462,36,32094
"Harbor Isle CDP, New York",736,711,25,1360,36,32105
"Harriman village, New York",1580,1496,84,2955,36,32325
"Harris Hill CDP, New York",3125,3084,41,6107,36,32391
"Harrison village, New York",14419,13653,766,28721,36,32402
"Hartsdale CDP, New York",1782,1753,29,3082,36,32523
"Hartwick CDP, New York",279,259,20,531,36,32578
"Hartwick Seminary CDP, New York",48,48,0,291,36,32597
"Hastings-on-Hudson village, New York",4544,4445,99,8456,36,32710
"Hauppauge CDP, New York",11351,10771,580,20401,36,32732
"Haverstraw village, New York",6070,5538,532,12286,36,32754
"Haviland CDP, New York",1890,1733,157,3500,36,32776
"Hawthorne CDP, New York",2596,2419,177,4693,36,32842
"Head of the Harbor village, New York",858,833,25,1501,36,32963
"Hemlock CDP, New York",348,328,20,668,36,33128
"Hempstead village, New York",31005,28398,2607,58557,36,33139
"Henderson CDP, New York",105,66,39,238,36,34044
"Heritage Hills CDP, New York",1241,1100,141,3927,36,34118
"Herkimer village, New York",3585,3367,218,6858,36,34121
"Hermon CDP, New York",126,121,5,477,36,34165
"Herricks CDP, New York",1959,1801,158,4225,36,34198
"Herrings CDP, New York",19,19,0,33,36,34220
"Heuvelton village, New York",363,333,30,638,36,34264
"Hewlett CDP, New York",3705,3506,199,7590,36,34286
"Hewlett Bay Park village, New York",222,222,0,353,36,34297
"Hewlett Harbor village, New York",523,488,35,1066,36,34308
"Hewlett Neck village, New York",289,281,8,641,36,34319
"Hicksville CDP, New York",24450,23523,927,44084,36,34374
"High Falls CDP, New York",240,220,20,482,36,34451
"Highland CDP, New York",3538,3389,149,6545,36,34484
"Highland Falls village, New York",1950,1852,98,3720,36,34495
"Highland-on-the-Lake CDP, New York",1956,1915,41,3809,36,34528
"Hillburn village, New York",499,455,44,1131,36,34660
"Hillcrest CDP, New York",4406,4082,324,8178,36,34693
"Hillside CDP, New York",394,389,5,754,36,34786
"Hillside Lake CDP, New York",823,816,7,1256,36,34803
"Hilton village, New York",2992,2764,228,5998,36,34847
"Hobart village, New York",235,223,12,400,36,34979
"Holbrook CDP, New York",15155,14517,638,27220,36,35056
"Holland CDP, New York",589,548,41,1218,36,35111
"Holland Patent village, New York",153,149,4,278,36,35144
"Holley village, New York",1038,997,41,1829,36,35155
"Holtsville CDP, New York",11175,10823,352,19597,36,35254
"Homer village, New York",1829,1792,37,3170,36,35276
"Honeoye CDP, New York",484,475,9,768,36,35353
"Honeoye Falls village, New York",1495,1344,151,2774,36,35364
"Hoosick Falls village, New York",1325,1309,16,3225,36,35474
"Hopewell Junction CDP, New York",340,338,2,824,36,35573
"Hornell city, New York",3659,3347,312,8208,36,35672
"Horseheads village, New York",3165,3052,113,6524,36,35694
"Horseheads North CDP, New York",1233,1223,10,2707,36,35710
"Hortonville CDP, New York",98,98,0,282,36,35738
"Houghton CDP, New York",836,779,57,1771,36,35771
"Hudson city, New York",2952,2573,379,5923,36,35969
"Hudson Falls village, New York",3827,3604,223,7426,36,35980
"Hunt CDP, New York",20,20,0,124,36,36156
"Hunter village, New York",163,146,17,300,36,36167
"Huntington CDP, New York",11340,10758,582,19610,36,36233
"Huntington Bay village, New York",814,767,47,1776,36,37022
"Huntington Station CDP, New York",19507,18400,1107,34588,36,37044
"Hurley CDP, New York",1807,1777,30,3370,36,37132
"Hurleyville CDP, New York",682,642,40,1381,36,37154
"Hyde Park CDP, New York",983,923,60,1963,36,37198
"Ilion village, New York",3641,3492,149,7703,36,37275
"Interlaken village, New York",257,252,5,503,36,37528
"Inwood CDP, New York",5255,4989,266,11156,36,37583
"Irondequoit CDP, New York",27530,26123,1407,50780,36,37737
"Irvington village, New York",3509,3401,108,6590,36,37803
"Islandia village, New York",1980,1901,79,3568,36,37840
"Island Park village, New York",2683,2501,182,4947,36,37847
"Islip CDP, New York",9741,9216,525,17284,36,37869
"Islip Terrace CDP, New York",3188,3178,10,5318,36,38022
"Ithaca city, New York",15757,14834,923,31359,36,38077
"Jacksonville CDP, New York",328,301,27,668,36,38209
"Jamesport CDP, New York",784,746,38,1634,36,38253
"Jamestown city, New York",13233,12033,1200,28679,36,38264
"Jamestown West CDP, New York",1208,1201,7,2587,36,38275
"Jefferson CDP, New York",65,62,3,143,36,38429
"Jefferson Heights CDP, New York",528,518,10,1435,36,38451
"Jefferson Valley-Yorktown CDP, New York",7270,6619,651,14072,36,38500
"Jeffersonville village, New York",239,237,2,434,36,38506
"Jericho CDP, New York",6544,6083,461,14281,36,38539
"Johnson City village, New York",7290,6470,820,15229,36,38748
"Johnstown city, New York",4145,4003,142,8216,36,38781
"Jordan village, New York",722,695,27,1480,36,38825
"Kaser village, New York",1507,1399,108,5501,36,38934
"Katonah CDP, New York",946,946,0,1893,36,38946
"Kauneonga Lake CDP, New York",287,268,19,539,36,38985
"Keeseville CDP, New York",1233,1150,83,2545,36,39089
"Kenmore village, New York",8705,8246,459,15155,36,39232
"Kennedy CDP, New York",104,104,0,222,36,39243
"Kensington village, New York",609,582,27,1445,36,39309
"Kerhonkson CDP, New York",1101,1010,91,2038,36,39397
"Keuka Park CDP, New York",518,489,29,1092,36,39463
"Kiamesha Lake CDP, New York",187,187,0,321,36,39485
"Kinderhook village, New York",738,670,68,1351,36,39562
"Kings Park CDP, New York",9119,8705,414,16730,36,39672
"Kings Point village, New York",2208,2160,48,5593,36,39694
"Kingston city, New York",12978,12198,780,24018,36,39727
"Kiryas Joel village, New York",8032,7756,276,34368,36,39853
"Kysorville CDP, New York",24,24,0,59,36,40175
"Lackawanna city, New York",9758,9232,526,19762,36,40189
"Lacona village, New York",341,319,22,782,36,40200
"La Fargeville CDP, New York",205,193,12,530,36,40233
"Lake Carmel CDP, New York",4641,4470,171,8089,36,40398
"Lake Delta CDP, New York",1446,1416,30,2929,36,40475
"Lake Erie Beach CDP, New York",1324,1281,43,3282,36,40486
"Lake George village, New York",499,493,6,943,36,40508
"Lake Grove village, New York",5816,5512,304,11066,36,40530
"Lake Huntington CDP, New York",181,143,38,271,36,40552
"Lake Katrine CDP, New York",933,913,20,2357,36,40585
"Lakeland CDP, New York",1428,1392,36,2513,36,40607
"Lake Luzerne CDP, New York",609,588,21,1354,36,40651
"Lake Mohegan CDP, New York",3412,3320,92,5938,36,40689
"Lake Placid village, New York",1311,1311,0,2280,36,40761
"Lake Ronkonkoma CDP, New York",9925,9347,578,18339,36,40838
"Lake Success village, New York",1201,1164,37,2825,36,40937
"Lakeview CDP, New York",2978,2823,155,5938,36,41003
"Lakeville CDP, New York",516,261,255,577,36,41036
"Lakewood village, New York",1510,1393,117,2986,36,41069
"Lancaster village, New York",6259,6184,75,10160,36,41135
"Lansing village, New York",2399,2309,90,3814,36,41223
"Larchmont village, New York",3221,2888,333,6549,36,41333
"Latham CDP, New York",8082,7795,287,13660,36,41399
"Lattingtown village, New York",1119,1062,57,2039,36,41432
"Laurel CDP, New York",604,604,0,980,36,41465
"Laurel Hollow village, New York",1035,1029,6,2050,36,41487
"Laurens village, New York",88,88,0,186,36,41520
"Lawrence village, New York",2335,2217,118,6773,36,41553
"Leeds CDP, New York",263,263,0,309,36,41784
"Leicester village, New York",258,250,8,509,36,41872
"Le Roy village, New York",2160,2120,40,4332,36,42026
"Levittown CDP, New York",29832,28210,1622,50804,36,42081
"Lewiston village, New York",1388,1331,57,2541,36,42147
"Liberty village, New York",2105,1944,161,5030,36,42224
"Lido Beach CDP, New York",1385,1311,74,2615,36,42279
"Lima village, New York",1173,1142,31,2243,36,42323
"Lime Lake CDP, New York",295,275,20,755,36,42345
"Limestone CDP, New York",186,186,0,426,36,42378
"Lincolndale CDP, New York",772,772,0,1217,36,42455
"Lincoln Park CDP, New York",1077,987,90,2375,36,42488
"Lindenhurst village, New York",15286,14263,1023,27139,36,42554
"Linwood CDP, New York",14,14,0,31,36,42609
"Lisle village, New York",106,106,0,231,36,42642
"Little Falls city, New York",2046,1931,115,4596,36,42741
"Little Valley village, New York",358,344,14,1010,36,42829
"Liverpool village, New York",1154,1121,33,2331,36,42884
"Livingston Manor CDP, New York",389,389,0,863,36,42928
"Livonia village, New York",778,752,26,1525,36,42950
"Livonia Center CDP, New York",206,176,30,305,36,42972
"Lloyd Harbor village, New York",1539,1533,6,3572,36,43005
"Loch Sheldrake CDP, New York",436,395,41,1623,36,43038
"Lockport city, New York",10730,10119,611,20808,36,43082
"Locust Valley CDP, New York",1727,1671,56,3611,36,43192
"Lodi village, New York",134,124,10,303,36,43214
"Long Beach city, New York",20935,20138,797,34734,36,43335
"Long Lake CDP, New York",315,267,48,666,36,43401
"Lorenz Park CDP, New York",1035,988,47,2003,36,43511
"Lorraine CDP, New York",63,60,3,114,36,43533
"Loudonville CDP, New York",5157,5076,81,9826,36,43566
"Lowville village, New York",1693,1564,129,3534,36,43720
"Lynbrook village, New York",11232,10798,434,20299,36,43874
"Lyncourt CDP, New York",2053,2021,32,3917,36,43885
"Lyndonville village, New York",428,398,30,829,36,43918
"Lyon Mountain CDP, New York",82,70,12,250,36,43951
"Lyons CDP, New York",1876,1589,287,3594,36,43962
"Lyons Falls village, New York",189,186,3,510,36,44006
"MacDonnell Heights CDP, New York",585,555,30,1373,36,44105
"Macedon CDP, New York",740,721,19,1668,36,44149
"McGraw village, New York",562,519,43,1261,36,44193
"Machias CDP, New York",255,255,0,578,36,44226
"McLean CDP, New York",202,202,0,389,36,44358
"Madison village, New York",155,152,3,382,36,44424
"Madrid CDP, New York",408,385,23,822,36,44479
"Mahopac CDP, New York",4791,4621,170,8774,36,44534
"Malden-on-Hudson CDP, New York",121,121,0,321,36,44677
"Malone village, New York",2659,2586,73,5507,36,44710
"Malverne village, New York",5079,4955,124,8526,36,44787
"Malverne Park Oaks CDP, New York",281,281,0,585,36,44792
"Mamaroneck village, New York",10850,10459,391,19930,36,44831
"Manchester village, New York",801,756,45,1534,36,44853
"Manhasset CDP, New York",3746,3722,24,7720,36,44897
"Manhasset Hills CDP, New York",1849,1802,47,3904,36,44908
"Manlius village, New York",2351,2215,136,4675,36,45018
"Mannsville village, New York",164,156,8,328,36,45073
"Manorhaven village, New York",3746,3622,124,6929,36,45106
"Manorville CDP, New York",6659,6550,109,12681,36,45139
"Marathon village, New York",515,479,36,1036,36,45392
"Marcellus village, New York",1205,1067,138,2048,36,45480
"Marcy CDP, New York",431,431,0,791,36,45524
"Margaretville village, New York",183,183,0,656,36,45557
"Mariaville Lake CDP, New York",439,439,0,779,36,45573
"Marion CDP, New York",636,625,11,1219,36,45634
"Marist College CDP, New York",784,696,88,2120,36,45659
"Marlboro CDP, New York",1753,1753,0,3635,36,45700
"Massapequa CDP, New York",11994,11449,545,21845,36,45986
"Massapequa Park village, New York",9043,8599,444,17045,36,45997
"Massena village, New York",4688,4372,316,10218,36,46019
"Mastic CDP, New York",7520,6853,667,14968,36,46074
"Mastic Beach CDP, New York",7731,7289,442,16189,36,46085
"Matinecock village, New York",338,334,4,806,36,46107
"Mattituck CDP, New York",2413,2215,198,4800,36,46140
"Mattydale CDP, New York",3309,3118,191,5825,36,46151
"Maybrook village, New York",1719,1647,72,3135,36,46162
"Mayfield village, New York",463,445,18,938,36,46206
"Mayville village, New York",521,481,40,1355,36,46239
"Mechanicstown CDP, New York",3876,3395,481,8620,36,46349
"Mechanicville city, New York",2869,2683,186,5177,36,46360
"Medford CDP, New York",12236,11502,734,24738,36,46404
"Medina village, New York",2678,2523,155,5827,36,46415
"Melrose Park CDP, New York",1144,1116,28,1997,36,46503
"Melville CDP, New York",10039,9207,832,18526,36,46514
"Menands village, New York",2540,2460,80,4512,36,46536
"Meridian village, New York",129,128,1,206,36,46646
"Merrick CDP, New York",11261,10906,355,21004,36,46668
"Merritt Park CDP, New York",985,965,20,1879,36,46750
"Mexico village, New York",980,959,21,1925,36,46811
"Middleburgh village, New York",681,670,11,1211,36,46866
"Middle Island CDP, New York",5461,5230,231,10731,36,46976
"Middleport village, New York",969,910,59,1972,36,46998
"Middletown city, New York",14285,13580,705,30169,36,47042
"Middleville village, New York",256,239,17,622,36,47108
"Milford village, New York",235,230,5,462,36,47229
"Millbrook village, New York",670,670,0,1382,36,47273
"Miller Place CDP, New York",5250,4849,401,11848,36,47306
"Millerton village, New York",505,491,14,862,36,47361
"Mill Neck village, New York",522,498,24,1108,36,47405
"Millport village, New York",159,139,20,425,36,47427
"Millwood CDP, New York",409,409,0,696,36,47482
"Milton CDP (Saratoga County), New York",2257,2179,78,4385,36,47548
"Milton CDP (Ulster County), New York",1061,1039,22,1835,36,47554
"Mineola village, New York",13091,12605,486,20940,36,47636
"Minetto CDP, New York",715,628,87,1430,36,47680
"Mineville CDP, New York",574,574,0,1246,36,47702
"Minoa village, New York",1901,1652,249,3652,36,47757
"Mohawk village, New York",1212,1183,29,2574,36,47823
"Mongaup Valley CDP, New York",82,82,0,212,36,47977
"Monroe village, New York",5303,5082,221,9420,36,47988
"Monsey CDP, New York",7213,6622,591,28287,36,48010
"Montauk CDP, New York",2230,2108,122,4322,36,48054
"Montebello village, New York",2276,2115,161,4645,36,48090
"Montgomery village, New York",1792,1743,49,3797,36,48142
"Monticello village, New York",3770,3418,352,7224,36,48175
"Montour Falls village, New York",672,603,69,1830,36,48197
"Montrose CDP, New York",2394,1963,431,3728,36,48208
"Mooers CDP, New York",271,240,31,524,36,48241
"Moravia village, New York",610,574,36,1398,36,48296
"Moriches CDP, New York",1221,1175,46,2626,36,48450
"Morris village, New York",222,218,4,492,36,48483
"Morrisonville CDP, New York",784,782,2,1639,36,48538
"Morrisville village, New York",561,542,19,1526,36,48593
"Mountain Dale CDP, New York",158,144,14,260,36,48736
"Mountain Lodge Park CDP, New York",1154,1119,35,2083,36,48750
"Mount Ivy CDP, New York",4100,3819,281,7730,36,48879
"Mount Kisco village, New York",5742,5461,281,10835,36,48890
"Mount Morris village, New York",1443,1398,45,3347,36,48945
"Mount Sinai CDP, New York",5629,5285,344,11641,36,49066
"Mount Vernon city, New York",39696,36522,3174,72817,36,49121
"Mount Vision CDP, New York",60,60,0,110,36,49143
"Munnsville village, New York",224,219,5,402,36,49220
"Munsey Park village, New York",1388,1297,91,2792,36,49231
"Munsons Corners CDP, New York",1158,1128,30,2680,36,49242
"Muttontown village, New York",1715,1592,123,3499,36,49330
"Myers Corner CDP, New York",6277,6028,249,10653,36,49363
"Nanuet CDP, New York",10550,10229,321,20586,36,49407
"Napanoch CDP, New York",443,433,10,843,36,49418
"Napeague CDP, New York",83,83,0,154,36,49424
"Naples village, New York",511,505,6,976,36,49429
"Narrowsburg CDP, New York",226,182,44,378,36,49473
"Nassau village, New York",667,591,76,1169,36,49506
"Nassau Lake CDP, New York",486,481,5,840,36,49555
"Natural Bridge CDP, New York",141,141,0,179,36,49605
"Nazareth College CDP, New York",595,581,14,1229,36,49715
"Nedrow CDP, New York",1181,1135,46,2251,36,49726
"Nelliston village, New York",280,264,16,693,36,49748
"Nelsonville village, New York",371,349,22,674,36,49781
"Nesconset CDP, New York",7189,7066,123,13549,36,49825
"Newark village, New York",4173,4046,127,9076,36,49891
"Newark Valley village, New York",498,475,23,1080,36,49902
"New Baltimore CDP, New York",187,187,0,466,36,49924
"New Berlin village, New York",335,325,10,805,36,49946
"Newburgh city, New York",13837,12761,1076,28751,36,50034
"New Cassel CDP, New York",7945,7700,245,15127,36,50067
"New City CDP, New York",17958,16667,1291,33837,36,50100
"Newfane CDP, New York",1382,1315,67,3234,36,50221
"Newfield CDP, New York",779,779,0,1142,36,50243
"New Hackensack CDP, New York",692,675,17,1329,36,50265
"New Hamburg CDP, New York",386,367,19,921,36,50276
"New Hartford village, New York",864,842,22,1891,36,50298
"New Hempstead village, New York",2377,2213,164,5449,36,50353
"New Hyde Park village, New York",5853,5601,252,10235,36,50397
"New Paltz village, New York",3513,3191,322,7732,36,50551
"Newport village, New York",242,214,28,464,36,50573
"New Rochelle city, New York",43401,40354,3047,80828,36,50617
"New Square village, New York",2816,2587,229,9578,36,50705
"New Suffolk CDP, New York",127,127,0,305,36,50727
"New Windsor CDP, New York",4817,4302,515,8788,36,50837
"New York city, New York",4445502,4108682,336820,8622467,36,51000
"New York Mills village, New York",1540,1540,0,3084,36,51011
"Niagara Falls city, New York",22715,20654,2061,48502,36,51055
"Niagara University CDP, New York",429,420,9,1218,36,51088
"Nichols village, New York",306,303,3,661,36,51110
"Niskayuna CDP, New York",10387,10105,282,20629,36,51262
"Nissequogue village, New York",777,745,32,1523,36,51286
"Niverville CDP, New York",777,675,102,1463,36,51297
"Norfolk CDP, New York",358,337,21,869,36,51319
"North Amityville CDP, New York",12151,11600,551,20336,36,51396
"Northampton CDP, New York",520,484,36,1405,36,51418
"North Babylon CDP, New York",10078,9673,405,18393,36,51440
"North Ballston Spa CDP, New York",604,558,46,1283,36,51467
"North Bay CDP, New York",59,59,0,153,36,51484
"North Bay Shore CDP, New York",10297,9779,518,18392,36,51495
"North Bellmore CDP, New York",11205,10832,373,21070,36,51517
"North Bellport CDP, New York",5583,5145,438,10530,36,51528
"North Blenheim CDP, New York",51,42,9,79,36,51561
"North Boston CDP, New York",1455,1320,135,2554,36,51583
"North Collins village, New York",597,531,66,1204,36,51792
"North Creek CDP, New York",194,174,20,546,36,51847
"Northeast Ithaca CDP, New York",1453,1410,43,2627,36,51915
"North Gates CDP, New York",5778,5605,173,10138,36,52040
"North Granville CDP, New York",339,339,0,605,36,52067
"North Great River CDP, New York",2025,1994,31,3680,36,52078
"North Haven village, New York",460,448,12,913,36,52188
"North Hills village, New York",2519,2472,47,5425,36,53022
"North Hornell village, New York",529,441,88,1152,36,53055
"North Lindenhurst CDP, New York",6635,6401,234,11155,36,53198
"North Lynbrook CDP, New York",252,252,0,470,36,53231
"North Massapequa CDP, New York",10456,10152,304,18198,36,53253
"North Merrick CDP, New York",6646,6476,170,12192,36,53264
"North New Hyde Park CDP, New York",7483,7159,324,14652,36,53275
"North Patchogue CDP, New York",3823,3769,54,7800,36,53319
"Northport village, New York",4131,4110,21,7337,36,53396
"North Rose CDP, New York",287,266,21,588,36,53462
"North Sea CDP, New York",3557,3525,32,6054,36,53561
"North Syracuse village, New York",3586,3413,173,6669,36,53660
"North Tonawanda city, New York",16620,15684,936,30479,36,53682
"North Valley Stream CDP, New York",10556,9981,575,19016,36,53748
"Northville village, New York",415,410,5,1034,36,53770
"Northville CDP, New York",766,766,0,1829,36,53775
"North Wantagh CDP, New York",5972,5813,159,11444,36,53792
"Northwest Harbor CDP, New York",2445,2274,171,4771,36,53852
"Northwest Ithaca CDP, New York",785,772,13,1796,36,53853
"Norwich city, New York",3444,3040,404,6950,36,53979
"Norwood village, New York",569,551,18,1282,36,54012
"Noyack CDP, New York",2802,2664,138,4797,36,54056
"Nunda village, New York",497,487,10,1140,36,54078
"Nyack village, New York",4087,3690,397,7057,36,54100
"Oak Beach CDP, New York",92,92,0,123,36,54111
"Oakdale CDP, New York",4378,4163,215,7365,36,54144
"Oakfield village, New York",827,791,36,1683,36,54155
"Ocean Beach village, New York",14,14,0,26,36,54430
"Oceanside CDP, New York",17441,16419,1022,31488,36,54441
"Odessa village, New York",325,312,13,553,36,54452
"Ogdensburg city, New York",3788,3526,262,9902,36,54485
"Olcott CDP, New York",627,572,55,1041,36,54540
"Old Bethpage CDP, New York",3078,2971,107,5779,36,54551
"Old Brookville village, New York",872,844,28,1834,36,54562
"Old Field village, New York",533,515,18,1020,36,54617
"Old Forge CDP, New York",410,374,36,573,36,54639
"Old Westbury village, New York",2187,2027,160,4410,36,54705
"Olean city, New York",6529,6099,430,13890,36,54716
"Oneida city, New York",5202,5044,158,10326,36,54837
"Oneida Castle village, New York",379,368,11,699,36,54848
"Oneonta city, New York",6605,6367,238,14097,36,54881
"Ontario CDP, New York",1072,1051,21,2122,36,55002
"Orangeburg CDP, New York",2182,2051,131,4745,36,55167
"Orange Lake CDP, New York",5070,4869,201,10060,36,55189
"Orchard Park village, New York",1813,1735,78,3084,36,55266
"Orient CDP, New York",529,485,44,1220,36,55321
"Oriskany village, New York",599,586,13,1201,36,55365
"Oriskany Falls village, New York",326,317,9,655,36,55376
"Ossining village, New York",14414,13783,631,27076,36,55530
"Oswego city, New York",8246,7367,879,17092,36,55574
"Otego village, New York",394,394,0,845,36,55618
"Otisville village, New York",572,558,14,1431,36,55673
"Otter Lake CDP, New York",45,45,0,88,36,55750
"Ovid village, New York",269,257,12,464,36,55816
"Owego village, New York",1635,1584,51,3740,36,55882
"Oxbow CDP, New York",56,41,15,118,36,55937
"Oxford village, New York",675,630,45,1482,36,55948
"Oyster Bay CDP, New York",3790,3569,221,6640,36,55992
"Oyster Bay Cove village, New York",984,907,77,1942,36,56011
"Painted Post village, New York",968,899,69,1735,36,56088
"Palatine Bridge village, New York",307,295,12,701,36,56110
"Palenville CDP, New York",398,398,0,925,36,56132
"Palmyra village, New York",1953,1943,10,3326,36,56187
"Pamelia Center CDP, New York",263,231,32,770,36,56212
"Panama village, New York",247,245,2,484,36,56231
"Parc CDP, New York",43,6,37,171,36,56291
"Parish village, New York",305,286,19,555,36,56341
"Parishville CDP, New York",312,287,25,647,36,56363
"Patchogue village, New York",8143,7737,406,12343,36,56660
"Paul Smiths CDP, New York",254,212,42,616,36,56770
"Pavilion CDP, New York",452,406,46,715,36,56781
"Pawling village, New York",1146,1116,30,2021,36,56814
"Peach Lake CDP, New York",807,752,55,1349,36,56869
"Pearl River CDP, New York",8318,8051,267,16426,36,56902
"Peconic CDP, New York",314,314,0,793,36,56968
"Peekskill city, New York",14748,13394,1354,25401,36,56979
"Pelham village, New York",3801,3567,234,7261,36,57001
"Pelham Manor village, New York",2726,2583,143,5682,36,57023
"Penn Yan village, New York",2576,2492,84,5134,36,57177
"Perry village, New York",1698,1680,18,3533,36,57243
"Perrysburg CDP, New York",86,86,0,431,36,57287
"Peru CDP, New York",946,928,18,1807,36,57364
"Phelps village, New York",971,904,67,2212,36,57518
"Philadelphia village, New York",361,320,41,915,36,57551
"Philmont village, New York",765,697,68,1559,36,57639
"Phoenicia CDP, New York",142,142,0,266,36,57650
"Phoenix village, New York",1089,994,95,2440,36,57661
"Piermont village, New York",1637,1579,58,2507,36,57749
"Pierrepont Manor CDP, New York",185,185,0,369,36,57782
"Piffard CDP, New York",93,93,0,248,36,57804
"Pike CDP, New York",144,135,9,253,36,57815
"Pine Bush CDP, New York",877,717,160,1659,36,57980
"Pine Hill CDP, New York",185,185,0,360,36,58057
"Pine Plains CDP, New York",514,510,4,994,36,58145
"Pine Valley CDP, New York",278,273,5,609,36,58189
"Pittsford village, New York",926,908,18,1644,36,58354
"Plainedge CDP, New York",4950,4820,130,8963,36,58409
"Plainview CDP, New York",14026,13642,384,26620,36,58442
"Plandome village, New York",579,565,14,1365,36,58475
"Plandome Heights village, New York",520,511,9,938,36,58486
"Plandome Manor village, New York",291,279,12,665,36,58497
"Plattekill CDP, New York",772,762,10,1410,36,58541
"Plattsburgh city, New York",9971,9369,602,19907,36,58574
"Plattsburgh West CDP, New York",619,537,82,1307,36,58601
"Pleasant Valley CDP, New York",1174,1156,18,1848,36,58684
"Pleasantville village, New York",3990,3760,230,7430,36,58728
"Plessis CDP, New York",160,160,0,266,36,58739
"Poestenkill CDP, New York",496,496,0,754,36,58794
"Point Lookout CDP, New York",554,538,16,1110,36,58849
"Poland village, New York",307,301,6,602,36,58937
"Pomona village, New York",1828,1671,157,3837,36,58992
"Poquott village, New York",616,600,16,1107,36,59157
"Port Byron village, New York",460,438,22,1049,36,59212
"Port Chester village, New York",17582,16374,1208,31288,36,59223
"Port Dickinson village, New York",1045,1012,33,1976,36,59245
"Port Ewen CDP, New York",1664,1632,32,3441,36,59311
"Port Gibson CDP, New York",262,249,13,576,36,59322
"Port Henry CDP, New York",770,732,38,1602,36,59333
"Port Jefferson village, New York",4255,4131,124,7990,36,59355
"Port Jefferson Station CDP, New York",4144,3848,296,7974,36,59377
"Port Jervis city, New York",3952,3641,311,8725,36,59388
"Portlandville CDP, New York",41,41,0,116,36,59443
"Port Leyden village, New York",219,198,21,613,36,59454
"Portville village, New York",423,397,26,885,36,59498
"Port Washington CDP, New York",8415,8152,263,17015,36,59520
"Port Washington North village, New York",1471,1419,52,3169,36,59531
"Potsdam village, New York",3879,3518,361,8570,36,59564
"Pottersville CDP, New York",79,79,0,149,36,59619
"Poughkeepsie city, New York",16159,14978,1181,31717,36,59641
"Prattsburgh CDP, New York",365,349,16,659,36,59708
"Prattsville CDP, New York",36,30,6,98,36,59740
"Preston-Potter Hollow CDP, New York",239,227,12,466,36,59831
"Prospect CDP, New York",108,108,0,275,36,59883
"Pulaski village, New York",918,886,32,2090,36,59960
"Pultneyville CDP, New York",359,349,10,678,36,59993
"Putnam Lake CDP, New York",2126,1972,154,3826,36,60103
"Quiogue CDP, New York",473,435,38,787,36,60408
"Quogue village, New York",334,334,0,640,36,60422
"Radisson CDP, New York",3727,3620,107,7235,36,60455
"Randolph CDP, New York",384,375,9,858,36,60576
"Ransomville CDP, New York",887,856,31,1554,36,60598
"Rapids CDP, New York",604,567,37,1380,36,60609
"Ravena village, New York",2059,2000,59,3259,36,60675
"Red Creek village, New York",300,283,17,746,36,60829
"Redford CDP, New York",146,146,0,256,36,60884
"Red Hook village, New York",1004,978,26,1816,36,60895
"Red Oaks Mill CDP, New York",2343,2266,77,4135,36,60983
"Redwood CDP, New York",167,161,6,304,36,61016
"Remsen village, New York",192,190,2,410,36,61115
"Remsenburg-Speonk CDP, New York",826,826,0,1732,36,61142
"Rensselaer city, New York",5001,4867,134,9252,36,61148
"Rensselaer Falls village, New York",182,171,11,382,36,61159
"Retsof CDP, New York",191,191,0,236,36,61236
"Rhinebeck village, New York",1373,1290,83,2693,36,61346
"Rhinecliff CDP, New York",225,217,8,386,36,61368
"Richburg village, New York",237,227,10,573,36,61434
"Richfield Springs village, New York",585,577,8,1240,36,61489
"Richmondville village, New York",478,462,16,983,36,61588
"Richville village, New York",114,110,4,272,36,61621
"Ridge CDP, New York",6280,5987,293,12987,36,61665
"Rifton CDP, New York",161,161,0,548,36,61797
"Ripley CDP, New York",430,421,9,964,36,61874
"Riverhead CDP, New York",6742,6125,617,14388,36,61973
"Riverside village, New York",281,276,5,594,36,62061
"Riverside CDP, New York",1024,855,169,2945,36,62066
"Rochester city, New York",104722,95867,8855,210992,36,63000
"Rochester Institute of Technology CDP, New York",2472,2200,272,5901,36,63014
"Rock Hill CDP, New York",1049,963,86,2384,36,63132
"Rockville Centre village, New York",13517,12828,689,25784,36,63264
"Rocky Point CDP, New York",7780,7280,500,13716,36,63319
"Rodman CDP, New York",91,78,13,193,36,63330
"Roessleville CDP, New York",6457,6194,263,11583,36,63363
"Rome city, New York",13767,13085,682,32031,36,63418
"Romulus CDP, New York",171,153,18,383,36,63429
"Ronkonkoma CDP, New York",11189,10379,810,18838,36,63473
"Roosevelt CDP, New York",10777,10280,497,19233,36,63506
"Roscoe CDP, New York",172,172,0,442,36,63583
"Rosendale CDP, New York",560,540,20,901,36,63725
"Roslyn village, New York",1470,1461,9,2928,36,63770
"Roslyn Estates village, New York",639,625,14,1350,36,63792
"Roslyn Harbor village, New York",466,443,23,984,36,63803
"Roslyn Heights CDP, New York",3594,3452,142,6915,36,63814
"Rotterdam CDP, New York",12014,11666,348,22673,36,63924
"Round Lake village, New York",408,397,11,822,36,63957
"Round Top CDP, New York",289,289,0,663,36,63968
"Rouses Point village, New York",1135,1071,64,2530,36,63979
"Ruby CDP, New York",604,579,25,996,36,64056
"Rushford CDP, New York",175,172,3,483,36,64155
"Rushville village, New York",216,203,13,547,36,64199
"Russell Gardens village, New York",552,539,13,1100,36,64232
"Rye city, New York",7983,7571,412,16447,36,64309
"Rye Brook village, New York",4834,4376,458,9920,36,64325
"Sackets Harbor village, New York",633,619,14,1531,36,64408
"Saddle Rock village, New York",469,466,3,1207,36,64430
"Saddle Rock Estates CDP, New York",174,174,0,642,36,64441
"Sagaponack village, New York",127,127,0,344,36,64452
"Sag Harbor village, New York",1291,1281,10,2587,36,64485
"St. Bonaventure CDP, New York",764,721,43,2093,36,64551
"St. James CDP, New York",7198,6879,319,13733,36,64584
"St. John Fisher College CDP, New York",538,491,47,1276,36,64606
"St. Johnsville village, New York",692,661,31,1771,36,64639
"St. Regis Falls CDP, New York",116,108,8,284,36,64716
"Salamanca city, New York",2531,2333,198,5906,36,64749
"Salem CDP, New York",535,478,57,854,36,64771
"Salisbury CDP, New York",6600,6393,207,12861,36,64842
"Salisbury Center CDP, New York",119,116,3,255,36,64848
"Salisbury Mills CDP, New York",152,133,19,288,36,64859
"Saltaire village, New York",2,2,0,2,36,64881
"Salt Point CDP, New York",222,201,21,306,36,64892
"Sanborn CDP, New York",870,850,20,1499,36,64958
"Sand Ridge CDP, New York",457,387,70,1111,36,65024
"Sands Point village, New York",1200,1134,66,2702,36,65035
"Sandy Creek village, New York",288,272,16,567,36,65068
"Saranac Lake village, New York",2687,2613,74,5079,36,65233
"Saratoga Springs city, New York",15664,15248,416,28505,36,65255
"Saugerties village, New York",1908,1844,64,3892,36,65288
"Saugerties South CDP, New York",1200,1114,86,2224,36,65310
"Savannah CDP, New York",158,135,23,401,36,65332
"Savona village, New York",333,298,35,673,36,65354
"Sayville CDP, New York",8283,8124,159,16145,36,65409
"Scarsdale village, New York",8135,7765,370,18061,36,65431
"Schaghticoke village, New York",306,287,19,631,36,65475
"Schenectady city, New York",34326,31115,3211,68476,36,65508
"Schenevus CDP, New York",224,224,0,487,36,65519
"Schoharie village, New York",354,342,12,956,36,65585
"Schroon Lake CDP, New York",405,399,6,926,36,65640
"Schuyler Lake CDP, New York",23,23,0,82,36,65739
"Schuylerville village, New York",908,881,27,1640,36,65750
"Scio CDP, New York",276,240,36,589,36,65761
"Scotchtown CDP, New York",5980,5727,253,10353,36,65882
"Scotia village, New York",4106,4016,90,7292,36,65893
"Scottsburg CDP, New York",46,46,0,89,36,65926
"Scotts Corners CDP, New York",424,416,8,620,36,65948
"Scottsville village, New York",1446,1391,55,2482,36,65959
"Sea Cliff village, New York",2684,2356,328,5062,36,66047
"Seaford CDP, New York",8799,8300,499,15853,36,66058
"Searingtown CDP, New York",2480,2383,97,4700,36,66102
"Selden CDP, New York",11337,10768,569,21759,36,66212
"Seneca Falls CDP, New York",3655,3460,195,6895,36,66322
"Seneca Knolls CDP, New York",1026,923,103,2085,36,66366
"Setauket CDP, New York",2066,1988,78,3739,36,66465
"Sharon Springs village, New York",219,215,4,632,36,66663
"Shelter Island CDP, New York",1242,1171,71,2564,36,66828
"Shelter Island Heights CDP, New York",411,406,5,1056,36,66850
"Shenorock CDP, New York",1044,980,64,1883,36,66872
"Sherburne village, New York",499,468,31,1186,36,66883
"Sherman village, New York",232,225,7,567,36,66949
"Sherrill city, New York",1438,1392,46,3057,36,66993
"Shinnecock Hills CDP, New York",948,884,64,2135,36,67048
"Shirley CDP, New York",13507,12645,862,26498,36,67070
"Shokan CDP, New York",728,555,173,1294,36,67081
"Shoreham village, New York",269,261,8,591,36,67191
"Shorehaven CDP, New York",261,240,21,396,36,67207
"Shortsville village, New York",999,986,13,1745,36,67257
"Shrub Oak CDP, New York",1902,1688,214,3002,36,67279
"Sidney village, New York",1677,1489,188,3750,36,67334
"Siena College CDP, New York",967,915,52,2292,36,67367
"Silver Creek village, New York",1314,1230,84,2623,36,67411
"Silver Springs village, New York",314,300,14,615,36,67466
"Sinclairville village, New York",229,224,5,595,36,67488
"Skaneateles village, New York",1114,1087,27,2539,36,67510
"Slaterville Springs CDP, New York",104,92,12,230,36,67631
"Sleepy Hollow village, New York",5584,5124,460,10396,36,67638
"Sleepy Hollow Lake CDP, New York",889,861,28,1636,36,67640
"Sloan village, New York",1913,1851,62,3762,36,67686
"Sloatsburg village, New York",1504,1425,79,3039,36,67708
"Smallwood CDP, New York",184,184,0,666,36,67730
"Smithtown CDP, New York",13495,13010,485,25588,36,67851
"Smithville Flats CDP, New York",179,172,7,344,36,68088
"Smyrna village, New York",84,80,4,193,36,68099
"Sodus village, New York",1046,962,84,1917,36,68209
"Sodus Point village, New York",498,483,15,1096,36,68242
"Solvay village, New York",3339,3154,185,6607,36,68286
"Sound Beach CDP, New York",3947,3734,213,7154,36,68374
"Southampton village, New York",2473,2258,215,4481,36,68462
"South Blooming Grove village, New York",1429,1243,186,3858,36,68610
"South Cairo CDP, New York",380,380,0,550,36,68737
"South Corning village, New York",533,471,62,966,36,68847
"South Dayton village, New York",258,254,4,606,36,68891
"South Edmeston CDP, New York",92,92,0,156,36,68946
"South Fallsburg CDP, New York",775,775,0,1938,36,68968
"South Farmingdale CDP, New York",8394,7896,498,15028,36,69001
"South Floral Park village, New York",1061,1039,22,1928,36,69023
"South Glens Falls village, New York",2279,2115,164,3739,36,69078
"South Hempstead CDP, New York",1705,1671,34,3135,36,69188
"South Hill CDP, New York",2258,2179,79,6613,36,69199
"South Huntington CDP, New York",5982,5530,452,10307,36,69254
"South Ilion CDP, New York",77,77,0,197,36,69265
"South Lansing CDP, New York",509,509,0,910,36,69342
"South Lima CDP, New York",221,215,6,291,36,69364
"South Lockport CDP, New York",4493,4170,323,8403,36,69386
"South Nyack village, New York",1675,1513,162,2745,36,69441
"Southold CDP, New York",2870,2625,245,6386,36,69452
"Southport CDP, New York",3639,3411,228,6661,36,69606
"South Valley Stream CDP, New York",3332,3151,181,6529,36,69892
"Spackenkill CDP, New York",2573,2419,154,4336,36,70035
"Sparkill CDP, New York",768,750,18,1125,36,70068
"Sparrow Bush CDP, New York",613,522,91,1272,36,70090
"Speculator village, New York",170,161,9,388,36,70123
"Spencer village, New York",392,375,17,839,36,70167
"Spencerport village, New York",2238,2163,75,3670,36,70189
"Springfield Center CDP, New York",166,164,2,300,36,70321
"Springs CDP, New York",5203,5122,81,9162,36,70387
"Spring Valley village, New York",14786,13963,823,32963,36,70420
"Springville village, New York",1978,1882,96,4223,36,70442
"Springwater CDP, New York",154,142,12,394,36,70464
"Staatsburg CDP, New York",259,234,25,410,36,70552
"Stamford village, New York",538,477,61,1155,36,70618
"Stannards CDP, New York",284,249,35,616,36,70717
"Star Lake CDP, New York",242,235,7,649,36,70849
"Stewart Manor village, New York",1258,1164,94,2244,36,71267
"Stillwater village, New York",1135,1105,30,1756,36,71322
"Stittville CDP, New York",221,221,0,329,36,71377
"Stone Ridge CDP, New York",818,756,62,1900,36,71597
"Stony Brook CDP, New York",6466,6228,238,12501,36,71608
"Stony Brook University CDP, New York",3116,2722,394,8755,36,71620
"Stony Point CDP, New York",6573,6165,408,12533,36,71663
"Stottville CDP, New York",604,593,11,1186,36,71718
"Strykersville CDP, New York",295,295,0,523,36,71817
"Suffern village, New York",6305,5961,344,11376,36,71894
"Sunset Bay CDP, New York",97,85,12,366,36,72246
"SUNY Oswego CDP, New York",1399,1066,333,3338,36,72327
"Swan Lake CDP, New York",97,97,0,249,36,72400
"Sylvan Beach village, New York",326,294,32,856,36,72521
"Syosset CDP, New York",9194,8832,362,18807,36,72554
"Syracuse city, New York",67481,61679,5802,146134,36,73000
"Taconic Shores CDP, New York",429,429,0,652,36,73057
"Tannersville village, New York",207,191,16,466,36,73143
"Tappan CDP, New York",4167,3817,350,7016,36,73154
"Tarrytown village, New York",6373,6194,179,11776,36,73176
"Terryville CDP, New York",5695,5332,363,10890,36,73352
"Thendara CDP, New York",63,63,0,228,36,73495
"Theresa village, New York",638,612,26,919,36,73517
"Thiells CDP, New York",2420,2394,26,4491,36,73583
"Thomaston village, New York",1389,1344,45,2750,36,73605
"Thornwood CDP, New York",2427,2396,31,4396,36,73715
"Thousand Island Park CDP, New York",113,101,12,216,36,73726
"Three Mile Bay CDP, New York",19,19,0,63,36,73737
"Ticonderoga CDP, New York",1572,1466,106,3399,36,73880
"Tillson CDP, New York",1188,1176,12,1782,36,73902
"Tioga Terrace CDP, New York",1105,1095,10,2348,36,73990
"Titusville CDP, New York",289,289,0,613,36,74017
"Tivoli village, New York",421,375,46,802,36,74023
"Tonawanda city, New York",7672,7185,487,15096,36,74166
"Tonawanda Town CDP, New York",32024,30764,1260,57210,36,75021
"Town Line CDP, New York",947,931,16,1951,36,75121
"Tribes Hill CDP, New York",358,358,0,838,36,75341
"Troy city, New York",26348,23798,2550,51268,36,75484
"Trumansburg village, New York",659,635,24,1485,36,75506
"Tuckahoe CDP, New York",634,610,24,1200,36,75572
"Tuckahoe village, New York",3918,3831,87,6995,36,75583
"Tully village, New York",513,497,16,985,36,75627
"Tupper Lake village, New York",1383,1316,67,2804,36,75671
"Turin village, New York",156,147,9,370,36,75682
"Tuscarora CDP, New York",104,104,0,167,36,75726
"Tuxedo village, New York",1622,1587,35,3072,36,75779
"Tuxedo Park village, New York",398,391,7,700,36,75803
"Unadilla village, New York",485,451,34,945,36,76001
"Unadilla Forks CDP, New York",106,86,20,199,36,76023
"Uniondale CDP, New York",16463,15403,1060,33192,36,76089
"Union Springs village, New York",642,610,32,1280,36,76155
"Unionville village, New York",376,376,0,670,36,76210
"University at Buffalo CDP, New York",1317,1290,27,6189,36,76280
"University Gardens CDP, New York",2259,2147,112,4171,36,76287
"Upper Brookville village, New York",1013,965,48,1880,36,76331
"Upper Nyack village, New York",1111,1041,70,2142,36,76386
"Upper Red Hook CDP, New York",36,36,0,89,36,76397
"Utica city, New York",27841,25892,1949,64728,36,76540
"Vails Gate CDP, New York",1572,1506,66,2881,36,76584
"Valatie village, New York",774,719,55,1668,36,76617
"Valhalla CDP, New York",1535,1467,68,3052,36,76639
"Valley Cottage CDP, New York",5279,4842,437,9069,36,76661
"Valley Falls village, New York",267,258,9,461,36,76672
"Valley Stream village, New York",22503,21363,1140,40288,36,76705
"Van Etten CDP, New York",238,234,4,476,36,76881
"Varna CDP, New York",555,531,24,699,36,76969
"Vassar College CDP, New York",1606,1564,42,3012,36,76985
"Vernon village, New York",760,753,7,1300,36,77112
"Verona CDP, New York",780,596,184,1363,36,77167
"Verplanck CDP, New York",481,417,64,796,36,77211
"Victor village, New York",1326,1308,18,2722,36,77376
"Victory village, New York",344,326,18,694,36,77431
"Village Green CDP, New York",2086,1964,122,3747,36,77513
"Village of the Branch village, New York",872,823,49,1747,36,77519
"Viola CDP, New York",2951,2581,370,7385,36,77574
"Virgil CDP, New York",146,139,7,232,36,77585
"Voorheesville village, New York",1470,1426,44,2840,36,77684
"Waddington village, New York",408,389,19,1060,36,77728
"Wading River CDP, New York",4425,4225,200,8100,36,77772
"Wadsworth CDP, New York",75,54,21,148,36,77783
"Wainscott CDP, New York",311,294,17,585,36,77805
"Walden village, New York",3270,3081,189,6861,36,77849
"Walker Valley CDP, New York",828,822,6,1440,36,77948
"Wallkill CDP, New York",938,899,39,1859,36,78003
"Walton village, New York",1364,1275,89,2811,36,78036
"Walton Park CDP, New York",2288,2174,114,4139,36,78063
"Walworth CDP, New York",501,470,31,865,36,78091
"Wampsville village, New York",261,251,10,590,36,78113
"Wanakah CDP, New York",1641,1590,51,3158,36,78124
"Wantagh CDP, New York",9310,8967,343,17995,36,78146
"Wappingers Falls village, New York",2858,2750,108,5775,36,78168
"Warrensburg CDP, New York",1539,1539,0,3307,36,78289
"Warsaw village, New York",1332,1215,117,2937,36,78333
"Warwick village, New York",3484,3405,79,6653,36,78355
"Washington Heights CDP, New York",761,693,68,1572,36,78421
"Washington Mills CDP, New York",1287,1273,14,1910,36,78454
"Washingtonville village, New York",3086,2897,189,5733,36,78465
"Wassaic CDP, New York",163,129,34,466,36,78476
"Watchtower CDP, New York",0,0,0,545,36,78487
"Waterford village, New York",1133,1080,53,2113,36,78520
"Waterloo village, New York",2275,2132,143,4587,36,78553
"Water Mill CDP, New York",1464,1305,159,2308,36,78575
"Watertown city, New York",11325,10610,715,24859,36,78608
"Waterville village, New York",967,956,11,1748,36,78663
"Watervliet city, New York",5430,5174,256,10325,36,78674
"Watkins Glen village, New York",889,833,56,1777,36,78696
"Waverly village, New York",2229,2062,167,4360,36,78806
"Wayland village, New York",756,718,38,1696,36,78850
"Webster village, New York",3207,3058,149,5725,36,78960
"Websters Crossing CDP, New York",91,91,0,124,36,78982
"Weedsport village, New York",858,851,7,1858,36,79015
"Wells CDP, New York",200,183,17,571,36,79048
"Wells Bridge CDP, New York",176,176,0,244,36,79070
"Wellsburg village, New York",233,216,17,440,36,79081
"Wellsville village, New York",2036,1930,106,4871,36,79092
"Wesley Hills village, New York",2330,2290,40,6123,36,79174
"West Babylon CDP, New York",24448,22756,1692,42783,36,79246
"West Bay Shore CDP, New York",2333,2238,95,4472,36,79301
"Westbury village, New York",8884,8603,281,15788,36,79444
"West Carthage village, New York",672,666,6,1632,36,79499
"West Chazy CDP, New York",196,196,0,481,36,79543
"West Danby CDP, New York",162,162,0,221,36,79697
"West Elmira CDP, New York",2656,2544,112,4796,36,79785
"West End CDP, New York",1065,1028,37,2142,36,79796
"Westernville CDP, New York",73,61,12,191,36,79895
"Westfield village, New York",1062,988,74,2714,36,79939
"Westford CDP, New York",51,44,7,88,36,79961
"West Glens Falls CDP, New York",5358,5223,135,9565,36,80082
"Westhampton CDP, New York",1566,1499,67,3769,36,80170
"Westhampton Beach village, New York",1223,1178,45,2344,36,80181
"West Hampton Dunes village, New York",73,72,1,130,36,80186
"West Haverstraw village, New York",5820,5449,371,10649,36,80203
"West Hempstead CDP, New York",10486,9865,621,20393,36,80225
"West Hills CDP, New York",2911,2818,93,5140,36,80258
"West Hurley CDP, New York",786,763,23,1608,36,80291
"West Islip CDP, New York",15951,15295,656,27192,36,80302
"West Kill CDP, New York",31,31,0,54,36,80324
"Westmere CDP, New York",4472,4449,23,7798,36,80423
"Westmoreland CDP, New York",57,57,0,76,36,80522
"West Nyack CDP, New York",1649,1596,53,3768,36,80599
"Weston Mills CDP, New York",587,519,68,1259,36,80632
"West Point CDP, New York",1263,1223,40,6386,36,80747
"Westport CDP, New York",115,115,0,251,36,80764
"West Sand Lake CDP, New York",1760,1689,71,3304,36,80863
"West Sayville CDP, New York",2738,2636,102,5032,36,80885
"West Seneca CDP, New York",25314,24206,1108,45387,36,80907
"Westvale CDP, New York",2458,2423,35,4933,36,81127
"West Valley CDP, New York",202,202,0,495,36,81138
"West Winfield village, New York",460,450,10,843,36,81292
"Wheatley Heights CDP, New York",2699,2616,83,5338,36,81419
"Whitehall village, New York",1036,911,125,2166,36,81622
"White Lake CDP (Oneida County), New York",44,40,4,114,36,81644
"White Lake CDP (Sullivan County), New York",55,55,0,85,36,81655
"White Plains city, New York",32744,30986,1758,59421,36,81677
"Whitesboro village, New York",1961,1780,181,3673,36,81710
"Whitney Point village, New York",556,396,160,1116,36,81831
"Williamson CDP, New York",1085,1023,62,2560,36,82029
"Williamsville village, New York",3065,3014,51,5411,36,82084
"Williston Park village, New York",3671,3511,160,7543,36,82117
"Willsboro CDP, New York",328,328,0,753,36,82260
"Willsboro Point CDP, New York",417,398,19,603,36,82282
"Wilmington CDP, New York",531,531,0,931,36,82304
"Wilson village, New York",595,553,42,1371,36,82359
"Windham CDP, New York",117,117,0,303,36,82469
"Windsor village, New York",539,477,62,1081,36,82524
"Wingdale CDP, New York",532,456,76,1292,36,82579
"Winthrop CDP, New York",125,125,0,235,36,82612
"Witherbee CDP, New York",39,39,0,206,36,82656
"Wolcott village, New York",663,621,42,1322,36,82678
"Woodbourne CDP, New York",266,266,0,468,36,82733
"Woodbury CDP, New York",3832,3763,69,9169,36,82744
"Woodbury village, New York",5931,5544,387,11371,36,82750
"Woodmere CDP, New York",8224,7845,379,17632,36,82942
"Woodridge village, New York",363,301,62,936,36,82953
"Woodsburgh village, New York",474,461,13,887,36,82986
"Woodstock CDP, New York",1220,1122,98,2873,36,83041
"Woodsville CDP, New York",29,29,0,67,36,83063
"Worcester CDP, New York",323,323,0,733,36,83118
"Wurtsboro village, New York",546,521,25,1218,36,83272
"Wurtsboro Hills CDP, New York",173,149,24,354,36,83283
"Wyandanch CDP, New York",6947,6552,395,13601,36,83294
"Wynantskill CDP, New York",1952,1921,31,3683,36,83349
"Wyoming village, New York",218,208,10,366,36,83371
"Yaphank CDP, New York",3917,3818,99,6229,36,83426
"Yonkers city, New York",109565,102288,7277,209780,36,84000
"York CDP, New York",175,175,0,345,36,84011
"Yorkshire CDP, New York",448,411,37,1057,36,84044
"Yorktown Heights CDP, New York",1211,1100,111,2147,36,84088
"Yorkville village, New York",1467,1387,80,2635,36,84099
"Youngstown village, New York",895,832,63,1965,36,84143
"Zena CDP, New York",400,392,8,726,36,84187
"Aberdeen town, North Carolina",4038,3888,150,8674,37,00160
"Advance CDP, North Carolina",673,673,0,1605,37,00440
"Ahoskie town, North Carolina",2043,1799,244,4841,37,00500
"Alamance village, North Carolina",570,569,1,1287,37,00640
"Albemarle city, North Carolina",7813,7298,515,16444,37,00680
"Alexis CDP, North Carolina",228,221,7,570,37,00880
"Alliance town, North Carolina",259,241,18,842,37,01000
"Altamahaw CDP, North Carolina",278,251,27,424,37,01140
"Anderson Creek CDP, North Carolina",5131,4756,375,14447,37,01340
"Andrews town, North Carolina",951,828,123,2086,37,01380
"Angier town, North Carolina",2642,2553,89,5348,37,01400
"Ansonville town, North Carolina",358,349,9,671,37,01420
"Apex town, North Carolina",35784,34325,1459,65541,37,01520
"Aquadale CDP, North Carolina",305,305,0,409,37,01560
"Arapahoe town, North Carolina",190,180,10,364,37,01640
"Archdale city, North Carolina",6176,6078,98,11873,37,01720
"Archer Lodge town, North Carolina",2985,2985,0,4894,37,01760
"Arrowhead Beach CDP, North Carolina",266,257,9,1243,37,01972
"Asheboro city, North Carolina",12118,11455,663,27117,37,02080
"Asheville city, North Carolina",50387,48338,2049,93695,37,02140
"Ashley Heights CDP, North Carolina",200,169,31,365,37,02240
"Askewville town, North Carolina",74,74,0,184,37,02320
"Atkinson town, North Carolina",181,172,9,410,37,02460
"Atlantic CDP, North Carolina",221,211,10,534,37,02480
"Atlantic Beach town, North Carolina",670,647,23,1736,37,02500
"Aulander town, North Carolina",277,242,35,704,37,02580
"Aurora town, North Carolina",251,205,46,522,37,02620
"Autryville town, North Carolina",50,46,4,134,37,02700
"Avery Creek CDP, North Carolina",2008,2008,0,3338,37,02760
"Avon CDP, North Carolina",210,141,69,370,37,02780
"Ayden town, North Carolina",1971,1936,35,5002,37,02840
"Badin town, North Carolina",476,422,54,2075,37,02960
"Bailey town, North Carolina",240,228,12,459,37,03020
"Bakersville town, North Carolina",320,188,132,728,37,03100
"Bald Head Island village, North Carolina",26,26,0,138,37,03150
"Balfour CDP, North Carolina",713,713,0,1142,37,03220
"Banner Elk town, North Carolina",455,424,31,1234,37,03500
"Barker Heights CDP, North Carolina",508,502,6,978,37,03640
"Barker Ten Mile CDP, North Carolina",402,402,0,769,37,03665
"Barnardsville CDP, North Carolina",134,115,19,420,37,03720
"Bath town, North Carolina",79,78,1,236,37,03840
"Bayboro town, North Carolina",193,188,5,1209,37,03960
"Bayshore CDP, North Carolina",1825,1787,38,3066,37,04015
"Bayview CDP, North Carolina",225,225,0,398,37,04040
"Bear Grass town, North Carolina",50,50,0,129,37,04180
"Beaufort town, North Carolina",1979,1852,127,4534,37,04260
"Beech Mountain town, North Carolina",320,291,29,798,37,04510
"Belhaven town, North Carolina",492,437,55,1378,37,04640
"Bell Arthur CDP, North Carolina",257,215,42,491,37,04680
"Belmont city, North Carolina",7963,7610,353,14842,37,04840
"Belville town, North Carolina",1965,1821,144,3380,37,04950
"Belvoir CDP, North Carolina",88,88,0,169,37,04955
"Belwood town, North Carolina",372,359,13,1103,37,04960
"Bennett CDP, North Carolina",102,102,0,228,37,05020
"Benson town, North Carolina",1763,1718,45,4004,37,05040
"Bent Creek CDP, North Carolina",902,778,124,1536,37,05049
"Bermuda Run town, North Carolina",1007,1007,0,3118,37,05135
"Bessemer City city, North Carolina",2864,2689,175,5472,37,05220
"Bethania town, North Carolina",134,129,5,335,37,05340
"Bethel town, North Carolina",784,725,59,1604,37,05460
"Bethlehem CDP, North Carolina",1845,1791,54,3688,37,05530
"Beulaville town, North Carolina",563,546,17,1439,37,05660
"Biltmore Forest town, North Carolina",694,677,17,1700,37,05880
"Biscoe town, North Carolina",1004,993,11,2595,37,06000
"Black Creek town, North Carolina",422,381,41,758,37,06080
"Black Mountain town, North Carolina",3328,3290,38,8430,37,06140
"Bladenboro town, North Carolina",844,792,52,2485,37,06240
"Blowing Rock town, North Carolina",519,516,3,900,37,06500
"Blue Clay Farms CDP, North Carolina",49,49,0,124,37,06510
"Boardman town, North Carolina",140,130,10,238,37,06660
"Bogue town, North Carolina",414,414,0,815,37,06740
"Boiling Spring Lakes city, North Carolina",2890,2711,179,6032,37,06760
"Boiling Springs town, North Carolina",2028,1928,100,4622,37,06800
"Bolivia town, North Carolina",76,66,10,197,37,06820
"Bolton town, North Carolina",243,151,92,581,37,06860
"Bonnetsville CDP, North Carolina",381,364,17,1297,37,06980
"Boone town, North Carolina",9936,8283,1653,19368,37,07080
"Boonville town, North Carolina",532,532,0,1364,37,07140
"Bostic town, North Carolina",153,142,11,304,37,07220
"Bowdens CDP, North Carolina",147,131,16,271,37,07340
"Bowmore CDP, North Carolina",50,50,0,65,37,07400
"Brandywine Bay CDP, North Carolina",540,471,69,1339,37,07588
"Brevard city, North Carolina",3479,3284,195,7777,37,07720
"Briar Chapel CDP, North Carolina",2533,2294,239,5332,37,07748
"Brices Creek CDP, North Carolina",1706,1687,19,3678,37,07765
"Bridgeton town, North Carolina",181,172,9,532,37,07860
"Broad Creek CDP, North Carolina",889,854,35,2013,37,08040
"Broadway town, North Carolina",716,695,21,1415,37,08080
"Brogden CDP, North Carolina",1129,1011,118,2744,37,08110
"Brookford town, North Carolina",203,171,32,435,37,08140
"Brunswick town, North Carolina",230,216,14,1233,37,08420
"Bryson City town, North Carolina",718,711,7,1638,37,08480
"Buies Creek CDP, North Carolina",1567,1545,22,3589,37,08760
"Bunn town, North Carolina",243,243,0,478,37,08860
"Bunnlevel CDP, North Carolina",565,565,0,1011,37,08880
"Burgaw town, North Carolina",1221,1040,181,3207,37,08960
"Burlington city, North Carolina",28606,26982,1624,56951,37,09060
"Burnsville town, North Carolina",959,901,58,2380,37,09140
"Butner town, North Carolina",3227,3031,196,8374,37,09360
"Butters CDP, North Carolina",87,87,0,164,37,09380
"Buxton CDP, North Carolina",907,880,27,1477,37,09400
"Cajah's Mountain town, North Carolina",1347,1278,69,2715,37,09530
"Calabash town, North Carolina",1186,1090,96,2570,37,09540
"Calypso town, North Carolina",272,252,20,429,37,09760
"Camden CDP, North Carolina",594,553,41,960,37,09780
"Cameron town, North Carolina",260,255,5,427,37,09800
"Candor town, North Carolina",478,476,2,1168,37,10120
"Canton town, North Carolina",2387,2362,25,4410,37,10240
"Cape Carteret town, North Carolina",1072,1053,19,2651,37,10260
"Cape Colony CDP, North Carolina",218,218,0,493,37,10264
"Caroleen CDP, North Carolina",183,183,0,377,37,10460
"Carolina Beach town, North Carolina",3612,3292,320,6583,37,10500
"Carolina Meadows CDP, North Carolina",0,0,0,576,37,10532
"Carolina Shores town, North Carolina",1729,1596,133,4643,37,10550
"Carrboro town, North Carolina",12470,12026,444,21242,37,10620
"Carthage town, North Carolina",1303,1277,26,2779,37,10680
"Cary town, North Carolina",96502,93260,3242,174880,37,10740
"Casar town, North Carolina",235,184,51,391,37,10760
"Cashiers CDP, North Carolina",480,480,0,752,37,10800
"Castalia town, North Carolina",95,89,6,257,37,10860
"Castle Hayne CDP, North Carolina",502,482,20,970,37,10880
"Caswell Beach town, North Carolina",226,224,2,489,37,10960
"Catawba town, North Carolina",287,272,15,630,37,10980
"Cedar Point town, North Carolina",901,864,37,2198,37,11340
"Cedar Rock village, North Carolina",188,185,3,409,37,11352
"Centerville CDP, North Carolina",110,110,0,261,37,11560
"Cerro Gordo town, North Carolina",143,143,0,352,37,11620
"Chadbourn town, North Carolina",463,441,22,1548,37,11640
"Chapel Hill town, North Carolina",29630,28240,1390,58919,37,11800
"Charlotte city, North Carolina",500911,477149,23762,875045,37,12000
"Cherokee CDP, North Carolina",628,618,10,1604,37,12140
"Cherry Branch CDP, North Carolina",618,574,44,1281,37,12186
"Cherryville city, North Carolina",2735,2638,97,6113,37,12340
"Chimney Rock Village village, North Carolina",88,88,0,220,37,12460
"China Grove town, North Carolina",2249,2063,186,4449,37,12480
"Chinquapin CDP, North Carolina",0,0,0,7,37,12520
"Chocowinity town, North Carolina",448,363,85,1059,37,12580
"Chowan Beach CDP, North Carolina",79,32,47,382,37,12590
"Claremont city, North Carolina",1080,1058,22,1902,37,12720
"Clarkton town, North Carolina",220,209,11,822,37,12780
"Clayton town, North Carolina",14071,13818,253,26837,37,12860
"Clemmons village, North Carolina",10454,9930,524,21281,37,12960
"Cleveland town, North Carolina",561,516,45,1244,37,13000
"Cliffside CDP, North Carolina",87,87,0,424,37,13100
"Clinton city, North Carolina",3105,2963,142,8362,37,13240
"Clyde town, North Carolina",712,685,27,1424,37,13280
"Coats town, North Carolina",1039,991,48,2324,37,13360
"Cofield village, North Carolina",194,160,34,384,37,13460
"Coinjock CDP, North Carolina",193,193,0,301,37,13500
"Colerain town, North Carolina",133,115,18,257,37,13560
"Columbia town, North Carolina",208,199,9,560,37,13940
"Columbus town, North Carolina",466,451,15,1087,37,13980
"Como town, North Carolina",61,46,15,85,37,14060
"Concord city, North Carolina",56392,53735,2657,105335,37,14100
"Conetoe town, North Carolina",168,164,4,671,37,14200
"Connelly Springs town, North Carolina",878,818,60,2355,37,14280
"Conover city, North Carolina",3717,3585,132,8457,37,14340
"Conway town, North Carolina",353,308,45,884,37,14400
"Cooleemee town, North Carolina",443,428,15,875,37,14460
"Cordova CDP, North Carolina",782,522,260,1320,37,14600
"Cornelius town, North Carolina",16696,16127,569,31396,37,14700
"Cove City town, North Carolina",251,249,2,633,37,15020
"Cove Creek CDP, North Carolina",907,897,10,1354,37,15040
"Cramerton town, North Carolina",3088,2944,144,5294,37,15260
"Creedmoor city, North Carolina",2437,2303,134,4871,37,15320
"Creswell town, North Carolina",62,62,0,152,37,15420
"Cricket CDP, North Carolina",1229,1145,84,2491,37,15440
"Crossnore town, North Carolina",27,27,0,139,37,15580
"Crouse CDP, North Carolina",60,60,0,179,37,15640
"Cullowhee CDP, North Carolina",3707,3271,436,6715,37,15880
"Cypress Landing CDP, North Carolina",292,292,0,1052,37,16084
"Dallas town, North Carolina",3205,3072,133,5889,37,16180
"Dana CDP, North Carolina",1591,1488,103,3629,37,16220
"Danbury town, North Carolina",152,143,9,293,37,16240
"Davidson town, North Carolina",7601,7421,180,15199,37,16400
"Davis CDP, North Carolina",148,148,0,275,37,16480
"Deep Run CDP, North Carolina",162,162,0,484,37,16720
"Deercroft CDP, North Carolina",228,228,0,448,37,16730
"Delco CDP, North Carolina",70,70,0,123,37,16780
"Dellview town, North Carolina",0,0,0,25,37,16820
"Delway CDP, North Carolina",3,3,0,37,37,16860
"Denton town, North Carolina",631,588,43,1307,37,16980
"Denver CDP, North Carolina",1470,1416,54,2739,37,17000
"Dillsboro town, North Carolina",120,120,0,231,37,17180
"Dobbins Heights town, North Carolina",321,215,106,645,37,17325
"Dobson town, North Carolina",751,707,44,1812,37,17340
"Dortches town, North Carolina",453,431,22,976,37,17520
"Dover town, North Carolina",211,193,18,441,37,17660
"Drexel town, North Carolina",854,815,39,1768,37,17860
"Dublin town, North Carolina",149,144,5,444,37,18040
"Duck town, North Carolina",288,284,4,686,37,18060
"Dudley CDP, North Carolina",646,646,0,1996,37,18080
"Dundarrach CDP, North Carolina",17,17,0,52,37,18300
"Dunn city, North Carolina",3608,3473,135,8549,37,18320
"Durham city, North Carolina",161325,154398,6927,284094,37,19000
"Earl town, North Carolina",181,171,10,358,37,19140
"East Arcadia town, North Carolina",165,137,28,337,37,19300
"East Bend town, North Carolina",381,365,16,741,37,19320
"East Flat Rock CDP, North Carolina",3267,3130,137,5934,37,19420
"East Laurinburg town, North Carolina",125,93,32,322,37,19620
"Eastover town, North Carolina",1511,1417,94,3659,37,19740
"East Rockingham CDP, North Carolina",1365,1195,170,3328,37,19800
"East Spencer town, North Carolina",436,401,35,1216,37,19860
"Eden city, North Carolina",6923,6511,412,15349,37,20080
"Edenton town, North Carolina",2084,1954,130,4512,37,20120
"Edneyville CDP, North Carolina",1596,1580,16,2829,37,20280
"Efland CDP, North Carolina",428,428,0,825,37,20420
"Elizabeth City city, North Carolina",8442,7739,703,18570,37,20580
"Elizabethtown town, North Carolina",1161,1161,0,3304,37,20600
"Elkin town, North Carolina",2102,2037,65,4026,37,20620
"Elk Park town, North Carolina",233,216,17,511,37,20700
"Ellenboro town, North Carolina",387,370,17,944,37,20780
"Ellerbe town, North Carolina",585,469,116,1156,37,20840
"Elm City town, North Carolina",495,464,31,1157,37,20980
"Elon town, North Carolina",4649,4468,181,11161,37,21095
"Elrod CDP, North Carolina",94,81,13,264,37,21120
"Elroy CDP, North Carolina",1563,1512,51,3495,37,21130
"Emerald Isle town, North Carolina",1580,1564,16,3870,37,21160
"Emma CDP, North Carolina",1395,1395,0,2969,37,21260
"Enfield town, North Carolina",611,498,113,1967,37,21360
"Engelhard CDP, North Carolina",125,125,0,254,37,21380
"Enochville CDP, North Carolina",1537,1421,116,3446,37,21500
"Erwin town, North Carolina",1994,1964,30,4606,37,21740
"Etowah CDP, North Carolina",3624,3587,37,7689,37,21880
"Eureka town, North Carolina",101,94,7,217,37,21960
"Everetts town, North Carolina",130,130,0,269,37,22040
"Evergreen CDP, North Carolina",56,56,0,300,37,22080
"Fair Bluff town, North Carolina",183,176,7,437,37,22240
"Fairfield CDP, North Carolina",36,36,0,338,37,22280
"Fairfield Harbour CDP, North Carolina",934,846,88,2816,37,22305
"Fairmont town, North Carolina",866,791,75,2519,37,22360
"Fairplains CDP, North Carolina",554,446,108,1709,37,22380
"Fairview CDP, North Carolina",1069,1010,59,2436,37,22440
"Fairview town, North Carolina",1676,1636,40,3512,37,22500
"Faison town, North Carolina",437,396,41,950,37,22560
"Faith town, North Carolina",678,678,0,1096,37,22600
"Falcon town, North Carolina",56,56,0,186,37,22620
"Falkland town, North Carolina",110,110,0,122,37,22640
"Fallston town, North Carolina",248,243,5,670,37,22720
"Farmington CDP, North Carolina",112,112,0,234,37,22800
"Farmville town, North Carolina",1949,1903,46,4474,37,22820
"Fayetteville city, North Carolina",82748,75828,6920,208697,37,22920
"Fearrington Village CDP, North Carolina",542,542,0,2582,37,22982
"Five Points CDP, North Carolina",575,530,45,1136,37,23520
"Flat Rock village, North Carolina",1220,1156,64,3483,37,23600
"Flat Rock CDP, North Carolina",489,473,16,1066,37,23640
"Fletcher town, North Carolina",4035,3911,124,8000,37,23760
"Fontana Dam town, North Carolina",4,4,0,11,37,23980
"Forest City town, North Carolina",2900,2606,294,7357,37,24080
"Forest Hills village, North Carolina",132,132,0,344,37,24170
"Forest Oaks CDP, North Carolina",1928,1928,0,4144,37,24198
"Foscoe CDP, North Carolina",715,684,31,1411,37,24380
"Fountain town, North Carolina",120,78,42,299,37,24440
"Four Oaks town, North Carolina",1179,1110,69,2269,37,24520
"Foxfire village, North Carolina",586,579,7,1588,37,24570
"Franklin town, North Carolina",1803,1736,67,4184,37,24640
"Franklinton town, North Carolina",1049,895,154,2477,37,24720
"Franklinville town, North Carolina",596,571,25,1245,37,24740
"Fremont town, North Carolina",402,402,0,935,37,24900
"Frisco CDP, North Carolina",404,404,0,659,37,25020
"Fruitland CDP, North Carolina",1083,1070,13,2447,37,25160
"Fuquay-Varina town, North Carolina",17746,17138,608,35428,37,25300
"Gamewell town, North Carolina",2095,1959,136,3710,37,25380
"Garland town, North Carolina",397,371,26,996,37,25460
"Garner town, North Carolina",17831,16794,1037,31684,37,25480
"Garysburg town, North Carolina",261,239,22,620,37,25540
"Gaston town, North Carolina",370,283,87,849,37,25560
"Gastonia city, North Carolina",40257,38012,2245,80615,37,25580
"Gatesville town, North Carolina",128,113,15,277,37,25680
"Germanton CDP, North Carolina",374,374,0,876,37,25880
"Gerton CDP, North Carolina",91,91,0,251,37,25900
"Gibson town, North Carolina",271,223,48,747,37,25940
"Gibsonville town, North Carolina",4562,4451,111,8827,37,25980
"Glen Alpine town, North Carolina",960,920,40,1896,37,26200
"Glen Raven CDP, North Carolina",1848,1780,68,3710,37,26460
"Glenville CDP, North Carolina",73,73,0,136,37,26520
"Glenwood CDP, North Carolina",174,174,0,280,37,26560
"Gloucester CDP, North Carolina",219,212,7,506,37,26680
"Godwin town, North Carolina",64,64,0,147,37,26740
"Gold Hill CDP, North Carolina",181,181,0,331,37,26800
"Goldsboro city, North Carolina",13507,12497,1010,33566,37,26880
"Goldston town, North Carolina",226,226,0,375,37,26920
"Gorman CDP, North Carolina",644,630,14,1473,37,27120
"Governors Club CDP, North Carolina",548,528,20,1856,37,27180
"Governors Village CDP, North Carolina",971,958,13,2014,37,27182
"Graham city, North Carolina",8404,7726,678,17136,37,27280
"Graingers CDP, North Carolina",0,0,0,30,37,27300
"Grandfather Village village, North Carolina",14,14,0,57,37,27324
"Grandy CDP, North Carolina",1345,1281,64,2438,37,27400
"Granite Falls town, North Carolina",2287,2218,69,4934,37,27420
"Granite Quarry town, North Carolina",1624,1582,42,2988,37,27440
"Grantsboro town, North Carolina",238,234,4,528,37,27520
"Greenevers town, North Carolina",264,235,29,789,37,27780
"Green Level town, North Carolina",1211,1174,37,3111,37,27870
"Greensboro city, North Carolina",155234,146624,8610,297202,37,28000
"Greenville city, North Carolina",46699,42619,4080,87894,37,28080
"Grifton town, North Carolina",1318,1111,207,2676,37,28200
"Grimesland town, North Carolina",165,142,23,368,37,28240
"Grover town, North Carolina",227,193,34,598,37,28400
"Gulf CDP, North Carolina",106,106,0,178,37,28600
"Half Moon CDP, North Carolina",3568,3366,202,8381,37,28900
"Halifax town, North Carolina",183,183,0,227,37,28920
"Hallsboro CDP, North Carolina",42,21,21,172,37,29000
"Hamilton town, North Carolina",76,70,6,167,37,29120
"Hamlet city, North Carolina",2416,2160,256,6043,37,29160
"Hampstead CDP, North Carolina",4074,3812,262,8340,37,29180
"Harkers Island CDP, North Carolina",479,434,45,1104,37,29560
"Harmony town, North Carolina",325,318,7,584,37,29640
"Harrells town, North Carolina",102,91,11,209,37,29680
"Harrellsville town, North Carolina",101,85,16,208,37,29720
"Harrisburg town, North Carolina",10111,9770,341,18934,37,29800
"Hassell town, North Carolina",0,0,0,26,37,30040
"Hatteras CDP, North Carolina",169,169,0,458,37,30100
"Havelock city, North Carolina",5462,5203,259,16759,37,30120
"Haw River town, North Carolina",1503,1437,66,2894,37,30260
"Hayesville town, North Carolina",240,238,2,629,37,30280
"Hays CDP, North Carolina",657,657,0,1389,37,30340
"Hemby Bridge town, North Carolina",829,829,0,1924,37,30620
"Henderson city, North Carolina",6731,6280,451,14997,37,30660
"Hendersonville city, North Carolina",6918,6769,149,15102,37,30720
"Henrietta CDP, North Carolina",88,88,0,341,37,30800
"Hertford town, North Carolina",938,813,125,2045,37,30900
"Hickory city, North Carolina",21306,19987,1319,43352,37,31060
"Hiddenite CDP, North Carolina",151,142,9,319,37,31260
"Highlands town, North Carolina",539,521,18,1140,37,31360
"High Point city, North Carolina",57008,53497,3511,114120,37,31400
"High Shoals city, North Carolina",260,252,8,675,37,31440
"Hightsville CDP, North Carolina",127,127,0,750,37,31490
"Hildebran town, North Carolina",954,906,48,1843,37,31500
"Hillsborough town, North Carolina",4937,4582,355,9534,37,31620
"Hobgood town, North Carolina",136,128,8,279,37,31860
"Hobucken CDP, North Carolina",0,0,0,0,37,31880
"Hoffman town, North Carolina",284,284,0,829,37,31920
"Holden Beach town, North Carolina",432,422,10,997,37,31960
"Hollister CDP, North Carolina",347,347,0,847,37,32100
"Holly Ridge town, North Carolina",2217,2194,23,4236,37,32180
"Holly Springs town, North Carolina",21703,20941,762,42023,37,32260
"Hookerton town, North Carolina",282,252,30,578,37,32540
"Hoopers Creek CDP, North Carolina",578,559,19,1515,37,32580
"Hope Mills town, North Carolina",7874,7256,618,17671,37,32640
"Horse Shoe CDP, North Carolina",782,757,25,1854,37,32740
"Hot Springs town, North Carolina",265,256,9,519,37,32840
"Hudson town, North Carolina",1945,1825,120,3780,37,32980
"Huntersville town, North Carolina",34696,33278,1418,61202,37,33120
"Icard CDP, North Carolina",1129,951,178,1984,37,33320
"Indian Beach town, North Carolina",74,73,1,225,37,33460
"Indian Trail town, North Carolina",23099,21868,1231,40325,37,33560
"Ingold CDP, North Carolina",368,260,108,757,37,33640
"Iron Station CDP, North Carolina",220,220,0,699,37,33820
"Ivanhoe CDP, North Carolina",163,163,0,434,37,33940
"JAARS CDP, North Carolina",272,272,0,887,37,33993
"Jackson town, North Carolina",354,298,56,671,37,34000
"Jackson Heights CDP, North Carolina",433,433,0,889,37,34038
"Jackson Springs CDP, North Carolina",162,162,0,244,37,34160
"Jacksonville city, North Carolina",19863,18100,1763,71908,37,34200
"James City CDP, North Carolina",2521,2400,121,5186,37,34260
"Jamestown town, North Carolina",2030,2016,14,3677,37,34300
"Jamesville town, North Carolina",156,137,19,384,37,34320
"Jefferson town, North Carolina",795,761,34,1872,37,34440
"Jonesville town, North Carolina",1039,1017,22,2634,37,34840
"Kannapolis city, North Carolina",26760,25139,1621,53314,37,35200
"Keener CDP, North Carolina",93,93,0,237,37,35340
"Kelford town, North Carolina",121,116,5,282,37,35360
"Kelly CDP, North Carolina",103,103,0,555,37,35440
"Kenansville town, North Carolina",288,286,2,929,37,35460
"Kenly town, North Carolina",1060,968,92,2527,37,35540
"Kernersville town, North Carolina",14721,14283,438,27177,37,35600
"Kill Devil Hills town, North Carolina",4672,4385,287,7658,37,35720
"King city, North Carolina",3192,3124,68,7210,37,35760
"Kings Grant CDP, North Carolina",5134,5018,116,8561,37,35870
"Kings Mountain city, North Carolina",5355,4991,364,11246,37,35880
"Kingstown town, North Carolina",241,224,17,533,37,35890
"Kinston city, North Carolina",7801,6739,1062,19704,37,35920
"Kittrell town, North Carolina",56,56,0,76,37,36020
"Kitty Hawk town, North Carolina",2145,1993,152,3690,37,36060
"Knightdale town, North Carolina",11275,10615,660,19127,37,36080
"Kure Beach town, North Carolina",1253,1238,15,2313,37,36220
"La Grange town, North Carolina",1195,1091,104,2640,37,36400
"Lake Junaluska CDP, North Carolina",1270,1183,87,2977,37,36480
"Lake Lure town, North Carolina",627,601,26,1575,37,36500
"Lake Norman of Catawba CDP, North Carolina",4423,4244,179,8998,37,36510
"Lake Norman of Iredell CDP, North Carolina",6036,5918,118,12526,37,36511
"Lake Park village, North Carolina",1818,1752,66,3342,37,36512
"Lake Royale CDP, North Carolina",1586,1555,31,3358,37,36513
"Lake Santeetlah town, North Carolina",25,25,0,121,37,36514
"Lake Waccamaw town, North Carolina",540,528,12,1462,37,36640
"Landis town, North Carolina",1668,1619,49,3663,37,36860
"Lansing town, North Carolina",110,100,10,236,37,36960
"Lasker town, North Carolina",50,50,0,172,37,37000
"Lattimore town, North Carolina",299,294,5,557,37,37040
"Laurel Hill CDP, North Carolina",279,229,50,869,37,37120
"Laurel Park town, North Carolina",1082,1050,32,2615,37,37160
"Laurinburg city, North Carolina",5935,5271,664,14971,37,37220
"Lawndale town, North Carolina",240,240,0,599,37,37260
"Leggett town, North Carolina",17,17,0,55,37,37640
"Leland town, North Carolina",11385,10950,435,24473,37,37680
"Lenoir city, North Carolina",8066,7521,545,18301,37,37760
"Lewiston Woodville town, North Carolina",169,153,16,458,37,38030
"Lewisville town, North Carolina",6644,6405,239,13509,37,38040
"Lexington city, North Carolina",8506,7947,559,19595,37,38060
"Liberty town, North Carolina",1405,1262,143,2666,37,38100
"Light Oak CDP, North Carolina",225,164,61,677,37,38170
"Lilesville town, North Carolina",276,247,29,779,37,38200
"Lillington town, North Carolina",1692,1679,13,4566,37,38220
"Lincolnton city, North Carolina",5215,4828,387,11225,37,38320
"Linden town, North Carolina",48,45,3,126,37,38360
"Linville CDP, North Carolina",220,190,30,437,37,38420
"Littleton town, North Carolina",187,186,1,525,37,38680
"Locust city, North Carolina",2149,2085,64,4700,37,38860
"Long Creek CDP, North Carolina",25,25,0,77,37,39060
"Long View town, North Carolina",2812,2663,149,5029,37,39280
"Louisburg town, North Carolina",1055,756,299,3099,37,39360
"Love Valley town, North Carolina",56,43,13,130,37,39420
"Lowell city, North Carolina",1944,1856,88,3692,37,39480
"Lowesville CDP, North Carolina",2055,2010,45,3567,37,39520
"Lowgap CDP, North Carolina",103,84,19,188,37,39540
"Lucama town, North Carolina",476,423,53,1058,37,39600
"Lumber Bridge town, North Carolina",24,23,1,69,37,39680
"Lumberton city, North Carolina",7196,6711,485,19099,37,39700
"McAdenville town, North Carolina",570,549,21,1125,37,39880
"Macclesfield town, North Carolina",138,134,4,335,37,39960
"McDonald town, North Carolina",45,45,0,97,37,40140
"McFarlan town, North Carolina",47,43,4,111,37,40240
"McLeansville CDP, North Carolina",420,420,0,933,37,40460
"Macon town, North Carolina",50,42,8,90,37,40540
"Madison town, North Carolina",1119,1034,85,2185,37,40560
"Maggie Valley town, North Carolina",998,975,23,2195,37,40600
"Magnolia town, North Carolina",465,445,20,944,37,40640
"Maiden town, North Carolina",2008,1924,84,3727,37,40660
"Mamers CDP, North Carolina",187,163,24,668,37,40860
"Manns Harbor CDP, North Carolina",356,356,0,673,37,40980
"Manteo town, North Carolina",857,835,22,1808,37,41060
"Marble CDP, North Carolina",125,66,59,282,37,41220
"Marietta town, North Carolina",38,32,6,110,37,41380
"Marion city, North Carolina",2810,2542,268,7652,37,41420
"Mar-Mac CDP, North Carolina",845,845,0,2485,37,41540
"Marshall town, North Carolina",291,287,4,616,37,41580
"Marshallberg CDP, North Carolina",273,263,10,430,37,41600
"Mars Hill town, North Carolina",1342,1312,30,2843,37,41620
"Marshville town, North Carolina",1066,926,140,2565,37,41640
"Marvin village, North Carolina",3066,2932,134,6421,37,41720
"Matthews town, North Carolina",16247,15755,492,29613,37,41960
"Maury CDP, North Carolina",111,96,15,1055,37,42000
"Maxton town, North Carolina",766,649,117,2300,37,42020
"Mayodan town, North Carolina",1170,1039,131,2438,37,42060
"Maysville town, North Carolina",334,325,9,893,37,42100
"Mebane city, North Carolina",9577,9243,334,17899,37,42240
"Mesic town, North Carolina",70,67,3,183,37,42480
"Micro town, North Carolina",193,181,12,477,37,42620
"Middleburg town, North Carolina",83,73,10,223,37,42640
"Middlesex town, North Carolina",501,497,4,963,37,42700
"Midland town, North Carolina",2618,2596,22,4675,37,42760
"Midway town, North Carolina",2488,2397,91,4773,37,42860
"Millers Creek CDP, North Carolina",747,694,53,1475,37,43160
"Millingport CDP, North Carolina",306,306,0,479,37,43200
"Mills River town, North Carolina",3629,3441,188,7100,37,43260
"Milton town, North Carolina",61,61,0,147,37,43300
"Milwaukee CDP, North Carolina",33,33,0,205,37,43320
"Mineral Springs town, North Carolina",1889,1790,99,3185,37,43360
"Minnesott Beach town, North Carolina",156,156,0,486,37,43440
"Mint Hill town, North Carolina",14256,13561,695,26537,37,43480
"Misenheimer village, North Carolina",291,252,39,652,37,43580
"Mocksville town, North Carolina",2897,2727,170,5908,37,43720
"Momeyer town, North Carolina",196,182,14,412,37,43860
"Moncure CDP, North Carolina",387,387,0,775,37,43880
"Monroe city, North Carolina",17874,16773,1101,34897,37,43920
"Montreat town, North Carolina",315,274,41,442,37,44100
"Mooresboro town, North Carolina",92,86,6,204,37,44160
"Mooresville town, North Carolina",26923,25864,1059,50025,37,44220
"Moravian Falls CDP, North Carolina",361,361,0,1023,37,44280
"Morehead City town, North Carolina",4539,4372,167,9632,37,44320
"Morganton city, North Carolina",7492,7091,401,17457,37,44400
"Morrisville town, North Carolina",17561,16922,639,29756,37,44520
"Morven town, North Carolina",107,93,14,345,37,44560
"Mountain Home CDP, North Carolina",2350,2332,18,4028,37,44700
"Mountain View CDP, North Carolina",1745,1660,85,3323,37,44770
"Mount Airy city, North Carolina",4332,4021,311,10621,37,44800
"Mount Gilead town, North Carolina",532,489,43,1090,37,44900
"Mount Holly city, North Carolina",10106,9449,657,17644,37,44960
"Mount Olive town, North Carolina",2133,1981,152,4286,37,45100
"Mount Pleasant town, North Carolina",854,812,42,1776,37,45140
"Moyock CDP, North Carolina",2978,2906,72,5259,37,45460
"Mulberry CDP, North Carolina",748,677,71,1980,37,45560
"Murfreesboro town, North Carolina",992,942,50,2612,37,45640
"Murphy town, North Carolina",608,561,47,1549,37,45660
"Murraysville CDP, North Carolina",10578,10132,446,16672,37,45720
"Myrtle Grove CDP, North Carolina",5573,5334,239,12093,37,45840
"Nags Head town, North Carolina",1483,1456,27,3153,37,45880
"Nashville town, North Carolina",3030,2683,347,5624,37,46000
"Navassa town, North Carolina",814,766,48,1976,37,46060
"Nebo CDP, North Carolina",614,614,0,1423,37,46100
"Neuse Forest CDP, North Carolina",799,717,82,2176,37,46280
"New Bern city, North Carolina",14383,13730,653,31373,37,46340
"New Hope CDP, North Carolina",554,542,12,924,37,46650
"Newland town, North Carolina",338,294,44,743,37,46740
"New London town, North Carolina",366,358,8,674,37,46820
"Newport town, North Carolina",2203,1983,220,4407,37,46860
"Newton city, North Carolina",6107,5699,408,13173,37,47000
"Newton Grove town, North Carolina",377,362,15,659,37,47020
"Norlina town, North Carolina",551,525,26,1170,37,47240
"Norman town, North Carolina",58,54,4,173,37,47260
"Northchase CDP, North Carolina",2734,2229,505,5543,37,47485
"Northlakes CDP, North Carolina",767,743,24,1378,37,47695
"North Topsail Beach town, North Carolina",371,341,30,775,37,47845
"Northwest city, North Carolina",379,338,41,769,37,47860
"North Wilkesboro town, North Carolina",1766,1745,21,4349,37,47880
"Norwood town, North Carolina",1544,1465,79,2906,37,47980
"Oakboro town, North Carolina",1247,1229,18,2379,37,48040
"Oak City town, North Carolina",244,237,7,420,37,48060
"Oak Island town, North Carolina",3827,3638,189,8564,37,48345
"Oak Ridge town, North Carolina",3799,3654,145,7637,37,48480
"Ocean Isle Beach town, North Carolina",256,248,8,809,37,48700
"Ocracoke CDP, North Carolina",312,284,28,715,37,48740
"Ogden CDP, North Carolina",4563,4464,99,8699,37,48790
"Old Fort town, North Carolina",288,272,16,658,37,48920
"Old Hundred CDP, North Carolina",113,22,91,316,37,48940
"Oriental town, North Carolina",240,237,3,968,37,49380
"Orrum town, North Carolina",11,11,0,62,37,49460
"Ossipee town, North Carolina",322,267,55,560,37,49600
"Oxford city, North Carolina",3841,3581,260,8685,37,49800
"Pantego town, North Carolina",108,101,7,441,37,50080
"Parkton town, North Carolina",206,198,8,451,37,50340
"Parmele town, North Carolina",119,115,4,221,37,50540
"Patterson Springs town, North Carolina",356,322,34,854,37,50700
"Peachland town, North Carolina",159,157,2,465,37,50820
"Peletier town, North Carolina",366,310,56,749,37,51040
"Pembroke town, North Carolina",874,832,42,2832,37,51080
"Pikeville town, North Carolina",401,401,0,679,37,51780
"Pilot Mountain town, North Carolina",816,781,35,1667,37,51820
"Pinebluff town, North Carolina",780,743,37,1767,37,51840
"Pinehurst village, North Carolina",6004,5754,250,17653,37,51940
"Pine Knoll Shores town, North Carolina",459,444,15,1363,37,52000
"Pine Level town, North Carolina",1017,984,33,2116,37,52020
"Pinetops town, North Carolina",581,550,31,1374,37,52140
"Pinetown CDP, North Carolina",25,25,0,42,37,52160
"Pineville town, North Carolina",5351,5142,209,10532,37,52220
"Piney Green CDP, North Carolina",6831,6338,493,14767,37,52260
"Pink Hill town, North Carolina",260,249,11,528,37,52400
"Pinnacle CDP, North Carolina",230,230,0,749,37,52500
"Pittsboro town, North Carolina",2510,2432,78,4555,37,52660
"Plain View CDP, North Carolina",682,653,29,1494,37,52685
"Pleasant Garden town, North Carolina",2278,2251,27,4987,37,52760
"Pleasant Hill CDP, North Carolina",605,520,85,867,37,52920
"Plymouth town, North Carolina",1163,881,282,3315,37,53040
"Polkton town, North Carolina",481,474,7,2937,37,53140
"Polkville city, North Carolina",249,237,12,500,37,53160
"Pollocksville town, North Carolina",185,178,7,342,37,53200
"Porters Neck CDP, North Carolina",3361,2900,461,7165,37,53475
"Potters Hill CDP, North Carolina",260,260,0,460,37,53580
"Powellsville town, North Carolina",20,20,0,161,37,53680
"Princeton town, North Carolina",556,546,10,1471,37,53820
"Princeville town, North Carolina",710,629,81,1630,37,53840
"Proctorville town, North Carolina",52,52,0,140,37,53900
"Prospect CDP, North Carolina",309,309,0,650,37,53950
"Pumpkin Center CDP, North Carolina",832,779,53,2151,37,54160
"Raeford city, North Carolina",1819,1741,78,4570,37,54580
"Raemon CDP, North Carolina",170,103,67,305,37,54600
"Raleigh city, North Carolina",267659,255519,12140,465517,37,55000
"Ramseur town, North Carolina",754,734,20,1877,37,55040
"Randleman city, North Carolina",1978,1939,39,4573,37,55080
"Ranlo town, North Carolina",2122,1967,155,4487,37,55260
"Raynham town, North Carolina",19,15,4,37,37,55340
"Red Cross town, North Carolina",349,332,17,677,37,55460
"Red Oak town, North Carolina",1621,1621,0,3357,37,55640
"Red Springs town, North Carolina",976,894,82,3118,37,55660
"Reidsville city, North Carolina",5711,5137,574,14526,37,55900
"Rennert town, North Carolina",135,119,16,300,37,55940
"Rex CDP, North Carolina",0,0,0,42,37,56100
"Rhodhiss town, North Carolina",440,426,14,1074,37,56240
"Richfield town, North Carolina",513,504,9,921,37,56340
"Richlands town, North Carolina",1069,924,145,2577,37,56360
"Rich Square town, North Carolina",291,262,29,746,37,56440
"Riegelwood CDP, North Carolina",312,301,11,658,37,56600
"River Bend town, North Carolina",1152,1138,14,2914,37,56710
"River Road CDP, North Carolina",1956,1816,140,3507,37,56815
"Roanoke Rapids city, North Carolina",6610,6201,409,15143,37,56900
"Robbins town, North Carolina",618,564,54,1511,37,57000
"Robbinsville town, North Carolina",201,196,5,705,37,57020
"Roberdel CDP, North Carolina",108,108,0,202,37,57039
"Robersonville town, North Carolina",647,619,28,1471,37,57100
"Rockfish CDP, North Carolina",1604,1530,74,3569,37,57200
"Rockingham city, North Carolina",4177,3875,302,9174,37,57260
"Rockwell town, North Carolina",1135,1065,70,2434,37,57340
"Rocky Mount city, North Carolina",26037,24003,2034,54260,37,57500
"Rocky Point CDP, North Carolina",495,458,37,940,37,57540
"Rodanthe CDP, North Carolina",184,184,0,184,37,57580
"Rolesville town, North Carolina",4566,4398,168,9696,37,57640
"Ronda town, North Carolina",220,209,11,516,37,57700
"Roper town, North Carolina",147,110,37,502,37,57740
"Roseboro town, North Carolina",356,349,7,900,37,57800
"Rose Hill town, North Carolina",911,790,121,1754,37,57860
"Rosman town, North Carolina",277,267,10,642,37,58020
"Rougemont CDP, North Carolina",433,414,19,1125,37,58040
"Rowland town, North Carolina",270,239,31,1003,37,58140
"Roxboro city, North Carolina",3895,3707,188,8131,37,58160
"Roxobel town, North Carolina",243,155,88,440,37,58180
"Royal Pines CDP, North Carolina",2415,2389,26,4681,37,58260
"Ruffin CDP, North Carolina",257,242,15,437,37,58340
"Rural Hall town, North Carolina",1720,1490,230,3376,37,58360
"Ruth town, North Carolina",261,255,6,621,37,58420
"Rutherford College town, North Carolina",541,521,20,1119,37,58440
"Rutherfordton town, North Carolina",1574,1511,63,3671,37,58460
"St. Helena village, North Carolina",236,225,11,465,37,58620
"St. James town, North Carolina",1599,1543,56,6566,37,58630
"St. Pauls town, North Carolina",822,741,81,2261,37,58720
"St. Stephens CDP, North Carolina",4853,4650,203,9624,37,58730
"Salem CDP, North Carolina",771,726,45,1634,37,58740
"Salemburg town, North Carolina",158,158,0,330,37,58840
"Salisbury city, North Carolina",16255,15120,1135,35437,37,58860
"Saluda city, North Carolina",260,239,21,617,37,58920
"Salvo CDP, North Carolina",114,114,0,201,37,58940
"Sandy Creek town, North Carolina",190,177,13,304,37,59090
"Sandyfield town, North Carolina",154,146,8,625,37,59135
"Sanford city, North Carolina",14404,13589,815,30373,37,59280
"Saratoga town, North Carolina",196,175,21,345,37,59340
"Sawmills town, North Carolina",2557,2353,204,5026,37,59540
"Saxapahaw CDP, North Carolina",580,532,48,1200,37,59580
"Scotch Meadows CDP, North Carolina",310,310,0,645,37,59765
"Scotland Neck town, North Carolina",645,576,69,1861,37,59780
"Seaboard town, North Carolina",245,245,0,603,37,59980
"Sea Breeze CDP, North Carolina",638,638,0,1533,37,60000
"Seagrove town, North Carolina",199,188,11,405,37,60080
"Sedalia town, North Carolina",256,251,5,529,37,60180
"Selma town, North Carolina",2824,2689,135,6449,37,60320
"Seven Devils town, North Carolina",183,181,2,422,37,60505
"Seven Lakes CDP, North Carolina",1322,1322,0,3994,37,60515
"Seven Springs town, North Carolina",6,6,0,17,37,60540
"Severn town, North Carolina",47,46,1,177,37,60560
"Shallotte town, North Carolina",2032,2005,27,4213,37,60800
"Shannon CDP, North Carolina",84,84,0,245,37,60940
"Sharpsburg town, North Carolina",627,624,3,1504,37,61060
"Shelby city, North Carolina",9762,9396,366,21712,37,61200
"Siler City town, North Carolina",3643,3540,103,7847,37,61860
"Silver City CDP, North Carolina",332,313,19,819,37,61920
"Silver Lake CDP, North Carolina",3240,3131,109,5858,37,61950
"Simpson village, North Carolina",175,157,18,386,37,62040
"Sims town, North Carolina",199,182,17,406,37,62060
"Skippers Corner CDP, North Carolina",1448,1431,17,3599,37,62190
"Smithfield town, North Carolina",4404,4117,287,11527,37,62520
"Smithtown CDP, North Carolina",44,44,0,158,37,62580
"Sneads Ferry CDP, North Carolina",982,982,0,2140,37,62680
"Snow Hill town, North Carolina",775,732,43,2092,37,62760
"Southern Pines town, North Carolina",6656,6208,448,15701,37,63120
"Southern Shores town, North Carolina",1456,1246,210,3098,37,63130
"South Henderson CDP, North Carolina",550,423,127,1187,37,63240
"South Mills CDP, North Carolina",367,333,34,627,37,63340
"Southmont CDP, North Carolina",531,531,0,1392,37,63360
"Southport city, North Carolina",1544,1532,12,4015,37,63400
"South Rosemary CDP, North Carolina",1230,1187,43,2877,37,63470
"South Weldon CDP, North Carolina",160,143,17,619,37,63560
"Sparta town, North Carolina",716,684,32,1795,37,63680
"Speed town, North Carolina",27,27,0,59,37,63720
"Spencer town, North Carolina",1675,1524,151,3296,37,63760
"Spencer Mountain town, North Carolina",0,0,0,0,37,63780
"Spindale town, North Carolina",1967,1799,168,4218,37,63880
"Spivey's Corner CDP, North Carolina",319,311,8,696,37,63920
"Spout Springs CDP, North Carolina",3477,3127,350,10384,37,64000
"Springdale CDP, North Carolina",536,491,45,1121,37,64050
"Spring Hope town, North Carolina",597,545,52,1441,37,64160
"Spring Lake town, North Carolina",3544,3249,295,11710,37,64180
"Spruce Pine town, North Carolina",1119,1099,20,2637,37,64260
"Staley town, North Carolina",235,215,20,505,37,64380
"Stallings town, North Carolina",9062,8625,437,16193,37,64420
"Stanfield town, North Carolina",820,745,75,1463,37,64460
"Stanley town, North Carolina",1825,1724,101,3967,37,64500
"Stantonsburg town, North Carolina",376,354,22,632,37,64560
"Star town, North Carolina",411,398,13,1208,37,64580
"Statesville city, North Carolina",14573,13517,1056,28576,37,64740
"Stedman town, North Carolina",756,742,14,1479,37,64840
"Stem town, North Carolina",564,545,19,1071,37,64940
"Stokes CDP, North Carolina",97,97,0,218,37,65020
"Stokesdale town, North Carolina",2893,2881,12,5900,37,65040
"Stoneville town, North Carolina",518,483,35,1052,37,65100
"Stonewall town, North Carolina",123,73,50,229,37,65120
"Stony Point CDP, North Carolina",835,835,0,1494,37,65260
"Stovall town, North Carolina",206,197,9,374,37,65320
"Sugar Mountain village, North Carolina",237,229,8,489,37,65530
"Summerfield town, North Carolina",5523,5364,159,10986,37,65580
"Sunbury CDP, North Carolina",93,93,0,121,37,65700
"Sunset Beach town, North Carolina",1465,1406,59,4189,37,65900
"Surf City town, North Carolina",1745,1693,52,3888,37,66040
"Swannanoa CDP, North Carolina",2110,2078,32,5338,37,66280
"Swan Quarter CDP, North Carolina",186,186,0,293,37,66340
"Swansboro town, North Carolina",1417,1417,0,3759,37,66360
"Swepsonville town, North Carolina",1327,1269,58,2464,37,66460
"Sylva town, North Carolina",1175,1034,141,2601,37,66500
"Tabor City town, North Carolina",818,768,50,3709,37,66520
"Tarboro town, North Carolina",4293,4152,141,10696,37,66700
"Tar Heel town, North Carolina",27,27,0,104,37,66740
"Taylorsville town, North Carolina",787,782,5,2198,37,66960
"Taylortown town, North Carolina",412,391,21,820,37,66980
"Teachey town, North Carolina",216,187,29,574,37,67000
"Thomasville city, North Carolina",12493,11848,645,27130,37,67420
"Toast CDP, North Carolina",609,560,49,1210,37,67700
"Tobaccoville village, North Carolina",1179,1132,47,2602,37,67720
"Topsail Beach town, North Carolina",197,192,5,471,37,68040
"Trenton town, North Carolina",74,72,2,161,37,68320
"Trent Woods town, North Carolina",1934,1910,24,4086,37,68340
"Trinity city, North Carolina",3479,3353,126,7012,37,68400
"Troutman town, North Carolina",1933,1761,172,3689,37,68500
"Troy town, North Carolina",1191,1121,70,2921,37,68520
"Tryon town, North Carolina",643,630,13,1516,37,68580
"Turkey town, North Carolina",158,148,10,420,37,68740
"Tyro CDP, North Carolina",1661,1613,48,3460,37,69020
"Unionville town, North Carolina",3825,3688,137,6694,37,69260
"Valdese town, North Carolina",2395,2330,65,4682,37,69520
"Valle Crucis CDP, North Carolina",52,52,0,137,37,69600
"Valley Hill CDP, North Carolina",1225,1225,0,2417,37,69640
"Vanceboro town, North Carolina",389,385,4,958,37,69680
"Vandemere town, North Carolina",65,60,5,214,37,69720
"Vander CDP, North Carolina",498,447,51,1481,37,69740
"Vann Crossroads CDP, North Carolina",107,107,0,266,37,69755
"Varnamtown town, North Carolina",388,379,9,830,37,69795
"Vass town, North Carolina",399,390,9,1276,37,69840
"Waco town, North Carolina",104,102,2,278,37,70320
"Wade town, North Carolina",232,202,30,595,37,70340
"Wadesboro town, North Carolina",2323,2023,300,5004,37,70380
"Wagram town, North Carolina",492,432,60,946,37,70480
"Wake Forest town, North Carolina",25434,24330,1104,48047,37,70540
"Wakulla CDP, North Carolina",61,61,0,147,37,70580
"Walkertown town, North Carolina",2771,2717,54,5706,37,70660
"Wallace town, North Carolina",1555,1351,204,3443,37,70720
"Wallburg town, North Carolina",1639,1505,134,3081,37,70740
"Walnut Cove town, North Carolina",950,910,40,2028,37,70780
"Walnut Creek village, North Carolina",670,654,16,1570,37,70820
"Walstonburg town, North Carolina",129,118,11,247,37,70860
"Wanchese CDP, North Carolina",1097,1088,9,2005,37,70920
"Warrenton town, North Carolina",410,378,32,867,37,71100
"Warsaw town, North Carolina",1040,978,62,2743,37,71160
"Washington city, North Carolina",4030,3806,224,9759,37,71220
"Washington Park town, North Carolina",207,181,26,475,37,71240
"Watha town, North Carolina",103,80,23,230,37,71320
"Waves CDP, North Carolina",34,25,9,139,37,71440
"Waxhaw town, North Carolina",10486,10144,342,20665,37,71460
"Waynesville town, North Carolina",4824,4711,113,10307,37,71500
"Weaverville town, North Carolina",2421,2390,31,4559,37,71560
"Webster town, North Carolina",137,134,3,470,37,71600
"Weddington town, North Carolina",6564,6418,146,13173,37,71680
"Welcome CDP, North Carolina",1599,1570,29,3444,37,71760
"Weldon town, North Carolina",586,514,72,1536,37,71780
"Wendell town, North Carolina",6099,6072,27,10575,37,71860
"Wentworth town, North Carolina",1076,1020,56,2664,37,71900
"Wesley Chapel village, North Carolina",4346,4168,178,8763,37,71940
"West Canton CDP, North Carolina",623,572,51,1354,37,72150
"West Jefferson town, North Carolina",755,587,168,1508,37,72540
"West Marion CDP, North Carolina",380,348,32,916,37,72600
"Westport CDP, North Carolina",2095,1965,130,4570,37,72755
"Whispering Pines village, North Carolina",1769,1678,91,4938,37,73140
"Whitakers town, North Carolina",224,209,15,462,37,73160
"White Lake town, North Carolina",314,314,0,997,37,73300
"White Oak CDP, North Carolina",130,130,0,370,37,73320
"White Plains CDP, North Carolina",376,376,0,767,37,73460
"Whiteville city, North Carolina",2067,1968,99,4761,37,73660
"Whitsett town, North Carolina",289,270,19,579,37,73760
"Whittier CDP, North Carolina",0,0,0,0,37,73780
"Wilkesboro town, North Carolina",1636,1557,79,3674,37,74020
"Williamston town, North Carolina",2636,2263,373,5224,37,74220
"Wilmington city, North Carolina",63514,60402,3112,116933,37,74440
"Wilson city, North Carolina",22643,20741,1902,47767,37,74540
"Wilson's Mills town, North Carolina",1334,1189,145,2581,37,74580
"Windsor town, North Carolina",713,695,18,3494,37,74680
"Winfall town, North Carolina",361,310,51,900,37,74720
"Wingate town, North Carolina",1788,1778,10,4061,37,74760
"Winston-Salem city, North Carolina",121563,114048,7515,249571,37,75000
"Winterville town, North Carolina",5824,5585,239,10510,37,75060
"Winton town, North Carolina",331,306,25,674,37,75080
"Woodfin town, North Carolina",3939,3860,79,7901,37,75280
"Woodland town, North Carolina",162,156,6,630,37,75340
"Woodlawn CDP, North Carolina",426,426,0,947,37,75375
"Wrightsboro CDP, North Carolina",2770,2717,53,4876,37,75780
"Wrightsville Beach town, North Carolina",1437,1420,17,2848,37,75820
"Yadkin College CDP, North Carolina",98,98,0,247,37,75880
"Yadkinville town, North Carolina",1138,1056,82,2971,37,75960
"Yanceyville town, North Carolina",748,694,54,2576,37,76000
"Youngsville town, North Carolina",1440,1388,52,2421,37,76200
"Zebulon town, North Carolina",3503,3187,316,7421,37,76220
"Abercrombie city, North Dakota",119,117,2,261,38,00100
"Adams city, North Dakota",45,42,3,112,38,00340
"Alamo city, North Dakota",40,34,6,70,38,00940
"Alexander city, North Dakota",122,114,8,213,38,01180
"Alice city, North Dakota",22,22,0,44,38,01420
"Almont city, North Dakota",69,69,0,149,38,01700
"Alsen city, North Dakota",14,14,0,22,38,01740
"Ambrose city, North Dakota",12,12,0,29,38,01860
"Amenia city, North Dakota",103,100,3,181,38,01940
"Amidon city, North Dakota",8,8,0,31,38,02060
"Anamoose city, North Dakota",132,119,13,290,38,02220
"Aneta city, North Dakota",69,68,1,150,38,02380
"Antler city, North Dakota",3,3,0,13,38,02660
"Apple Valley CDP, North Dakota",153,126,27,274,38,02820
"Ardoch city, North Dakota",14,13,1,20,38,02860
"Argusville city, North Dakota",332,326,6,573,38,03020
"Arnegard city, North Dakota",93,85,8,155,38,03220
"Arthur city, North Dakota",159,155,4,338,38,03300
"Ashley city, North Dakota",292,292,0,614,38,03540
"Auburn CDP, North Dakota",0,0,0,10,38,03740
"Ayr city, North Dakota",14,14,0,15,38,04020
"Balfour city, North Dakota",5,5,0,13,38,04460
"Balta city, North Dakota",26,21,5,55,38,04580
"Bantry CDP, North Dakota",3,3,0,5,38,04740
"Barney city, North Dakota",29,28,1,51,38,04940
"Barton CDP, North Dakota",0,0,0,0,38,05220
"Bathgate city, North Dakota",26,25,1,48,38,05260
"Beach city, North Dakota",487,444,43,957,38,05420
"Belcourt CDP, North Dakota",689,634,55,1772,38,05740
"Belfield city, North Dakota",321,304,17,700,38,05820
"Benedict city, North Dakota",84,84,0,243,38,05980
"Bergen city, North Dakota",0,0,0,0,38,06180
"Berlin city, North Dakota",28,28,0,51,38,06300
"Berthold city, North Dakota",200,199,1,455,38,06460
"Beulah city, North Dakota",1579,1569,10,3063,38,06660
"Binford city, North Dakota",71,71,0,178,38,07020
"Bisbee city, North Dakota",29,26,3,63,38,07180
"Bismarck city, North Dakota",38953,37742,1211,73694,38,07200
"Blacktail CDP, North Dakota",38,38,0,113,38,07456
"Blanchard CDP, North Dakota",0,0,0,0,38,07620
"Bottineau city, North Dakota",1097,1024,73,2104,38,08460
"Bowbells city, North Dakota",187,187,0,285,38,08500
"Bowdon city, North Dakota",86,86,0,198,38,08580
"Bowman city, North Dakota",866,828,38,1646,38,08700
"Braddock city, North Dakota",7,7,0,16,38,08900
"Briarwood city, North Dakota",31,31,0,56,38,09320
"Brinsmade city, North Dakota",9,9,0,19,38,09460
"Brocket city, North Dakota",30,30,0,32,38,09700
"Brooktree Park CDP, North Dakota",54,54,0,156,38,09830
"Buchanan city, North Dakota",72,72,0,82,38,10060
"Bucyrus city, North Dakota",26,26,0,49,38,10300
"Buffalo city, North Dakota",67,65,2,136,38,10420
"Burlington city, North Dakota",697,661,36,1308,38,10940
"Butte city, North Dakota",25,20,5,71,38,11180
"Buxton city, North Dakota",181,178,3,379,38,11340
"Caledonia CDP, North Dakota",34,34,0,69,38,11500
"Calio city, North Dakota",3,3,0,6,38,11580
"Calvin city, North Dakota",6,6,0,14,38,11700
"Cando city, North Dakota",592,578,14,1218,38,11860
"Cannon Ball CDP, North Dakota",211,163,48,896,38,12020
"Canton City (Hensel) city, North Dakota",22,22,0,39,38,12060
"Carpio city, North Dakota",75,75,0,146,38,12260
"Carrington city, North Dakota",1150,1150,0,2161,38,12340
"Carson city, North Dakota",145,143,2,288,38,12460
"Casselton city, North Dakota",1415,1395,20,2496,38,12700
"Cathay city, North Dakota",2,2,0,22,38,12820
"Cavalier city, North Dakota",721,646,75,1360,38,12940
"Cayuga city, North Dakota",15,14,1,40,38,13020
"Center city, North Dakota",174,166,8,554,38,13180
"Christine city, North Dakota",103,103,0,166,38,14100
"Churchs Ferry city, North Dakota",1,1,0,2,38,14140
"Cleveland city, North Dakota",105,103,2,119,38,14660
"Clifford city, North Dakota",45,45,0,65,38,14740
"Cogswell city, North Dakota",64,62,2,113,38,15100
"Coleharbor city, North Dakota",26,26,0,89,38,15140
"Colfax city, North Dakota",103,100,3,259,38,15180
"Columbus city, North Dakota",30,30,0,66,38,15460
"Conway city, North Dakota",13,13,0,13,38,15820
"Cooperstown city, North Dakota",357,351,6,803,38,15900
"Courtenay city, North Dakota",17,17,0,53,38,16380
"Crary city, North Dakota",55,55,0,107,38,16580
"Crosby city, North Dakota",544,524,20,1105,38,16940
"Crystal city, North Dakota",43,42,1,96,38,17060
"Dahlen CDP, North Dakota",21,21,0,28,38,17620
"Davenport city, North Dakota",160,160,0,253,38,18180
"Dawson city, North Dakota",47,46,1,72,38,18260
"Dazey city, North Dakota",45,45,0,83,38,18340
"Deering city, North Dakota",49,49,0,102,38,18620
"De Lamere CDP, North Dakota",4,4,0,20,38,18820
"Denhoff CDP, North Dakota",4,4,0,18,38,19060
"Des Lacs city, North Dakota",138,138,0,200,38,19300
"Devils Lake city, North Dakota",3520,3480,40,7192,38,19420
"Dickey city, North Dakota",27,27,0,89,38,19580
"Dickinson city, North Dakota",13292,12891,401,25116,38,19620
"Dodge city, North Dakota",33,32,1,96,38,19820
"Donnybrook city, North Dakota",38,38,0,76,38,19900
"Douglas city, North Dakota",29,29,0,87,38,20020
"Drake city, North Dakota",128,108,20,297,38,20300
"Drayton city, North Dakota",432,418,14,812,38,20340
"Driscoll CDP, North Dakota",25,25,0,63,38,20500
"Dunn Center city, North Dakota",223,210,13,447,38,20940
"Dunseith city, North Dakota",303,295,8,858,38,21020
"Dwight city, North Dakota",33,31,2,54,38,21220
"East Dunseith CDP, North Dakota",194,159,35,459,38,21520
"East Fairview CDP, North Dakota",3,3,0,119,38,21580
"Edgeley city, North Dakota",332,332,0,678,38,22140
"Edinburg city, North Dakota",84,84,0,195,38,22260
"Edmore city, North Dakota",153,152,1,296,38,22340
"Egeland city, North Dakota",37,37,0,83,38,22540
"Elgin city, North Dakota",310,293,17,649,38,23020
"Ellendale city, North Dakota",493,470,23,997,38,23220
"Elliott city, North Dakota",26,22,4,37,38,23340
"Embden CDP, North Dakota",17,17,0,32,38,24020
"Emerado city, North Dakota",215,208,7,416,38,24060
"Enderlin city, North Dakota",476,455,21,1030,38,24260
"Englevale CDP, North Dakota",40,40,0,40,38,24380
"Epping city, North Dakota",75,57,18,113,38,24540
"Erie CDP, North Dakota",29,24,5,47,38,24620
"Esmond city, North Dakota",56,42,14,106,38,24780
"Fairdale city, North Dakota",4,3,1,17,38,25180
"Fairmount city, North Dakota",161,146,15,337,38,25300
"Fargo city, North Dakota",78139,75319,2820,127319,38,25700
"Fessenden city, North Dakota",337,330,7,550,38,26180
"Fingal city, North Dakota",104,103,1,136,38,26380
"Finley city, North Dakota",155,149,6,291,38,26420
"Flasher city, North Dakota",104,102,2,224,38,26660
"Flaxton city, North Dakota",17,17,0,44,38,26700
"Forbes city, North Dakota",15,15,0,20,38,26980
"Fordville city, North Dakota",131,130,1,227,38,27060
"Forest River city, North Dakota",53,53,0,117,38,27100
"Forman city, North Dakota",300,297,3,587,38,27260
"Fort Ransom city, North Dakota",49,47,2,106,38,27580
"Fort Totten CDP, North Dakota",162,152,10,1042,38,27700
"Fortuna city, North Dakota",24,24,0,54,38,27820
"Fort Yates city, North Dakota",51,45,6,144,38,27860
"Four Bears Village CDP, North Dakota",120,120,0,251,38,27950
"Foxholm CDP, North Dakota",29,29,0,63,38,27980
"Fredonia city, North Dakota",12,12,0,25,38,28380
"Frontier city, North Dakota",109,102,7,175,38,28720
"Fullerton city, North Dakota",35,35,0,63,38,28780
"Gackle city, North Dakota",105,100,5,309,38,28860
"Galesburg city, North Dakota",43,43,0,63,38,28980
"Gardena city, North Dakota",9,9,0,37,38,29180
"Gardner city, North Dakota",41,41,0,71,38,29220
"Garrison city, North Dakota",644,638,6,1524,38,29460
"Gascoyne city, North Dakota",6,6,0,24,38,29540
"Gilby city, North Dakota",183,183,0,376,38,30180
"Gladstone city, North Dakota",154,146,8,256,38,30460
"Glenburn city, North Dakota",208,206,2,490,38,30580
"Glenfield city, North Dakota",51,51,0,74,38,30660
"Glen Ullin city, North Dakota",282,262,20,739,38,30860
"Golden Valley city, North Dakota",108,100,8,224,38,31180
"Golva city, North Dakota",96,96,0,131,38,31420
"Goodrich city, North Dakota",47,45,2,105,38,31500
"Grace City city, North Dakota",33,30,3,49,38,31740
"Grafton city, North Dakota",2164,2092,72,4161,38,31820
"Grand Forks city, North Dakota",34105,32835,1270,58935,38,32060
"Grand Forks AFB CDP, North Dakota",437,428,9,2113,38,32140
"Grandin city, North Dakota",86,84,2,148,38,32300
"Grano city, North Dakota",2,2,0,2,38,32580
"Granville city, North Dakota",146,144,2,279,38,32660
"Great Bend city, North Dakota",23,23,0,31,38,32900
"Green Acres CDP, North Dakota",158,158,0,789,38,33050
"Grenora city, North Dakota",158,155,3,329,38,33500
"Gwinner city, North Dakota",497,479,18,852,38,34020
"Hague city, North Dakota",29,29,0,108,38,34180
"Halliday city, North Dakota",178,178,0,316,38,34340
"Hamberg city, North Dakota",7,7,0,15,38,34460
"Hamilton city, North Dakota",21,21,0,30,38,34620
"Hampden city, North Dakota",11,11,0,29,38,34860
"Hankinson city, North Dakota",302,291,11,790,38,34900
"Hannaford city, North Dakota",51,51,0,87,38,35020
"Hannah city, North Dakota",6,6,0,11,38,35060
"Hansboro city, North Dakota",6,6,0,23,38,35140
"Harmon CDP, North Dakota",111,111,0,235,38,35500
"Harvey city, North Dakota",837,820,17,1767,38,35900
"Harwood city, North Dakota",383,380,3,759,38,35940
"Hatton city, North Dakota",339,330,9,642,38,36100
"Havana city, North Dakota",33,33,0,88,38,36140
"Haynes city, North Dakota",25,25,0,38,38,36540
"Hazelton city, North Dakota",110,108,2,214,38,36700
"Hazen city, North Dakota",1209,1159,50,2569,38,36780
"Hebron city, North Dakota",322,319,3,754,38,36860
"Heil CDP, North Dakota",0,0,0,4,38,36980
"Heimdal CDP, North Dakota",31,31,0,39,38,37020
"Hettinger city, North Dakota",536,529,7,1096,38,37700
"Hillsboro city, North Dakota",898,884,14,1655,38,38100
"Hoople city, North Dakota",118,110,8,239,38,38780
"Hope city, North Dakota",147,139,8,316,38,38860
"Horace city, North Dakota",1853,1841,12,3464,38,38900
"Hunter city, North Dakota",167,163,4,283,38,39460
"Hurdsfield city, North Dakota",16,16,0,25,38,39580
"Inkster city, North Dakota",16,16,0,26,38,39980
"Jamestown city, North Dakota",8294,7823,471,15850,38,40580
"Jessie CDP, North Dakota",19,15,4,52,38,40740
"Jud city, North Dakota",21,21,0,47,38,41180
"Karlsruhe city, North Dakota",27,23,4,54,38,41380
"Kathryn city, North Dakota",23,23,0,82,38,41500
"Kenmare city, North Dakota",540,529,11,1016,38,42020
"Kensal city, North Dakota",139,139,0,277,38,42180
"Kief city, North Dakota",12,12,0,13,38,42660
"Killdeer city, North Dakota",372,364,8,757,38,42700
"Kindred city, North Dakota",540,521,19,957,38,42780
"Knox city, North Dakota",1,0,1,30,38,43260
"Kramer city, North Dakota",7,7,0,25,38,43500
"Kulm city, North Dakota",250,242,8,467,38,43580
"Lakota city, North Dakota",290,282,8,655,38,44300
"LaMoure city, North Dakota",394,388,6,674,38,44540
"Landa city, North Dakota",58,41,17,105,38,44700
"Langdon city, North Dakota",790,790,0,1717,38,44780
"Lankin city, North Dakota",45,45,0,115,38,44860
"Lansford city, North Dakota",103,100,3,230,38,44900
"Larimore city, North Dakota",655,645,10,1343,38,45020
"Larson CDP, North Dakota",0,0,0,4,38,45220
"Lawton city, North Dakota",10,10,0,18,38,45300
"Leal city, North Dakota",3,3,0,9,38,45460
"Leeds city, North Dakota",239,233,6,438,38,45580
"Lehr city, North Dakota",44,42,2,73,38,45740
"Leith city, North Dakota",22,21,1,31,38,45860
"Leonard city, North Dakota",143,135,8,260,38,45980
"Lidgerwood city, North Dakota",347,339,8,713,38,46460
"Lignite city, North Dakota",77,77,0,200,38,46540
"Lincoln city, North Dakota",2475,2412,63,4209,38,46640
"Linton city, North Dakota",442,427,15,886,38,46980
"Lisbon city, North Dakota",925,883,42,2159,38,47100
"Litchville city, North Dakota",53,53,0,152,38,47140
"Logan CDP, North Dakota",102,102,0,258,38,47540
"Loma city, North Dakota",8,8,0,24,38,47660
"Long Creek CDP, North Dakota",10,10,0,49,38,47796
"Loraine city, North Dakota",6,6,0,8,38,48020
"Ludden city, North Dakota",18,18,0,27,38,48460
"Luverne city, North Dakota",17,17,0,33,38,48580
"McClusky city, North Dakota",169,166,3,307,38,49020
"McGregor CDP, North Dakota",111,111,0,111,38,49220
"McHenry city, North Dakota",21,21,0,58,38,49260
"McLeod CDP, North Dakota",22,22,0,42,38,49540
"McVille city, North Dakota",173,173,0,341,38,49580
"Maddock city, North Dakota",159,155,4,369,38,49620
"Makoti city, North Dakota",35,33,2,86,38,49820
"Mandan city, North Dakota",13962,13681,281,24049,38,49900
"Mandaree CDP, North Dakota",181,170,11,684,38,49980
"Manning CDP, North Dakota",22,22,0,50,38,50220
"Mantador city, North Dakota",22,22,0,34,38,50380
"Manvel city, North Dakota",216,213,3,417,38,50420
"Mapleton city, North Dakota",693,681,12,1151,38,50580
"Marion city, North Dakota",50,49,1,119,38,50780
"Marmarth city, North Dakota",38,37,1,93,38,50860
"Martin city, North Dakota",40,40,0,57,38,51060
"Max city, North Dakota",83,83,0,185,38,51380
"Maxbass city, North Dakota",53,53,0,98,38,51420
"Mayville city, North Dakota",1143,1102,41,2102,38,51500
"Medina city, North Dakota",128,128,0,253,38,51860
"Medora city, North Dakota",79,75,4,151,38,51900
"Menoken CDP, North Dakota",35,34,1,64,38,52180
"Mercer city, North Dakota",68,64,4,109,38,52340
"Michigan City city, North Dakota",213,213,0,312,38,52740
"Milnor city, North Dakota",428,426,2,666,38,52940
"Milton city, North Dakota",37,36,1,60,38,53020
"Minnewaukan city, North Dakota",112,109,3,163,38,53220
"Minot city, North Dakota",26197,25216,981,48038,38,53380
"Minot AFB CDP, North Dakota",827,796,31,4943,38,53420
"Minto city, North Dakota",348,324,24,608,38,53540
"Mohall city, North Dakota",259,253,6,609,38,53780
"Monango city, North Dakota",9,9,0,19,38,53820
"Montpelier city, North Dakota",54,54,0,99,38,53980
"Mooreton city, North Dakota",79,78,1,157,38,54220
"Mott city, North Dakota",281,278,3,616,38,54620
"Mountain city, North Dakota",10,8,2,97,38,54740
"Munich city, North Dakota",172,171,1,337,38,55020
"Mylo city, North Dakota",5,5,0,12,38,55220
"Napoleon city, North Dakota",395,393,2,808,38,55420
"Nash CDP, North Dakota",7,7,0,7,38,55500
"Neche city, North Dakota",168,160,8,390,38,55620
"Nekoma city, North Dakota",7,7,0,18,38,55740
"Newburg city, North Dakota",33,31,2,61,38,56020
"New England city, North Dakota",404,376,28,810,38,56180
"New Leipzig city, North Dakota",86,85,1,159,38,56420
"New Rockford city, North Dakota",706,685,21,1421,38,56620
"New Salem city, North Dakota",470,455,15,939,38,56700
"New Town city, North Dakota",1116,1072,44,2714,38,56740
"Niagara city, North Dakota",17,17,0,31,38,56780
"Nome city, North Dakota",27,27,0,51,38,57180
"Noonan city, North Dakota",73,62,11,142,38,57220
"North River city, North Dakota",19,19,0,51,38,58120
"Northwood city, North Dakota",435,435,0,936,38,58300
"Oakes city, North Dakota",1194,1146,48,2125,38,58740
"Oberon city, North Dakota",15,15,0,38,38,59020
"Oriska city, North Dakota",91,87,4,193,38,59660
"Orrin CDP, North Dakota",0,0,0,0,38,59820
"Osnabrock city, North Dakota",49,48,1,175,38,60100
"Overly city, North Dakota",1,1,0,16,38,60380
"Oxbow city, North Dakota",200,200,0,354,38,60480
"Page city, North Dakota",110,105,5,193,38,60500
"Palermo city, North Dakota",63,62,1,131,38,60620
"Park River city, North Dakota",711,704,7,1556,38,60900
"Parshall city, North Dakota",483,471,12,1217,38,60940
"Pekin city, North Dakota",20,18,2,68,38,61460
"Pembina city, North Dakota",265,252,13,552,38,61580
"Perth city, North Dakota",17,17,0,17,38,61780
"Petersburg city, North Dakota",49,49,0,131,38,61860
"Pettibone city, North Dakota",23,23,0,61,38,62060
"Pick City city, North Dakota",49,43,6,105,38,62260
"Pillsbury city, North Dakota",0,0,0,9,38,62540
"Pingree city, North Dakota",40,40,0,70,38,62620
"Pisek city, North Dakota",44,43,1,112,38,62780
"Plaza city, North Dakota",95,95,0,231,38,62980
"Porcupine CDP, North Dakota",37,27,10,116,38,63700
"Portal city, North Dakota",72,66,6,130,38,63740
"Portland city, North Dakota",279,275,4,562,38,63900
"Powers Lake city, North Dakota",124,115,9,252,38,64140
"Prairie Rose city, North Dakota",14,14,0,36,38,64320
"Raleigh CDP, North Dakota",8,8,0,10,38,65100
"Ray city, North Dakota",384,383,1,768,38,65580
"Reeder city, North Dakota",26,26,0,86,38,65900
"Regan city, North Dakota",45,45,0,88,38,65980
"Regent city, North Dakota",91,91,0,149,38,66020
"Reile's Acres city, North Dakota",569,514,55,914,38,66040
"Reynolds city, North Dakota",244,239,5,396,38,66260
"Rhame city, North Dakota",76,71,5,181,38,66300
"Richardton city, North Dakota",422,422,0,768,38,66500
"Riverdale city, North Dakota",96,96,0,182,38,66980
"Robinson city, North Dakota",27,21,6,46,38,67180
"Rocklake city, North Dakota",88,88,0,107,38,67500
"Rogers city, North Dakota",35,33,2,41,38,67620
"Rolette city, North Dakota",177,177,0,456,38,67780
"Rolla city, North Dakota",493,447,46,1190,38,67820
"Ross city, North Dakota",112,104,8,188,38,68540
"Rugby city, North Dakota",1270,1262,8,2654,38,68860
"Ruso city, North Dakota",2,2,0,4,38,69140
"Ruthville CDP, North Dakota",75,69,6,142,38,69300
"Rutland city, North Dakota",42,41,1,82,38,69340
"Ryder city, North Dakota",44,41,3,114,38,69460
"St. John city, North Dakota",109,105,4,216,38,69980
"St. Thomas city, North Dakota",147,147,0,301,38,70260
"Sanborn city, North Dakota",87,78,9,128,38,70380
"Sarles city, North Dakota",8,8,0,18,38,70780
"Sawyer city, North Dakota",151,150,1,261,38,70980
"Scranton city, North Dakota",144,138,6,369,38,71500
"Selfridge city, North Dakota",117,99,18,219,38,71660
"Selz CDP, North Dakota",62,62,0,66,38,71700
"Sentinel Butte city, North Dakota",22,22,0,45,38,71780
"Sharon city, North Dakota",26,26,0,65,38,71940
"Sheldon city, North Dakota",109,106,3,155,38,72180
"Shell Valley CDP, North Dakota",350,315,35,1183,38,72250
"Sherwood city, North Dakota",96,96,0,236,38,72540
"Sheyenne city, North Dakota",86,84,2,222,38,72580
"Sibley city, North Dakota",6,6,0,18,38,72820
"Solen city, North Dakota",19,16,3,74,38,73820
"Souris city, North Dakota",29,29,0,57,38,74020
"South Heart city, North Dakota",273,273,0,489,38,74185
"Spiritwood CDP, North Dakota",22,22,0,22,38,74660
"Spiritwood Lake city, North Dakota",105,105,0,162,38,74740
"Springbrook city, North Dakota",10,10,0,31,38,74780
"Stanley city, North Dakota",1245,1204,41,2189,38,75380
"Stanton city, North Dakota",226,220,6,548,38,75420
"Starkweather city, North Dakota",13,13,0,33,38,75580
"Steele city, North Dakota",386,386,0,816,38,75780
"Strasburg city, North Dakota",203,198,5,510,38,76500
"Streeter city, North Dakota",41,41,0,90,38,76620
"Surrey city, North Dakota",758,729,29,1583,38,77180
"Sutton CDP, North Dakota",11,11,0,41,38,77260
"Sykeston city, North Dakota",58,50,8,92,38,77660
"Tappen city, North Dakota",114,111,3,286,38,77980
"Taylor city, North Dakota",99,91,8,186,38,78180
"Thompson city, North Dakota",634,633,1,1052,38,78660
"Tioga city, North Dakota",718,683,35,1376,38,78940
"Tolley city, North Dakota",12,12,0,14,38,79140
"Tolna city, North Dakota",55,55,0,149,38,79180
"Tower City city, North Dakota",195,194,1,296,38,79340
"Towner city, North Dakota",230,200,30,456,38,79420
"Trenton CDP, North Dakota",298,298,0,575,38,79460
"Turtle Lake city, North Dakota",228,228,0,503,38,79940
"Tuttle city, North Dakota",27,27,0,53,38,80140
"Underwood city, North Dakota",377,351,26,732,38,80660
"Upham city, North Dakota",83,66,17,183,38,80860
"Valley City city, North Dakota",3406,3271,135,6558,38,81180
"Velva city, North Dakota",502,490,12,1050,38,81620
"Venturia city, North Dakota",3,3,0,16,38,81700
"Verona city, North Dakota",68,68,0,119,38,81900
"Voltaire city, North Dakota",20,20,0,43,38,82380
"Wahpeton city, North Dakota",4443,4319,124,7983,38,82660
"Walcott city, North Dakota",159,155,4,316,38,82780
"Wales city, North Dakota",5,5,0,8,38,82940
"Walhalla city, North Dakota",369,353,16,910,38,82980
"Warwick city, North Dakota",48,48,0,98,38,83580
"Washburn city, North Dakota",804,804,0,1463,38,83700
"Watford City city, North Dakota",3334,3260,74,5900,38,83860
"West Fargo city, North Dakota",23245,23055,190,38653,38,84780
"Westhope city, North Dakota",182,182,0,360,38,85020
"Wheatland CDP, North Dakota",16,16,0,58,38,85180
"White Earth city, North Dakota",35,28,7,76,38,85540
"White Shield CDP, North Dakota",96,94,2,200,38,85660
"Wildrose city, North Dakota",55,55,0,119,38,86020
"Williston city, North Dakota",15479,15030,449,27783,38,86220
"Willow City city, North Dakota",49,49,0,91,38,86380
"Wilton city, North Dakota",332,327,5,675,38,86580
"Wimbledon city, North Dakota",108,90,18,156,38,86620
"Wing city, North Dakota",116,116,0,221,38,86780
"Wishek city, North Dakota",443,443,0,951,38,87020
"Wolford city, North Dakota",7,7,0,33,38,87180
"Woodworth city, North Dakota",21,21,0,46,38,87580
"Wyndmere city, North Dakota",269,257,12,505,38,87740
"York city, North Dakota",13,13,0,14,38,87860
"Ypsilanti CDP, North Dakota",0,0,0,9,38,88020
"Zap city, North Dakota",61,61,0,161,38,88140
"Zeeland city, North Dakota",49,49,0,96,38,88180
"Aberdeen village, Ohio",493,473,20,1298,39,00142
"Ada village, Ohio",2700,2600,100,5088,39,00198
"Adamsville village, Ohio",227,227,0,354,39,00380
"Addyston village, Ohio",393,379,14,896,39,00436
"Adelphi village, Ohio",157,149,8,365,39,00450
"Adena village, Ohio",235,217,18,659,39,00464
"Ai CDP, Ohio",304,304,0,534,39,00541
"Akron city, Ohio",97250,89775,7475,190273,39,01000
"Albany village, Ohio",387,383,4,844,39,01042
"Alexandria village, Ohio",309,295,14,507,39,01154
"Alger village, Ohio",299,289,10,784,39,01210
"Alliance city, Ohio",10412,9996,416,21603,39,01420
"Alvordton CDP, Ohio",38,38,0,140,39,01588
"Amanda village, Ohio",400,372,28,801,39,01630
"Amberley village, Ohio",2018,1918,100,3824,39,01672
"Amelia CDP, Ohio",6486,6381,105,12388,39,01742
"Amesville village, Ohio",68,51,17,160,39,01784
"Amherst city, Ohio",6552,6155,397,12740,39,01798
"Amsterdam village, Ohio",241,219,22,416,39,01938
"Andersonville CDP, Ohio",167,161,6,433,39,02022
"Andover village, Ohio",274,261,13,708,39,02050
"Anna village, Ohio",889,803,86,1625,39,02092
"Ansonia village, Ohio",551,530,21,988,39,02120
"Antioch village, Ohio",20,14,6,47,39,02148
"Antwerp village, Ohio",874,845,29,1811,39,02204
"Apple Creek village, Ohio",578,559,19,1089,39,02232
"Apple Valley CDP, Ohio",2671,2468,203,5217,39,02266
"Aquilla village, Ohio",130,120,10,266,39,02274
"Arcadia village, Ohio",317,313,4,688,39,02316
"Arcanum village, Ohio",1314,1294,20,2790,39,02330
"Archbold village, Ohio",2231,2106,125,4439,39,02344
"Arlington village, Ohio",702,693,9,1613,39,02400
"Arlington Heights village, Ohio",508,457,51,1017,39,02428
"Ashland city, Ohio",9691,9322,369,19270,39,02568
"Ashley village, Ohio",763,741,22,1492,39,02582
"Ashtabula city, Ohio",8132,7028,1104,18003,39,02638
"Ashville village, Ohio",2265,2168,97,4581,39,02680
"Athalia village, Ohio",122,121,1,341,39,02722
"Athens city, Ohio",12222,11309,913,22698,39,02736
"Attica village, Ohio",405,394,11,715,39,02820
"Atwater CDP, Ohio",428,394,34,742,39,02848
"Aurora city, Ohio",8707,8236,471,17227,39,03086
"Austinburg CDP, Ohio",111,57,54,472,39,03142
"Austintown CDP, Ohio",16312,15527,785,30397,39,03184
"Avon city, Ohio",13027,12592,435,24822,39,03352
"Avon Lake city, Ohio",12942,12691,251,25220,39,03464
"Bailey Lakes village, Ohio",215,209,6,331,39,03562
"Bainbridge CDP, Ohio",4616,4444,172,8808,39,03585
"Bainbridge village, Ohio",274,235,39,615,39,03604
"Bairdstown village, Ohio",58,57,1,109,39,03646
"Ballville CDP, Ohio",1829,1733,96,3635,39,03716
"Baltic village, Ohio",376,371,5,896,39,03744
"Baltimore village, Ohio",1395,1305,90,2968,39,03758
"Bannock CDP, Ohio",50,50,0,191,39,03786
"Barberton city, Ohio",11791,10995,796,25167,39,03828
"Barnesville village, Ohio",1667,1626,41,3713,39,03926
"Barnhill village, Ohio",379,347,32,601,39,03940
"Bascom CDP, Ohio",122,122,0,287,39,04094
"Bass Lake CDP, Ohio",448,448,0,755,39,04136
"Batavia village, Ohio",1024,859,165,2606,39,04150
"Batesville village, Ohio",34,34,0,73,39,04192
"Bay View village, Ohio",436,409,27,710,39,04402
"Bay Village city, Ohio",8218,8041,177,16047,39,04416
"Beach City village, Ohio",322,316,6,658,39,04458
"Beachwood city, Ohio",7133,6701,432,13846,39,04500
"Beallsville village, Ohio",155,148,7,392,39,04542
"Beaver village, Ohio",209,197,12,463,39,04696
"Beavercreek city, Ohio",23785,23128,657,46576,39,04720
"Beaverdam village, Ohio",231,226,5,370,39,04752
"Beckett Ridge CDP, Ohio",5392,5157,235,9880,39,04840
"Bedford city, Ohio",6743,6299,444,13043,39,04878
"Bedford Heights city, Ohio",5722,5369,353,10933,39,04920
"Beechwood Trails CDP, Ohio",1651,1633,18,2905,39,05013
"Bellaire village, Ohio",1810,1642,168,3878,39,05074
"Bellbrook city, Ohio",3863,3825,38,7321,39,05102
"Belle Center village, Ohio",393,367,26,709,39,05116
"Bellefontaine city, Ohio",6620,6397,223,13785,39,05130
"Belle Valley village, Ohio",70,70,0,154,39,05158
"Bellevue city, Ohio",3921,3714,207,8210,39,05228
"Bellville village, Ohio",953,934,19,1995,39,05284
"Belmont village, Ohio",157,146,11,350,39,05312
"Belmore village, Ohio",42,38,4,94,39,05396
"Beloit village, Ohio",643,617,26,1140,39,05410
"Belpre city, Ohio",3095,2975,120,6690,39,05424
"Bentleyville village, Ohio",308,306,2,699,39,05550
"Benton Ridge village, Ohio",285,280,5,480,39,05662
"Bentonville CDP, Ohio",117,117,0,189,39,05676
"Berea city, Ohio",9579,9118,461,18550,39,05690
"Bergholz village, Ohio",225,218,7,538,39,05718
"Berkey village, Ohio",146,146,0,310,39,05732
"Berlin CDP, Ohio",679,679,0,1207,39,05816
"Berlin Heights village, Ohio",338,320,18,731,39,05900
"Bethel village, Ohio",1081,975,106,2638,39,06068
"Bethesda village, Ohio",548,518,30,1237,39,06138
"Bettsville village, Ohio",350,342,8,693,39,06194
"Beulah Beach CDP, Ohio",51,38,13,67,39,06208
"Beverly village, Ohio",706,690,16,1641,39,06222
"Bexley city, Ohio",6793,6554,239,13537,39,06278
"Bidwell CDP, Ohio",494,494,0,1036,39,06320
"Birmingham CDP, Ohio",74,74,0,118,39,06502
"Blacklick Estates CDP, Ohio",4574,4234,340,9010,39,06670
"Bladensburg CDP, Ohio",136,136,0,263,39,06740
"Blaine CDP, Ohio",306,306,0,450,39,06754
"Blakeslee village, Ohio",50,50,0,96,39,06810
"Blanchester village, Ohio",2245,1971,274,4640,39,06908
"Bloomdale village, Ohio",307,301,6,626,39,07062
"Bloomingburg village, Ohio",420,393,27,954,39,07188
"Bloomingdale village, Ohio",45,43,2,99,39,07202
"Bloomingville CDP, Ohio",52,52,0,89,39,07258
"Bloomville village, Ohio",456,415,41,869,39,07286
"Blue Ash city, Ohio",7026,6940,86,13325,39,07300
"Blue Jay CDP, Ohio",811,811,0,1815,39,07377
"Bluffton village, Ohio",1635,1541,94,3540,39,07426
"Bolindale CDP, Ohio",840,824,16,2008,39,07583
"Bolivar village, Ohio",489,484,5,1007,39,07594
"Bolton CDP, Ohio",262,262,0,711,39,07608
"Boston Heights village, Ohio",613,585,28,1242,39,07790
"Botkins village, Ohio",518,506,12,999,39,07832
"Bourneville CDP, Ohio",107,107,0,397,39,07888
"Bowerston village, Ohio",148,145,3,473,39,07916
"Bowersville village, Ohio",139,135,4,293,39,07930
"Bowling Green city, Ohio",17674,16551,1123,30157,39,07972
"Bradford village, Ohio",999,953,46,1854,39,08084
"Bradner village, Ohio",545,517,28,1167,39,08112
"Brady Lake CDP, Ohio",510,386,124,868,39,08168
"Brandt CDP, Ohio",54,54,0,215,39,08308
"Bratenahl village, Ohio",799,788,11,1422,39,08336
"Brecksville city, Ohio",7397,6948,449,13618,39,08364
"Brecon CDP, Ohio",163,138,25,559,39,08378
"Bremen village, Ohio",829,804,25,1633,39,08392
"Brewster village, Ohio",950,927,23,2093,39,08504
"Brice village, Ohio",93,47,46,167,39,08532
"Bridgeport village, Ohio",720,660,60,1449,39,08560
"Bridgetown CDP, Ohio",7131,6910,221,13526,39,08602
"Brilliant CDP, Ohio",531,510,21,1068,39,08812
"Brimfield CDP, Ohio",1924,1889,35,3146,39,08826
"Broadview Heights city, Ohio",10725,10554,171,19815,39,09064
"Brookfield Center CDP, Ohio",541,526,15,1255,39,09200
"Brooklyn city, Ohio",5670,5293,377,11259,39,09246
"Brooklyn Heights village, Ohio",764,753,11,1500,39,09274
"Brook Park city, Ohio",9590,9080,510,18509,39,09288
"Brookside village, Ohio",398,386,12,665,39,09316
"Brookville city, Ohio",2690,2605,85,6035,39,09358
"Broughton village, Ohio",40,40,0,89,39,09386
"Brownsville CDP, Ohio",50,0,50,378,39,09596
"Brunersburg CDP, Ohio",230,194,36,414,39,09652
"Brunswick city, Ohio",19850,19387,463,35304,39,09680
"Bryan city, Ohio",4371,4231,140,8670,39,09792
"Buchtel village, Ohio",205,195,10,411,39,09834
"Buckeye Lake village, Ohio",1439,1415,24,2517,39,09890
"Buckland village, Ohio",130,130,0,258,39,09974
"Bucyrus city, Ohio",5442,5029,413,11643,39,10030
"Buffalo CDP, Ohio",332,332,0,794,39,10128
"Buford CDP, Ohio",251,205,46,439,39,10156
"Burbank village, Ohio",145,137,8,312,39,10254
"Burgoon village, Ohio",120,112,8,225,39,10282
"Burkettsville village, Ohio",163,163,0,292,39,10296
"Burlington CDP, Ohio",1173,1162,11,2780,39,10352
"Burton village, Ohio",881,829,52,1642,39,10436
"Butler village, Ohio",578,571,7,1212,39,10632
"Butlerville village, Ohio",105,94,11,213,39,10674
"Byesville village, Ohio",987,927,60,2258,39,10716
"Cadiz village, Ohio",1059,1059,0,3074,39,10800
"Cairo village, Ohio",422,408,14,645,39,10884
"Calcutta CDP, Ohio",2018,1972,46,4049,39,10926
"Caldwell village, Ohio",867,831,36,2110,39,10940
"Caledonia village, Ohio",203,194,9,444,39,10954
"Cambridge city, Ohio",4586,4469,117,10087,39,10996
"Camden village, Ohio",747,712,35,1977,39,11024
"Campbell city, Ohio",3551,3073,478,7819,39,11066
"Camp Dennison CDP, Ohio",181,181,0,363,39,11150
"Canal Fulton city, Ohio",2819,2701,118,5315,39,11304
"Canal Lewisville CDP, Ohio",308,228,80,761,39,11318
"Canal Winchester city, Ohio",5029,4903,126,9357,39,11332
"Candlewood Lake CDP, Ohio",595,595,0,1181,39,11334
"Canfield city, Ohio",3908,3659,249,7662,39,11360
"Canton city, Ohio",31827,28949,2878,70589,39,12000
"Carbon Hill CDP, Ohio",79,69,10,117,39,12056
"Cardington village, Ohio",1072,1056,16,1925,39,12084
"Carey village, Ohio",1805,1724,81,3518,39,12112
"Carlisle village, Ohio",2858,2730,128,5488,39,12168
"Carroll village, Ohio",281,272,9,443,39,12252
"Carrollton village, Ohio",1608,1590,18,3270,39,12280
"Casstown village, Ohio",163,155,8,269,39,12462
"Castalia village, Ohio",458,448,10,1108,39,12476
"Castine village, Ohio",45,45,0,121,39,12504
"Catawba village, Ohio",114,108,6,255,39,12560
"Cecil village, Ohio",66,64,2,136,39,12700
"Cedarville village, Ohio",2089,1898,191,3915,39,12784
"Celeryville CDP, Ohio",46,46,0,106,39,12854
"Celina city, Ohio",5777,5663,114,10974,39,12868
"Centerburg village, Ohio",821,799,22,1875,39,13036
"Centerville (Thurman) village, Ohio",17,17,0,54,39,13169
"Centerville city, Ohio",12613,12204,409,24510,39,13190
"Chagrin Falls village, Ohio",2119,2043,76,4116,39,13358
"Champion Heights CDP, Ohio",3347,3113,234,6347,39,13484
"Chardon city, Ohio",2445,2375,70,5248,39,13554
"Chatfield village, Ohio",92,61,31,243,39,13694
"Chauncey village, Ohio",394,381,13,874,39,13778
"Cherry Fork CDP, Ohio",14,14,0,35,39,13834
"Cherry Grove CDP, Ohio",2334,2296,38,4170,39,13848
"Chesapeake village, Ohio",646,627,19,1163,39,13904
"Cheshire village, Ohio",54,54,0,114,39,13932
"Chesterhill village, Ohio",156,148,8,320,39,14086
"Chesterland CDP, Ohio",3790,3576,214,7317,39,14100
"Chesterville village, Ohio",80,72,8,189,39,14114
"Cheviot city, Ohio",4624,4331,293,8682,39,14128
"Chickasaw village, Ohio",141,141,0,302,39,14156
"Chillicothe city, Ohio",10058,9299,759,22002,39,14184
"Chilo village, Ohio",7,7,0,18,39,14226
"Chippewa Lake village, Ohio",445,434,11,704,39,14254
"Chippewa Park CDP, Ohio",316,271,45,650,39,14280
"Choctaw Lake CDP, Ohio",1368,1358,10,2180,39,14288
"Christiansburg village, Ohio",300,287,13,594,39,14296
"Churchill CDP, Ohio",1086,1028,58,2115,39,14324
"Cincinnati city, Ohio",165938,154529,11409,308870,39,15000
"Cinnamon Lake CDP, Ohio",473,463,10,1027,39,15008
"Circleville city, Ohio",6088,5523,565,14017,39,15070
"Clarington village, Ohio",131,123,8,316,39,15210
"Clarksburg village, Ohio",258,186,72,667,39,15336
"Clarksville village, Ohio",273,240,33,501,39,15406
"Clarktown CDP, Ohio",313,308,5,664,39,15434
"Clay Center village, Ohio",124,113,11,357,39,15588
"Clayton city, Ohio",6979,6783,196,13292,39,15644
"Cleveland city, Ohio",178997,157682,21315,370365,39,16000
"Cleveland Heights city, Ohio",24122,22314,1808,45002,39,16014
"Cleves village, Ohio",1719,1623,96,3395,39,16028
"Clifton village, Ohio",104,103,1,141,39,16056
"Clinton village, Ohio",678,645,33,1171,39,16182
"Cloverdale village, Ohio",56,56,0,148,39,16266
"Clyde city, Ohio",3345,3108,237,6314,39,16308
"Coal Grove village, Ohio",998,894,104,2047,39,16378
"Coalton village, Ohio",184,117,67,403,39,16434
"Coldstream CDP, Ohio",759,734,25,1502,39,16521
"Coldwater village, Ohio",2420,2396,24,4511,39,16532
"College Corner village, Ohio",144,128,16,295,39,16700
"Collins CDP, Ohio",235,235,0,442,39,16784
"Columbiana city, Ohio",3377,3338,39,6688,39,17036
"Columbus city, Ohio",510057,483481,26576,902449,39,18000
"Columbus Grove village, Ohio",772,719,53,1678,39,18014
"Commercial Point village, Ohio",1533,1521,12,3033,39,18070
"Concorde Hills CDP, Ohio",283,283,0,568,39,18244
"Conesville village, Ohio",97,94,3,205,39,18266
"Congress village, Ohio",32,31,1,106,39,18308
"Conneaut city, Ohio",5451,4796,655,12372,39,18350
"Connorville CDP, Ohio",41,41,0,106,39,18420
"Continental village, Ohio",582,572,10,1299,39,18504
"Convoy village, Ohio",481,454,27,976,39,18546
"Coolville village, Ohio",330,306,24,615,39,18588
"Corning village, Ohio",162,148,14,474,39,18770
"Cortland city, Ohio",3244,3193,51,7073,39,18812
"Corwin village, Ohio",263,247,16,536,39,18840
"Coshocton city, Ohio",5353,4861,492,11054,39,18868
"Covedale CDP, Ohio",3072,3053,19,6426,39,19008
"Covington village, Ohio",1187,1148,39,2561,39,19050
"Craig Beach village, Ohio",718,704,14,1512,39,19106
"Crestline village, Ohio",2240,2116,124,4490,39,19330
"Creston village, Ohio",1043,999,44,2072,39,19344
"Cridersville village, Ohio",990,918,72,2093,39,19400
"Crooksville village, Ohio",871,829,42,2311,39,19456
"Crown City village, Ohio",167,157,10,522,39,19554
"Crystal Lakes CDP, Ohio",662,597,65,1605,39,19596
"Crystal Rock CDP, Ohio",58,58,0,108,39,19615
"Cumberland village, Ohio",162,154,8,323,39,19694
"Curtice CDP, Ohio",924,919,5,1501,39,19736
"Custar village, Ohio",129,124,5,252,39,19750
"Cuyahoga Falls city, Ohio",29590,28287,1303,50916,39,19778
"Cuyahoga Heights village, Ohio",329,301,28,627,39,19806
"Cygnet village, Ohio",274,266,8,479,39,19820
"Cynthiana CDP, Ohio",0,0,0,23,39,19848
"Dalton village, Ohio",842,831,11,1703,39,19974
"Damascus CDP, Ohio",111,111,0,199,39,20030
"Danville village, Ohio",339,325,14,784,39,20114
"Darbydale CDP, Ohio",360,327,33,823,39,20198
"Darbyville village, Ohio",118,117,1,265,39,20212
"Darrtown CDP, Ohio",363,363,0,679,39,20268
"Day Heights CDP, Ohio",1147,1103,44,2282,39,20366
"Dayton city, Ohio",64715,58256,6459,137305,39,21000
"Deer Park city, Ohio",3503,3397,106,5399,39,21266
"Deersville village, Ohio",27,27,0,42,39,21294
"Defiance city, Ohio",8556,8081,475,16852,39,21308
"De Graff village, Ohio",848,815,33,1519,39,21378
"Delaware city, Ohio",23445,22698,747,41926,39,21434
"Delhi Hills CDP, Ohio",2870,2800,70,5098,39,21518
"Dellroy village, Ohio",114,111,3,287,39,21560
"Delphos city, Ohio",3595,3349,246,7153,39,21602
"Delshire CDP, Ohio",1850,1647,203,3575,39,21610
"Delta village, Ohio",1279,1232,47,2813,39,21616
"Dennison village, Ohio",1320,1157,163,2657,39,21714
"Dent CDP, Ohio",5806,5542,264,11666,39,21742
"Derby CDP, Ohio",212,212,0,536,39,21784
"Deshler village, Ohio",939,893,46,1679,39,21812
"Devola CDP, Ohio",1350,1290,60,2669,39,21868
"Dexter City village, Ohio",65,57,8,120,39,21910
"Dillonvale CDP, Ohio",1859,1818,41,3316,39,22008
"Dillonvale village, Ohio",280,257,23,639,39,22022
"Dola CDP, Ohio",72,69,3,136,39,22260
"Donnelsville village, Ohio",173,166,7,372,39,22288
"Dover city, Ohio",6596,6252,344,13118,39,22456
"Doylestown village, Ohio",1395,1353,42,3049,39,22568
"Dresden village, Ohio",747,724,23,1709,39,22610
"Drexel CDP, Ohio",419,300,119,1365,39,22624
"Dry Ridge CDP, Ohio",1764,1671,93,3514,39,22660
"Dry Run CDP, Ohio",3716,3637,79,7417,39,22674
"Dublin city, Ohio",25706,24953,753,48893,39,22694
"Duncan Falls CDP, Ohio",767,732,35,1577,39,22820
"Dundee CDP, Ohio",414,243,171,414,39,22848
"Dunkirk village, Ohio",409,386,23,813,39,22946
"Dunlap CDP, Ohio",568,559,9,1155,39,22960
"Dupont village, Ohio",126,124,2,312,39,22974
"East Alliance CDP, Ohio",57,48,9,115,39,23254
"East Canton village, Ohio",728,711,17,1420,39,23324
"East Cleveland city, Ohio",5812,4690,1122,13926,39,23380
"East Fultonham CDP, Ohio",56,56,0,143,39,23534
"Eastlake city, Ohio",9666,9102,564,17625,39,23618
"East Liberty CDP, Ohio",153,153,0,404,39,23702
"East Liverpool city, Ohio",4002,3757,245,9969,39,23730
"East Palestine village, Ohio",2171,2091,80,4723,39,23940
"East Rochester CDP, Ohio",57,57,0,152,39,24024
"East Sparta village, Ohio",502,473,29,996,39,24052
"East Springfield CDP, Ohio",40,40,0,111,39,24066
"Eaton city, Ohio",4060,3994,66,8360,39,24234
"Eaton Estates CDP, Ohio",500,500,0,1191,39,24262
"Edgerton village, Ohio",1067,974,93,2009,39,24486
"Edgewood CDP, Ohio",2051,1941,110,4381,39,24542
"Edison village, Ohio",239,229,10,497,39,24598
"Edon village, Ohio",491,466,25,902,39,24640
"Eldorado village, Ohio",402,382,20,707,39,24766
"Elgin village, Ohio",72,70,2,109,39,24794
"Elida village, Ohio",1104,1037,67,2174,39,24808
"Elizabethtown CDP, Ohio",148,138,10,280,39,24850
"Elmore village, Ohio",761,761,0,1601,39,25144
"Elmwood Place village, Ohio",862,803,59,2312,39,25186
"Elyria city, Ohio",26577,25276,1301,52780,39,25256
"Empire village, Ohio",117,112,5,231,39,25368
"Englewood city, Ohio",6329,6036,293,13433,39,25396
"Enon village, Ohio",1150,1123,27,2509,39,25452
"Etna CDP, Ohio",537,523,14,958,39,25676
"Euclid city, Ohio",24877,22762,2115,49279,39,25704
"Evendale village, Ohio",1198,1172,26,2663,39,25802
"Fairborn city, Ohio",17738,16876,862,34494,39,25914
"Fairfax village, Ohio",995,956,39,1661,39,25942
"Fairfield city, Ohio",24323,23014,1309,44602,39,25970
"Fairfield Beach CDP, Ohio",612,542,70,1250,39,26110
"Fairlawn city, Ohio",4636,4554,82,7697,39,26166
"Fairport Harbor village, Ohio",1656,1560,96,3100,39,26306
"Fairview village, Ohio",13,9,4,44,39,26348
"Fairview Park city, Ohio",10211,9874,337,17137,39,26446
"Farmersville village, Ohio",465,442,23,1022,39,26656
"Fayette village, Ohio",609,577,32,1177,39,26768
"Fayetteville village, Ohio",135,135,0,241,39,26796
"Felicity village, Ohio",196,153,43,502,39,26880
"Findlay city, Ohio",20839,19950,889,40408,39,27048
"Finneytown CDP, Ohio",6730,6366,364,12870,39,27104
"Five Points CDP, Ohio",746,689,57,1652,39,27303
"Flat Rock CDP, Ohio",160,160,0,293,39,27356
"Fletcher village, Ohio",241,232,9,382,39,27412
"Florida village, Ohio",131,131,0,258,39,27538
"Flushing village, Ohio",473,442,31,967,39,27552
"Forest village, Ohio",812,787,25,1455,39,27636
"Forest Park city, Ohio",11029,10607,422,20005,39,27706
"Forestville CDP, Ohio",5368,5062,306,10724,39,27776
"Fort Jennings village, Ohio",235,230,5,405,39,27818
"Fort Loramie village, Ohio",803,793,10,1494,39,27832
"Fort McKinley CDP, Ohio",2366,2107,259,4236,39,27846
"Fort Recovery village, Ohio",1034,1007,27,1955,39,27902
"Fort Seneca CDP, Ohio",47,40,7,118,39,27930
"Fort Shawnee CDP, Ohio",3474,3368,106,6379,39,27944
"Fostoria city, Ohio",6243,5878,365,12904,39,28014
"Four Bridges CDP, Ohio",1581,1521,60,3511,39,28058
"Frankfort village, Ohio",490,486,4,1231,39,28182
"Franklin city, Ohio",5805,5577,228,11672,39,28476
"Franklin Furnace CDP, Ohio",601,586,15,1896,39,28532
"Frazeysburg village, Ohio",622,584,38,1335,39,28574
"Fredericksburg village, Ohio",215,214,1,422,39,28616
"Fredericktown village, Ohio",1385,1340,45,2642,39,28658
"Freeport village, Ohio",216,204,12,464,39,28798
"Fremont city, Ohio",7267,6789,478,15900,39,28826
"Fresno CDP, Ohio",12,12,0,46,39,28882
"Friendship CDP, Ohio",278,278,0,577,39,28896
"Fruit Hill CDP, Ohio",2275,2213,62,4157,39,28966
"Fulton village, Ohio",192,189,3,374,39,29050
"Fultonham village, Ohio",69,69,0,139,39,29064
"Gahanna city, Ohio",19436,19017,419,35529,39,29106
"Galena village, Ohio",631,612,19,1205,39,29148
"Galion city, Ohio",4887,4535,352,10378,39,29162
"Gallipolis village, Ohio",1029,967,62,3337,39,29204
"Gambier village, Ohio",927,893,34,2000,39,29246
"Gann (Brinkhaven) village, Ohio",77,75,2,117,39,29288
"Garfield Heights city, Ohio",14867,13410,1457,29497,39,29428
"Garrettsville village, Ohio",1323,1146,177,2591,39,29442
"Gates Mills village, Ohio",1061,1012,49,2158,39,29498
"Geneva city, Ohio",3053,2806,247,5935,39,29610
"Geneva-on-the-Lake village, Ohio",539,502,37,1085,39,29652
"Genoa village, Ohio",1124,1099,25,2039,39,29722
"Georgetown village, Ohio",1525,1485,40,4323,39,29778
"Germantown city, Ohio",3034,2834,200,5784,39,29932
"Gettysburg village, Ohio",231,223,8,574,39,29974
"Gibsonburg village, Ohio",1299,1277,22,2572,39,30072
"Gilboa village, Ohio",103,103,0,230,39,30114
"Girard city, Ohio",4485,4192,293,9565,39,30198
"Glandorf village, Ohio",589,584,5,1028,39,30282
"Glencoe CDP, Ohio",60,60,0,112,39,30352
"Glendale village, Ohio",1073,1030,43,2154,39,30380
"Glenford village, Ohio",164,160,4,271,39,30436
"Glenmont village, Ohio",159,143,16,295,39,30506
"Glenmoor CDP, Ohio",1385,1352,33,2029,39,30520
"Glenwillow village, Ohio",364,337,27,849,39,30632
"Gloria Glens Park village, Ohio",297,279,18,414,39,30660
"Glouster village, Ohio",565,539,26,1559,39,30674
"Gnadenhutten village, Ohio",759,732,27,1383,39,30702
"Golf Manor village, Ohio",2099,2046,53,3786,39,30786
"Gomer CDP, Ohio",113,105,8,192,39,30814
"Good Hope CDP, Ohio",85,85,0,260,39,30828
"Gordon village, Ohio",135,124,11,247,39,30912
"Goshen CDP, Ohio",446,446,0,756,39,30996
"Grafton village, Ohio",1423,1351,72,5730,39,31150
"Grand Rapids village, Ohio",578,578,0,1033,39,31206
"Grand River village, Ohio",461,447,14,677,39,31234
"Grandview CDP, Ohio",896,775,121,1351,39,31262
"Grandview Heights city, Ohio",5274,5180,94,8258,39,31304
"Granville village, Ohio",2680,2605,75,5778,39,31402
"Granville South CDP, Ohio",565,565,0,1168,39,31434
"Gratiot village, Ohio",145,130,15,231,39,31458
"Gratis village, Ohio",330,330,0,703,39,31472
"Graysville village, Ohio",23,23,0,77,39,31542
"Green city, Ohio",13881,13431,450,27333,39,31860
"Green Camp village, Ohio",230,227,3,447,39,31948
"Greenfield village, Ohio",1765,1648,117,4237,39,32088
"Greenhills village, Ohio",1837,1801,36,3703,39,32158
"Green Meadows CDP, Ohio",1178,1094,84,2191,39,32207
"Green Springs village, Ohio",701,686,15,1309,39,32256
"Greentown CDP, Ohio",1752,1677,75,3541,39,32298
"Greenville city, Ohio",5703,5473,230,12768,39,32340
"Greenwich village, Ohio",680,634,46,1361,39,32368
"Groesbeck CDP, Ohio",4620,4488,132,8379,39,32536
"Grove City city, Ohio",22790,22235,555,41423,39,32592
"Groveport city, Ohio",3030,2980,50,5928,39,32606
"Grover Hill village, Ohio",166,155,11,461,39,32620
"Guilford Lake CDP, Ohio",396,376,20,956,39,32680
"Hamburg CDP, Ohio",222,222,0,382,39,32928
"Hamden village, Ohio",322,295,27,679,39,32956
"Hamersville village, Ohio",310,294,16,642,39,32984
"Hamilton city, Ohio",30054,27963,2091,63149,39,33012
"Hamler village, Ohio",283,257,26,577,39,33096
"Hanging Rock village, Ohio",77,75,2,145,39,33194
"Hannibal CDP, Ohio",61,61,0,177,39,33222
"Hanover village, Ohio",522,511,11,1123,39,33292
"Hanoverton village, Ohio",172,171,1,337,39,33306
"Harbor Hills CDP, Ohio",798,774,24,1635,39,33362
"Harbor View village, Ohio",58,58,0,124,39,33376
"Harpster village, Ohio",82,82,0,261,39,33656
"Harrisburg village, Ohio",197,197,0,404,39,33740
"Harrisburg CDP, Ohio",105,105,0,224,39,33768
"Harrison city, Ohio",7621,7554,67,13086,39,33838
"Harrisville village, Ohio",78,68,10,151,39,34090
"Harrod village, Ohio",288,269,19,484,39,34118
"Hartford (Croton) village, Ohio",208,179,29,400,39,34202
"Hartville village, Ohio",1679,1662,17,3318,39,34328
"Harveysburg village, Ohio",478,474,4,777,39,34384
"Haskins village, Ohio",686,664,22,1249,39,34412
"Haviland village, Ohio",81,81,0,216,39,34552
"Haydenville CDP, Ohio",112,107,5,374,39,34594
"Hayesville village, Ohio",294,284,10,599,39,34636
"Heath city, Ohio",4791,4636,155,10492,39,34748
"Hebron village, Ohio",1341,1268,73,2485,39,34790
"Helena village, Ohio",145,136,9,274,39,34860
"Hemlock village, Ohio",142,138,4,258,39,34888
"Hessville CDP, Ohio",41,41,0,60,39,35028
"Hicksville village, Ohio",1553,1505,48,3114,39,35098
"Hidden Lakes CDP, Ohio",0,0,0,0,39,35119
"Hide-A-Way Hills CDP, Ohio",409,376,33,978,39,35126
"Higginsport village, Ohio",131,116,15,287,39,35168
"Highland village, Ohio",73,73,0,131,39,35210
"Highland Heights city, Ohio",4241,4047,194,8652,39,35252
"Highland Hills village, Ohio",198,194,4,699,39,35255
"Highland Holiday CDP, Ohio",225,206,19,947,39,35256
"Highpoint CDP, Ohio",504,467,37,876,39,35322
"Hilliard city, Ohio",20795,20289,506,36103,39,35476
"Hills and Dales village, Ohio",97,96,1,254,39,35532
"Hillsboro city, Ohio",2742,2604,138,6492,39,35560
"Hilltop CDP, Ohio",351,334,17,653,39,35613
"Hiram village, Ohio",645,593,52,1264,39,35658
"Hockingport CDP, Ohio",9,9,0,54,39,35826
"Holgate village, Ohio",470,452,18,1044,39,35854
"Holiday City village, Ohio",13,13,0,18,39,35864
"Holiday Lakes CDP, Ohio",452,452,0,700,39,35866
"Holiday Valley CDP, Ohio",689,655,34,1515,39,35868
"Holland village, Ohio",767,747,20,1561,39,35882
"Hollansburg village, Ohio",133,130,3,236,39,35896
"Holloway village, Ohio",151,151,0,352,39,35924
"Holmesville village, Ohio",162,162,0,252,39,35994
"Homeworth CDP, Ohio",483,433,50,656,39,36176
"Hooven CDP, Ohio",225,225,0,590,39,36232
"Hopedale village, Ohio",522,503,19,1086,39,36260
"Howard CDP, Ohio",241,241,0,463,39,36512
"Howland Center CDP, Ohio",3397,3201,196,6266,39,36557
"Hoytville village, Ohio",217,180,37,368,39,36568
"Hubbard city, Ohio",4146,4039,107,7618,39,36582
"Huber Heights city, Ohio",21541,20619,922,43095,39,36610
"Huber Ridge CDP, Ohio",2753,2698,55,4302,39,36624
"Hudson city, Ohio",11662,11395,267,23005,39,36651
"Hunter CDP, Ohio",2347,2347,0,4304,39,36806
"Hunting Valley village, Ohio",296,292,4,800,39,36918
"Huntsville village, Ohio",284,280,4,476,39,36988
"Huron city, Ohio",3406,3281,125,6882,39,37016
"Iberia CDP, Ohio",245,245,0,490,39,37142
"Independence city, Ohio",3969,3917,52,7539,39,37240
"Irondale village, Ohio",123,102,21,298,39,37422
"Ironton city, Ohio",4234,3964,270,10597,39,37464
"Ithaca village, Ohio",75,73,2,116,39,37604
"Jackson city, Ohio",3236,3081,155,6222,39,37842
"Jacksonburg village, Ohio",13,13,0,39,39,38192
"Jackson Center village, Ohio",696,650,46,1352,39,38220
"Jacksontown CDP, Ohio",92,92,0,212,39,38276
"Jacksonville village, Ohio",153,152,1,346,39,38304
"Jamestown village, Ohio",1027,959,68,2211,39,38374
"Jefferson village, Ohio",1784,1735,49,3319,39,38500
"Jeffersonville village, Ohio",449,409,40,1085,39,38920
"Jenera village, Ohio",174,174,0,297,39,38948
"Jeromesville village, Ohio",352,340,12,642,39,39060
"Jerry City village, Ohio",250,242,8,535,39,39074
"Jersey CDP, Ohio",114,114,0,339,39,39088
"Jerusalem village, Ohio",56,56,0,132,39,39130
"Jewett village, Ohio",220,197,23,518,39,39172
"Johnstown village, Ohio",2878,2835,43,5183,39,39340
"Junction City village, Ohio",376,360,16,860,39,39508
"Kalida village, Ohio",951,936,15,1575,39,39536
"Kanauga CDP, Ohio",142,142,0,277,39,39564
"Kansas CDP, Ohio",67,67,0,184,39,39578
"Kelleys Island village, Ohio",104,83,21,221,39,39662
"Kent city, Ohio",15294,13660,1634,27336,39,39872
"Kenton city, Ohio",3247,2976,271,7685,39,39886
"Kenwood CDP, Ohio",4221,3979,242,8287,39,39914
"Kettering city, Ohio",30472,29336,1136,57707,39,40040
"Kettlersville village, Ohio",73,68,5,117,39,40054
"Kidron CDP, Ohio",429,424,5,1001,39,40096
"Kilbourne CDP, Ohio",18,18,0,25,39,40124
"Killbuck village, Ohio",577,518,59,936,39,40180
"Kimbolton CDP, Ohio",43,43,0,130,39,40264
"Kings Mills CDP, Ohio",855,841,14,1159,39,40348
"Kingston village, Ohio",301,286,15,766,39,40376
"Kingsville CDP, Ohio",325,317,8,737,39,40390
"Kinsman Center CDP, Ohio",321,321,0,821,39,40507
"Kipton village, Ohio",88,86,2,190,39,40544
"Kirby village, Ohio",30,30,0,48,39,40558
"Kirkersville village, Ohio",268,261,7,556,39,40572
"Kirtland city, Ohio",3599,3489,110,6914,39,40642
"Kirtland Hills village, Ohio",341,326,15,678,39,40670
"Kunkle CDP, Ohio",136,128,8,223,39,40978
"La Croft CDP, Ohio",609,556,53,1133,39,41090
"Lafayette village, Ohio",203,186,17,359,39,41118
"Lafayette CDP, Ohio",73,73,0,133,39,41146
"Lafferty CDP, Ohio",78,78,0,99,39,41188
"LaGrange village, Ohio",1435,1363,72,2662,39,41230
"Lake Buckhorn CDP, Ohio",240,220,20,608,39,41349
"Lake Darby CDP, Ohio",2610,2559,51,4569,39,41363
"Lake Lakengren CDP, Ohio",1900,1877,23,3504,39,41373
"Lakeline village, Ohio",112,110,2,198,39,41398
"Lake Lorelei CDP, Ohio",557,531,26,1143,39,41419
"Lake Milton CDP, Ohio",195,195,0,469,39,41440
"Lake Mohawk CDP, Ohio",687,687,0,1474,39,41443
"Lakemore village, Ohio",1512,1442,70,2935,39,41454
"Lake Seneca CDP, Ohio",306,306,0,633,39,41500
"Lakeside CDP, Ohio",140,133,7,588,39,41552
"Lake Tomahawk CDP, Ohio",500,455,45,777,39,41597
"Lakeview village, Ohio",534,501,33,1140,39,41608
"Lake Waynoka CDP, Ohio",501,488,13,1103,39,41657
"Lakewood city, Ohio",32761,30999,1762,50605,39,41664
"Lancaster city, Ohio",19460,18558,902,40616,39,41720
"Landen CDP, Ohio",4634,4593,41,8149,39,41755
"Lansing CDP, Ohio",106,106,0,285,39,41860
"La Rue village, Ohio",312,301,11,706,39,41902
"Latty village, Ohio",71,71,0,145,39,41986
"Laura village, Ohio",295,287,8,589,39,42028
"Laurelville village, Ohio",279,249,30,585,39,42084
"Lawrenceville CDP, Ohio",255,235,20,416,39,42210
"Leavittsburg CDP, Ohio",541,511,30,1116,39,42308
"Lebanon city, Ohio",10283,10073,210,20999,39,42364
"Leesburg village, Ohio",724,700,24,1270,39,42476
"Leesville village, Ohio",69,64,5,278,39,42518
"Leetonia village, Ohio",1042,960,82,2075,39,42560
"Leipsic village, Ohio",1130,1095,35,2215,39,42602
"Lewisburg village, Ohio",932,897,35,1841,39,42938
"Lewistown CDP, Ohio",25,25,0,143,39,42966
"Lewisville village, Ohio",89,89,0,176,39,42980
"Lexington village, Ohio",2499,2399,100,4956,39,42994
"Liberty Center village, Ohio",584,567,17,981,39,43414
"Lima city, Ohio",16129,14741,1388,35555,39,43554
"Limaville CDP, Ohio",102,102,0,162,39,43596
"Lincoln Heights village, Ohio",973,715,258,3140,39,43722
"Lincoln Heights CDP, Ohio",361,361,0,687,39,43764
"Lincoln Village CDP, Ohio",5267,5137,130,9553,39,43792
"Lindsey village, Ohio",185,180,5,415,39,43904
"Linndale village, Ohio",147,134,13,276,39,43918
"Lisbon village, Ohio",981,959,22,2582,39,44030
"Lithopolis village, Ohio",1194,1164,30,2400,39,44086
"Little Hocking CDP, Ohio",323,307,16,629,39,44128
"Lloydsville CDP, Ohio",201,189,12,519,39,44282
"Lockbourne village, Ohio",88,72,16,255,39,44310
"Lockington village, Ohio",87,86,1,173,39,44352
"Lockland village, Ohio",1937,1796,141,3497,39,44366
"Lodi village, Ohio",1556,1499,57,2764,39,44604
"Logan city, Ohio",3098,3004,94,7168,39,44632
"Logan Elm Village CDP, Ohio",549,549,0,1223,39,44636
"London city, Ohio",5104,4885,219,10316,39,44674
"Lorain city, Ohio",28854,27052,1802,65138,39,44856
"Lordstown village, Ohio",1341,1301,40,3327,39,44912
"Lore City village, Ohio",148,144,4,353,39,44954
"Loudonville village, Ohio",1393,1322,71,2898,39,45066
"Louisville city, Ohio",4587,4511,76,9500,39,45094
"Loveland city, Ohio",6985,6711,274,13247,39,45108
"Loveland Park CDP, Ohio",1098,1098,0,1824,39,45122
"Lowell village, Ohio",230,214,16,506,39,45164
"Lowellville village, Ohio",559,535,24,1102,39,45178
"Lower Salem village, Ohio",57,52,5,116,39,45220
"Lucas village, Ohio",267,258,9,473,39,45276
"Lucasville CDP, Ohio",838,816,22,1849,39,45304
"Luckey village, Ohio",696,676,20,1092,39,45332
"Ludlow Falls village, Ohio",83,80,3,201,39,45374
"Lynchburg village, Ohio",796,762,34,1443,39,45542
"Lyndhurst city, Ohio",7660,7389,271,13952,39,45556
"Lyons village, Ohio",400,389,11,785,39,45626
"McArthur village, Ohio",777,738,39,1816,39,45696
"McClure village, Ohio",550,486,64,819,39,45794
"McComb village, Ohio",777,765,12,1567,39,45808
"McConnelsville village, Ohio",916,876,40,2197,39,45822
"McCutchenville CDP, Ohio",170,170,0,358,39,45892
"McDermott CDP, Ohio",188,172,16,529,39,45906
"McDonald village, Ohio",1575,1535,40,3160,39,45934
"Macedonia city, Ohio",6526,6308,218,12126,39,45976
"McGuffey village, Ohio",190,174,16,380,39,46046
"Mack CDP, Ohio",5907,5787,120,11764,39,46088
"McKinley Heights CDP, Ohio",414,364,50,938,39,46144
"Macksburg village, Ohio",49,48,1,155,39,46158
"Madeira city, Ohio",4681,4577,104,9426,39,46312
"Madison village, Ohio",1835,1792,43,3417,39,46480
"Madison Place CDP, Ohio",201,201,0,526,39,46736
"Magnetic Springs village, Ohio",165,160,5,306,39,46830
"Magnolia village, Ohio",576,556,20,1172,39,46844
"Maineville village, Ohio",908,881,27,2057,39,46872
"Malinta village, Ohio",145,145,0,333,39,46942
"Malta village, Ohio",267,236,31,677,39,46970
"Malvern village, Ohio",741,731,10,1555,39,46998
"Manchester village, Ohio",862,769,93,2110,39,47012
"Mansfield city, Ohio",19501,17989,1512,47630,39,47138
"Mantua village, Ohio",501,458,43,767,39,47180
"Maple Heights city, Ohio",11302,10362,940,23473,39,47306
"Maple Ridge CDP, Ohio",289,276,13,490,39,47362
"Maplewood Park CDP, Ohio",107,107,0,275,39,47445
"Marathon CDP, Ohio",64,64,0,111,39,47460
"Marble Cliff village, Ohio",604,593,11,1009,39,47474
"Marblehead village, Ohio",392,389,3,962,39,47502
"Marengo village, Ohio",167,165,2,294,39,47558
"Maria Stein CDP, Ohio",701,701,0,1112,39,47586
"Mariemont village, Ohio",1811,1782,29,3493,39,47600
"Marietta city, Ohio",6419,6061,358,13366,39,47628
"Marion city, Ohio",14713,13433,1280,35927,39,47754
"Marlboro CDP, Ohio",129,129,0,243,39,47922
"Marne CDP, Ohio",216,216,0,358,39,47950
"Marseilles village, Ohio",54,54,0,87,39,47992
"Marshallville village, Ohio",363,354,9,776,39,48048
"Martinsburg village, Ohio",139,134,5,224,39,48090
"Martins Ferry city, Ohio",3159,2502,657,6283,39,48104
"Martinsville village, Ohio",245,230,15,456,39,48118
"Marysville city, Ohio",13635,13194,441,25806,39,48160
"Mason city, Ohio",18303,17973,330,34768,39,48188
"Massieville CDP, Ohio",252,220,32,700,39,48230
"Massillon city, Ohio",16779,16128,651,32179,39,48244
"Masury CDP, Ohio",968,899,69,2212,39,48272
"Matamoras village, Ohio",334,277,57,1154,39,48286
"Maumee city, Ohio",7671,7480,191,13824,39,48342
"Mayfield village, Ohio",1964,1803,161,3344,39,48468
"Mayfield Heights city, Ohio",11646,10977,669,20127,39,48482
"Mechanicsburg village, Ohio",862,844,18,1860,39,48706
"Medina city, Ohio",14228,13551,677,26092,39,48790
"Medway CDP, Ohio",306,293,13,534,39,48832
"Melmore CDP, Ohio",31,31,0,83,39,48972
"Melrose village, Ohio",166,126,40,388,39,49000
"Mendon village, Ohio",322,301,21,656,39,49042
"Mentor city, Ohio",25425,24451,974,47302,39,49056
"Mentor-on-the-Lake city, Ohio",4010,3886,124,7152,39,49098
"Metamora village, Ohio",388,385,3,625,39,49238
"Meyers Lake village, Ohio",366,354,12,837,39,49294
"Miami Heights CDP, Ohio",2285,2238,47,4585,39,49420
"Miamisburg city, Ohio",10165,9413,752,19877,39,49434
"Miamitown CDP, Ohio",546,546,0,959,39,49462
"Miamiville CDP, Ohio",143,126,17,155,39,49504
"Middlebranch CDP, Ohio",1197,1197,0,2017,39,49588
"Middleburg Heights city, Ohio",8065,7901,164,15918,39,49644
"Middlefield village, Ohio",1652,1472,180,2754,39,49700
"Middle Point village, Ohio",380,375,5,646,39,49728
"Middleport village, Ohio",865,842,23,2053,39,49756
"Middletown city, Ohio",24210,22475,1735,50514,39,49840
"Midland village, Ohio",193,177,16,356,39,49896
"Midvale village, Ohio",411,395,16,868,39,49966
"Midway village, Ohio",113,113,0,257,39,50008
"Mifflin village, Ohio",82,82,0,185,39,50036
"Milan village, Ohio",832,804,28,1855,39,50134
"Milford city, Ohio",3639,3468,171,6556,39,50176
"Milford Center village, Ohio",445,436,9,816,39,50218
"Millbury village, Ohio",718,691,27,1343,39,50260
"Milledgeville village, Ohio",54,52,2,89,39,50316
"Miller CDP, Ohio",176,176,0,535,39,50344
"Miller City village, Ohio",65,65,0,144,39,50358
"Millersburg village, Ohio",1790,1753,37,3158,39,50372
"Millersport village, Ohio",522,459,63,974,39,50400
"Millfield CDP, Ohio",106,106,0,258,39,50456
"Millville village, Ohio",354,337,17,611,39,50540
"Milton Center village, Ohio",73,64,9,188,39,50708
"Miltonsburg village, Ohio",21,21,0,61,39,50722
"Mineral City village, Ohio",322,311,11,571,39,50764
"Mineral Ridge CDP, Ohio",1678,1616,62,3955,39,50778
"Minerva village, Ohio",1830,1776,54,3246,39,50834
"Minerva Park village, Ohio",1088,1061,27,1894,39,50862
"Minford CDP, Ohio",200,200,0,590,39,50876
"Mingo Junction village, Ohio",1809,1727,82,3565,39,50904
"Minster village, Ohio",1638,1625,13,3042,39,50918
"Mitiwanga CDP, Ohio",180,180,0,249,39,50974
"Mogadore village, Ohio",2175,2117,58,3838,39,51058
"Monfort Heights CDP, Ohio",6527,6316,211,12012,39,51212
"Monroe city, Ohio",8260,8068,192,15202,39,51310
"Monroeville village, Ohio",673,643,30,1388,39,51618
"Montezuma village, Ohio",46,44,2,104,39,51674
"Montgomery city, Ohio",5205,5079,126,10816,39,51716
"Montpelier village, Ohio",1630,1531,99,3928,39,51772
"Montrose-Ghent CDP, Ohio",3142,3017,125,5854,39,51816
"Moraine city, Ohio",3016,2881,135,6484,39,52010
"Moreland Hills village, Ohio",1765,1669,96,3440,39,52052
"Morgandale CDP, Ohio",622,560,62,1361,39,52178
"Morral village, Ohio",213,205,8,458,39,52276
"Morristown village, Ohio",137,107,30,277,39,52346
"Morrow village, Ohio",1044,1006,38,2338,39,52374
"Moscow village, Ohio",50,50,0,161,39,52416
"Mount Blanchard village, Ohio",288,280,8,519,39,52598
"Mount Carmel CDP, Ohio",3016,2986,30,4924,39,52612
"Mount Cory village, Ohio",234,208,26,380,39,52668
"Mount Eaton village, Ohio",90,86,4,128,39,52682
"Mount Gilead village, Ohio",1296,1262,34,2927,39,52738
"Mount Healthy city, Ohio",3354,3154,200,6949,39,52752
"Mount Healthy Heights CDP, Ohio",1451,1349,102,3135,39,52780
"Mount Hope CDP, Ohio",104,104,0,148,39,52822
"Mount Orab village, Ohio",2037,1894,143,4544,39,52906
"Mount Pleasant village, Ohio",145,130,15,291,39,52976
"Mount Repose CDP, Ohio",2241,2127,114,3752,39,53032
"Mount Sterling village, Ohio",887,818,69,1890,39,53046
"Mount Vernon city, Ohio",8223,7949,274,16861,39,53102
"Mount Victory village, Ohio",353,332,21,627,39,53144
"Mowrystown village, Ohio",227,218,9,461,39,53186
"Mulberry CDP, Ohio",1963,1911,52,4071,39,53270
"Munroe Falls city, Ohio",2278,2160,118,5034,39,53312
"Murray City village, Ohio",180,158,22,425,39,53410
"Mutual village, Ohio",26,26,0,60,39,53480
"Nankin CDP, Ohio",343,310,33,682,39,53536
"Napoleon city, Ohio",4296,4177,119,8888,39,53550
"Nashport CDP, Ohio",160,160,0,315,39,53606
"Nashville village, Ohio",101,100,1,316,39,53634
"Navarre village, Ohio",926,883,43,1868,39,53690
"Neapolis CDP, Ohio",538,478,60,627,39,53718
"Neffs CDP, Ohio",513,492,21,1093,39,53788
"Negley CDP, Ohio",216,216,0,305,39,53802
"Nellie village, Ohio",102,97,5,297,39,53816
"Nelsonville city, Ohio",1627,1406,221,4269,39,53886
"Nettle Lake CDP, Ohio",173,173,0,186,39,53914
"Nevada village, Ohio",423,411,12,751,39,53942
"Neville village, Ohio",28,23,5,75,39,53956
"New Albany city, Ohio",5076,4964,112,10516,39,53970
"New Alexandria village, Ohio",164,152,12,327,39,54012
"Newark city, Ohio",24152,23186,966,50062,39,54040
"New Athens village, Ohio",136,136,0,250,39,54068
"New Baltimore CDP, Ohio",842,842,0,1457,39,54082
"New Bavaria village, Ohio",64,64,0,94,39,54110
"New Bloomington village, Ohio",139,93,46,363,39,54152
"New Boston village, Ohio",765,689,76,2572,39,54166
"New Bremen village, Ohio",1612,1596,16,2846,39,54194
"Newburgh Heights village, Ohio",1014,936,78,1760,39,54250
"New Burlington CDP, Ohio",2077,2035,42,5321,39,54264
"New California CDP, Ohio",996,980,16,1909,39,54320
"New Carlisle city, Ohio",2798,2319,479,5579,39,54334
"Newcomerstown village, Ohio",1627,1213,414,3441,39,54432
"New Concord village, Ohio",1229,1201,28,2593,39,54446
"New Franklin city, Ohio",7796,7442,354,13874,39,54562
"New Hampshire CDP, Ohio",246,160,86,449,39,54628
"New Haven CDP (Hamilton County), Ohio",94,94,0,115,39,54684
"New Haven CDP (Huron County), Ohio",291,274,17,520,39,54698
"New Holland village, Ohio",336,321,15,909,39,54726
"New Knoxville village, Ohio",561,513,48,1023,39,54838
"New Lebanon village, Ohio",1621,1601,20,4131,39,54852
"New Lexington village, Ohio",1601,1529,72,4368,39,54866
"New London village, Ohio",1160,1059,101,2531,39,54908
"New Madison village, Ohio",382,370,12,958,39,54978
"New Marshfield CDP, Ohio",85,85,0,184,39,55062
"New Miami village, Ohio",1140,948,192,2411,39,55104
"New Middletown village, Ohio",704,661,43,1443,39,55118
"New Paris village, Ohio",652,585,67,1443,39,55188
"New Philadelphia city, Ohio",9042,8758,284,17602,39,55216
"New Pittsburg CDP, Ohio",120,120,0,289,39,55244
"Newport CDP (Shelby County), Ohio",91,91,0,107,39,55314
"Newport CDP (Washington County), Ohio",564,527,37,1071,39,55342
"New Richmond village, Ohio",1247,1154,93,2733,39,55384
"New Riegel village, Ohio",134,130,4,328,39,55398
"New Springfield CDP, Ohio",284,284,0,568,39,55524
"New Straitsville village, Ohio",319,298,21,764,39,55552
"Newton Falls village, Ohio",2272,2115,157,4562,39,55650
"Newtown village, Ohio",1424,1355,69,2691,39,55678
"New Vienna village, Ohio",515,503,12,1054,39,55748
"New Washington village, Ohio",457,453,4,900,39,55776
"New Waterford village, Ohio",515,494,21,897,39,55790
"New Weston village, Ohio",39,39,0,93,39,55818
"Ney village, Ohio",175,174,1,301,39,55874
"Niles city, Ohio",8983,8477,506,18107,39,55916
"North Baltimore village, Ohio",1469,1420,49,3624,39,56154
"North Bend village, Ohio",468,451,17,1006,39,56182
"Northbrook CDP, Ohio",5892,5621,271,11199,39,56280
"North Canton city, Ohio",9515,9278,237,17773,39,56294
"North College Hill city, Ohio",4764,4345,419,9602,39,56322
"North Fairfield village, Ohio",275,264,11,611,39,56420
"Northfield village, Ohio",1985,1918,67,3546,39,56448
"Northgate CDP, Ohio",3480,3262,218,6347,39,56553
"North Hampton village, Ohio",205,202,3,397,39,56588
"North Industry CDP, Ohio",1087,1085,2,1785,39,56658
"North Kingsville village, Ohio",1339,1225,114,2749,39,56700
"North Lawrence CDP, Ohio",97,97,0,133,39,56756
"North Lewisburg village, Ohio",868,785,83,1768,39,56770
"North Lima CDP, Ohio",515,475,40,1102,39,56798
"North Madison CDP, Ohio",4429,4094,335,8313,39,56812
"North Olmsted city, Ohio",17043,16510,533,32244,39,56882
"North Perry village, Ohio",452,429,23,852,39,56910
"North Randall village, Ohio",542,429,113,1113,39,56924
"Northridge CDP, Ohio",3397,3229,168,7675,39,56938
"North Ridgeville city, Ohio",17824,17245,579,35481,39,56966
"North Robinson village, Ohio",92,82,10,325,39,56994
"North Royalton city, Ohio",17667,16929,738,31120,39,57008
"North Star village, Ohio",83,83,0,171,39,57064
"Northwood city, Ohio",3043,3021,22,5180,39,57190
"North Zanesville CDP, Ohio",1321,1280,41,2633,39,57218
"Norton city, Ohio",6126,5883,243,11643,39,57260
"Norwalk city, Ohio",8285,7906,379,17041,39,57302
"Norwich village, Ohio",45,45,0,84,39,57372
"Norwood city, Ohio",11216,10710,506,19018,39,57386
"Oak Harbor village, Ohio",1189,1150,39,2521,39,57582
"Oak Hill village, Ohio",576,533,43,1698,39,57596
"Oakwood village (Cuyahoga County), Ohio",1523,1444,79,3551,39,57750
"Oakwood city, Ohio",5121,5009,112,9496,39,57764
"Oakwood village (Paulding County), Ohio",207,197,10,402,39,57792
"Oberlin city, Ohio",4109,3918,191,8194,39,57834
"Obetz village, Ohio",3106,2853,253,5580,39,57862
"Oceola CDP, Ohio",142,142,0,237,39,57876
"Octa village, Ohio",22,22,0,50,39,57918
"Ohio City village, Ohio",367,363,4,737,39,58002
"Olde West Chester CDP, Ohio",216,216,0,250,39,58149
"Old Fort CDP, Ohio",49,49,0,138,39,58156
"Old Washington village, Ohio",249,236,13,481,39,58226
"Olmsted Falls city, Ohio",4597,4454,143,8670,39,58422
"Ontario city, Ohio",3810,3624,186,6642,39,58520
"Orange village, Ohio",1657,1503,154,3432,39,58604
"Orangeville village, Ohio",96,90,6,171,39,58674
"Oregon city, Ohio",10980,10492,488,19896,39,58730
"Orient CDP, Ohio",96,96,0,208,39,58800
"Orrville city, Ohio",4187,4087,100,8304,39,58828
"Orwell village, Ohio",874,813,61,1804,39,58856
"Osgood village, Ohio",196,194,2,353,39,58912
"Ostrander village, Ohio",511,499,12,952,39,58940
"Ottawa village, Ohio",2045,2045,0,4447,39,58982
"Ottawa Hills village, Ohio",2289,2168,121,4782,39,59010
"Ottoville village, Ohio",526,508,18,976,39,59052
"Otway village, Ohio",25,25,0,75,39,59066
"Owensville village, Ohio",277,277,0,788,39,59220
"Oxford city, Ohio",9154,8155,999,22051,39,59234
"Painesville city, Ohio",9706,9239,467,20387,39,59416
"Palestine village, Ohio",133,122,11,207,39,59598
"Pancoastburg CDP, Ohio",26,26,0,65,39,59724
"Pandora village, Ohio",818,801,17,1479,39,59738
"Park Layne CDP, Ohio",2019,1990,29,3974,39,59920
"Parkman CDP, Ohio",80,80,0,114,39,59934
"Parma city, Ohio",45435,42809,2626,80587,39,61000
"Parma Heights city, Ohio",10985,10568,417,20706,39,61028
"Parral village, Ohio",139,132,7,223,39,61056
"Pataskala city, Ohio",9256,8958,298,17843,39,61112
"Patterson village, Ohio",83,68,15,173,39,61182
"Paulding village, Ohio",1749,1560,189,3638,39,61252
"Payne village, Ohio",682,635,47,1458,39,61322
"Peebles village, Ohio",838,694,144,2031,39,61420
"Pekin CDP, Ohio",185,185,0,352,39,61448
"Pemberville village, Ohio",726,703,23,1358,39,61504
"Peninsula village, Ohio",381,364,17,633,39,61574
"Pepper Pike city, Ohio",3503,3448,55,6778,39,61686
"Perry village, Ohio",795,775,20,1578,39,61882
"Perry Heights CDP, Ohio",4586,4479,107,8762,39,62134
"Perrysburg city, Ohio",13299,12749,550,24855,39,62148
"Perrysville village, Ohio",384,366,18,803,39,62190
"Petersburg CDP, Ohio",149,149,0,339,39,62302
"Pettisville CDP, Ohio",284,262,22,528,39,62344
"Pheasant Run CDP, Ohio",699,675,24,1481,39,62404
"Phillipsburg village, Ohio",202,177,25,398,39,62414
"Philo village, Ohio",358,345,13,811,39,62442
"Pickerington city, Ohio",12575,12305,270,23229,39,62498
"Pigeon Creek CDP, Ohio",408,395,13,811,39,62578
"Piketon village, Ohio",924,785,139,2525,39,62708
"Pioneer village, Ohio",695,663,32,1333,39,62834
"Piqua city, Ohio",10529,10131,398,20441,39,62848
"Pitsburg village, Ohio",164,161,3,331,39,62890
"Plain City village, Ohio",1851,1829,22,3644,39,63030
"Plainfield village, Ohio",63,62,1,184,39,63044
"Plainville CDP, Ohio",28,28,0,61,39,63072
"Pleasant City village, Ohio",337,307,30,608,39,63436
"Pleasant Grove CDP, Ohio",717,701,16,1310,39,63478
"Pleasant Hill village, Ohio",624,605,19,1390,39,63534
"Pleasant Hills CDP, Ohio",529,529,0,1210,39,63548
"Pleasant Plain village, Ohio",105,103,2,160,39,63576
"Pleasant Run CDP, Ohio",2955,2757,198,5258,39,63604
"Pleasant Run Farm CDP, Ohio",1932,1918,14,4016,39,63618
"Pleasantville village, Ohio",356,331,25,768,39,63716
"Plumwood CDP, Ohio",194,155,39,278,39,63758
"Plymouth village, Ohio",870,804,66,1788,39,63800
"Poland village, Ohio",1372,1296,76,2573,39,63954
"Polk village, Ohio",212,201,11,470,39,63996
"Pomeroy village, Ohio",685,659,26,1605,39,64024
"Portage village, Ohio",289,234,55,445,39,64108
"Portage Lakes CDP, Ohio",4012,3754,258,6427,39,64136
"Port Clinton city, Ohio",2933,2779,154,6024,39,64150
"Port Jefferson village, Ohio",203,176,27,387,39,64262
"Portsmouth city, Ohio",6934,6140,794,18130,39,64304
"Port Washington village, Ohio",311,278,33,621,39,64346
"Port William village, Ohio",105,101,4,294,39,64360
"Potsdam village, Ohio",195,184,11,381,39,64430
"Pottery Addition CDP, Ohio",77,77,0,100,39,64472
"Powell city, Ohio",7147,6920,227,14113,39,64486
"Powhatan Point village, Ohio",638,603,35,1493,39,64542
"Proctorville village, Ohio",194,190,4,558,39,64766
"Prospect village, Ohio",558,542,16,1267,39,64780
"Pulaski CDP, Ohio",54,43,11,114,39,64906
"Put-in-Bay village, Ohio",46,43,3,89,39,65032
"Quaker City village, Ohio",165,165,0,401,39,65116
"Quincy village, Ohio",231,219,12,406,39,65200
"Racine village, Ohio",413,408,5,1061,39,65256
"Radnor CDP, Ohio",117,117,0,167,39,65298
"Rarden village, Ohio",41,39,2,153,39,65508
"Ravenna city, Ohio",5811,5406,405,11323,39,65592
"Rawson village, Ohio",261,256,5,628,39,65634
"Rayland village, Ohio",172,153,19,448,39,65662
"Raymond CDP, Ohio",90,90,0,155,39,65676
"Reading city, Ohio",6016,5709,307,10527,39,65732
"Reedurban CDP, Ohio",2791,2698,93,4935,39,66012
"Reminderville village, Ohio",2927,2927,0,5305,39,66152
"Remington CDP, Ohio",387,349,38,614,39,66180
"Rendville village, Ohio",7,5,2,55,39,66222
"Reno CDP, Ohio",688,592,96,1295,39,66250
"Reno Beach CDP, Ohio",217,217,0,598,39,66264
"Republic village, Ohio",348,323,25,664,39,66320
"Reynoldsburg city, Ohio",21574,20410,1164,40926,39,66390
"Richfield village, Ohio",2097,2046,51,3719,39,66530
"Richmond village, Ohio",252,246,6,555,39,66824
"Richmond Dale CDP, Ohio",104,104,0,423,39,66880
"Richmond Heights city, Ohio",5738,5154,584,10714,39,66894
"Richville CDP, Ohio",1664,1619,45,3023,39,66922
"Richwood village, Ohio",1145,1099,46,2222,39,66936
"Ridgeville Corners CDP, Ohio",228,228,0,340,39,67104
"Ridgeway village, Ohio",153,151,2,291,39,67118
"Ridgewood CDP, Ohio",387,343,44,563,39,67128
"Rio Grande village, Ohio",336,316,20,856,39,67258
"Ripley village, Ohio",725,640,85,1609,39,67272
"Risingsun village, Ohio",204,196,8,467,39,67314
"Rittman city, Ohio",3153,2923,230,6058,39,67356
"Riverlea village, Ohio",292,286,6,515,39,67440
"Riverside city, Ohio",12124,11628,496,24482,39,67468
"Roachester CDP, Ohio",226,226,0,438,39,67580
"Roaming Shores village, Ohio",1029,1011,18,1957,39,67600
"Robertsville CDP, Ohio",137,137,0,256,39,67664
"Rochester village, Ohio",71,71,0,153,39,67762
"Rockbridge CDP, Ohio",29,17,12,63,39,67804
"Rock Creek village, Ohio",313,310,3,721,39,67846
"Rockford village, Ohio",466,437,29,986,39,67874
"Rocky Fork Point CDP, Ohio",250,250,0,701,39,68004
"Rocky Ridge village, Ohio",187,174,13,323,39,68042
"Rocky River city, Ohio",11314,11024,290,21552,39,68056
"Rogers village, Ohio",117,105,12,256,39,68084
"Rome (Stout) village, Ohio",9,7,2,51,39,68196
"Rose Farm CDP, Ohio",52,52,0,93,39,68448
"Roseland CDP, Ohio",746,697,49,1835,39,68490
"Rosemount CDP, Ohio",1023,912,111,2013,39,68546
"Roseville village, Ohio",895,860,35,2053,39,68560
"Rosewood CDP, Ohio",79,79,0,280,39,68574
"Ross CDP, Ohio",1288,1252,36,2823,39,68602
"Rossburg village, Ohio",125,124,1,255,39,68672
"Rossford city, Ohio",3771,3591,180,6314,39,68686
"Rossmoyne CDP, Ohio",959,927,32,1562,39,68714
"Roswell village, Ohio",116,116,0,217,39,68742
"Rudolph CDP, Ohio",168,168,0,276,39,68938
"Rushsylvania village, Ohio",255,251,4,511,39,69176
"Rushville village, Ohio",158,154,4,326,39,69204
"Russells Point village, Ohio",519,469,50,1240,39,69302
"Russellville village, Ohio",370,361,9,672,39,69316
"Russia village, Ohio",348,325,23,841,39,69344
"Rutland village, Ohio",389,340,49,928,39,69358
"Sabina village, Ohio",1109,1092,17,2606,39,69400
"St. Bernard village, Ohio",2502,2435,67,4026,39,69470
"St. Clairsville city, Ohio",2487,2416,71,5085,39,69526
"St. Henry village, Ohio",1419,1415,4,2675,39,69540
"St. Johns CDP, Ohio",134,134,0,285,39,69596
"St. Louisville village, Ohio",209,204,5,383,39,69652
"St. Martin CDP, Ohio",80,80,0,135,39,69666
"St. Marys city, Ohio",4921,4828,93,8323,39,69680
"St. Paris village, Ohio",1067,1018,49,2138,39,69708
"Salem city, Ohio",6813,6505,308,11861,39,69834
"Salem Heights CDP (Columbiana County), Ohio",176,159,17,176,39,70044
"Salem Heights CDP (Hamilton County), Ohio",1708,1708,0,3335,39,70050
"Salesville CDP, Ohio",81,81,0,150,39,70072
"Salineville village, Ohio",539,517,22,1195,39,70100
"Sandusky city, Ohio",12892,11677,1215,24964,39,70380
"Sandyville CDP, Ohio",39,39,0,39,39,70464
"Sarahsville village, Ohio",46,43,3,104,39,70520
"Sardinia village, Ohio",473,462,11,1328,39,70534
"Sardis CDP, Ohio",178,178,0,387,39,70548
"Savannah village, Ohio",161,161,0,309,39,70576
"Sawyerwood CDP, Ohio",571,438,133,1381,39,70618
"Saybrook-on-the-Lake CDP, Ohio",504,463,41,1112,39,70655
"Scio village, Ohio",165,151,14,570,39,70814
"Sciotodale CDP, Ohio",405,350,55,814,39,70912
"Scott village, Ohio",161,151,10,226,39,71080
"Seaman village, Ohio",363,361,2,1142,39,71206
"Sebring village, Ohio",1647,1457,190,4185,39,71220
"Senecaville village, Ohio",215,206,9,449,39,71360
"Seven Hills city, Ohio",6148,5914,234,11681,39,71416
"Seven Mile village, Ohio",274,253,21,685,39,71444
"Seville village, Ohio",1054,1019,35,2153,39,71486
"Shadyside village, Ohio",1768,1744,24,3514,39,71640
"Shaker Heights city, Ohio",15409,14618,791,29157,39,71682
"Sharon Center CDP, Ohio",645,643,2,1363,39,71836
"Sharonville city, Ohio",7533,7405,128,14023,39,71892
"Shawnee CDP, Ohio",673,446,227,1034,39,71958
"Shawnee village, Ohio",186,158,28,411,39,71962
"Shawnee Hills village, Ohio",503,474,29,855,39,71976
"Shawnee Hills CDP, Ohio",1505,1311,194,2566,39,71983
"Sheffield village, Ohio",2133,2082,51,4225,39,72060
"Sheffield Lake city, Ohio",5032,4871,161,8958,39,72088
"Shelby city, Ohio",3796,3676,120,8360,39,72102
"Sherrodsville village, Ohio",163,149,14,307,39,72242
"Sherwood village, Ohio",332,332,0,762,39,72256
"Sherwood CDP, Ohio",1935,1836,99,3408,39,72258
"Shiloh CDP, Ohio",5434,4991,443,10539,39,72284
"Shiloh village, Ohio",256,245,11,523,39,72298
"Shreve village, Ohio",863,845,18,1680,39,72396
"Sidney city, Ohio",10652,9946,706,20350,39,72424
"Silver Lake village, Ohio",1295,1252,43,2621,39,72494
"Silverton village, Ohio",2605,2447,158,4883,39,72522
"Sinking Spring village, Ohio",130,117,13,271,39,72578
"Sixteen Mile Stand CDP, Ohio",2207,2161,46,3677,39,72620
"Skyline Acres CDP, Ohio",476,463,13,1189,39,72648
"Smithville village, Ohio",651,636,15,1357,39,72788
"Solon city, Ohio",12509,12125,384,24053,39,72928
"Somerset village, Ohio",599,539,60,1544,39,72977
"Somerville CDP, Ohio",121,121,0,292,39,72998
"South Amherst village, Ohio",973,912,61,1814,39,73040
"South Bloomfield village, Ohio",1392,1305,87,2677,39,73068
"South Canal CDP, Ohio",479,467,12,1013,39,73118
"South Charleston village, Ohio",881,854,27,1791,39,73124
"South Euclid city, Ohio",12019,11313,706,21754,39,73264
"South Lebanon village, Ohio",3536,3028,508,6376,39,73446
"South Mount Vernon CDP, Ohio",364,314,50,853,39,73530
"South Point village, Ohio",1665,1607,58,3000,39,73670
"South Russell village, Ohio",2076,2019,57,3966,39,73684
"South Salem village, Ohio",104,92,12,192,39,73698
"South Solon village, Ohio",182,173,9,385,39,73768
"South Vienna village, Ohio",307,283,24,573,39,73796
"South Webster village, Ohio",235,219,16,736,39,73824
"South Zanesville village, Ohio",800,774,26,1876,39,73894
"Sparta village, Ohio",85,73,12,175,39,73950
"Spencer village, Ohio",264,256,8,557,39,73992
"Spencerville village, Ohio",763,703,60,2127,39,74034
"Springboro city, Ohio",9650,9202,448,19218,39,74076
"Springdale city, Ohio",5356,5016,340,10991,39,74104
"Springfield city, Ohio",26847,24405,2442,58645,39,74118
"Spring Valley village, Ohio",256,251,5,606,39,74216
"Stafford village, Ohio",28,28,0,90,39,74300
"Sterling CDP, Ohio",182,177,5,288,39,74566
"Steubenville city, Ohio",8413,7777,636,18175,39,74608
"Stewart CDP, Ohio",140,140,0,320,39,74622
"Stockdale CDP, Ohio",0,0,0,0,39,74734
"Stockport village, Ohio",261,242,19,615,39,74748
"Stone Creek village, Ohio",78,74,4,156,39,74804
"Stony Prairie CDP, Ohio",870,821,49,1725,39,74832
"Stony Ridge CDP, Ohio",331,331,0,659,39,74846
"Stoutsville village, Ohio",326,267,59,620,39,74916
"Stow city, Ohio",18906,18080,826,34459,39,74944
"Strasburg village, Ohio",1258,1212,46,2581,39,74958
"Stratton village, Ohio",155,142,13,257,39,75000
"Streetsboro city, Ohio",10060,9604,456,17378,39,75014
"Strongsville city, Ohio",24017,23285,732,46165,39,75098
"Struthers city, Ohio",5411,5202,209,10061,39,75126
"Stryker village, Ohio",814,779,35,1388,39,75140
"Suffield CDP, Ohio",468,468,0,1055,39,75182
"Sugar Bush Knolls village, Ohio",164,159,5,348,39,75196
"Sugarcreek village, Ohio",1322,1254,68,2398,39,75210
"Sugar Grove village, Ohio",181,179,2,354,39,75252
"Sullivan CDP, Ohio",419,419,0,926,39,75350
"Sulphur Springs CDP, Ohio",131,87,44,193,39,75392
"Summerfield village, Ohio",62,62,0,199,39,75406
"Summerside CDP, Ohio",2243,2088,155,4515,39,75434
"Summitville village, Ohio",90,90,0,235,39,75574
"Sunbury village, Ohio",3805,3745,60,6933,39,75602
"Swanton village, Ohio",1908,1870,38,4133,39,75896
"Sycamore village, Ohio",412,398,14,733,39,75980
"Sylvania city, Ohio",9687,9316,371,19042,39,76022
"Syracuse village, Ohio",291,282,9,601,39,76050
"Tallmadge city, Ohio",9388,9170,218,18411,39,76106
"Tarlton village, Ohio",138,120,18,266,39,76148
"Taylor Creek CDP, Ohio",2213,2180,33,3986,39,76197
"Tedrow CDP, Ohio",92,90,2,250,39,76358
"Terrace Park village, Ohio",975,963,12,2150,39,76428
"The Plains CDP, Ohio",1091,1033,58,2724,39,76568
"The Village of Indian Hill city, Ohio",2640,2571,69,6051,39,76582
"Thornport CDP, Ohio",516,499,17,1040,39,76666
"Thornville village, Ohio",942,912,30,1595,39,76680
"Thurston village, Ohio",188,188,0,488,39,76764
"Tiffin city, Ohio",9226,8757,469,17894,39,76778
"Tiltonsville village, Ohio",709,671,38,1359,39,76806
"Timberlake village, Ohio",342,321,21,655,39,76834
"Tipp City city, Ohio",5420,5372,48,10266,39,76876
"Tippecanoe CDP, Ohio",30,30,0,97,39,76890
"Tiro village, Ohio",126,119,7,242,39,76932
"Toledo city, Ohio",132711,121834,10877,269962,39,77000
"Tontogany village, Ohio",214,211,3,398,39,77070
"Toronto city, Ohio",2467,2362,105,5387,39,77112
"Tremont City village, Ohio",156,145,11,314,39,77308
"Trenton city, Ohio",6706,6392,314,13133,39,77322
"Trimble village, Ohio",202,182,20,421,39,77406
"Trinway CDP, Ohio",79,79,0,220,39,77434
"Trotwood city, Ohio",10988,10062,926,23125,39,77504
"Troy city, Ohio",14021,13320,701,26494,39,77588
"Tuppers Plains CDP, Ohio",215,203,12,448,39,77812
"Turpin Hills CDP, Ohio",3209,3092,117,5831,39,77840
"Tuscarawas village, Ohio",677,657,20,1296,39,77924
"Twinsburg city, Ohio",10882,10537,345,19291,39,78050
"Twinsburg Heights CDP, Ohio",478,367,111,960,39,78078
"Uhrichsville city, Ohio",2466,2214,252,5238,39,78176
"Union city, Ohio",3527,3426,101,6894,39,78470
"Union City village, Ohio",664,613,51,1528,39,78624
"Uniontown CDP, Ohio",3352,3218,134,6948,39,78736
"Unionville Center village, Ohio",204,143,61,277,39,78834
"Uniopolis CDP, Ohio",188,162,26,319,39,78848
"University Heights city, Ohio",7639,7220,419,13649,39,78932
"Upper Arlington city, Ohio",18681,18273,408,36500,39,79002
"Upper Sandusky city, Ohio",3308,3198,110,6537,39,79044
"Urbana city, Ohio",5486,5256,230,11156,39,79072
"Urbancrest village, Ohio",356,276,80,1157,39,79100
"Utica village, Ohio",911,801,110,2024,39,79114
"Valley City CDP, Ohio",339,339,0,677,39,79184
"Valley Hi village, Ohio",87,87,0,155,39,79226
"Valley View village, Ohio",956,883,73,1912,39,79268
"Valleyview village, Ohio",372,313,59,671,39,79282
"Van Buren village, Ohio",307,303,4,581,39,79394
"Vandalia city, Ohio",8614,8360,254,15139,39,79492
"Vanlue village, Ohio",200,200,0,323,39,79534
"Van Wert city, Ohio",5346,5104,242,10828,39,79562
"Vaughnsville CDP, Ohio",57,57,0,159,39,79590
"Venedocia village, Ohio",55,52,3,173,39,79632
"Vermilion city, Ohio",5413,5251,162,10459,39,79716
"Verona village, Ohio",347,310,37,631,39,79898
"Versailles village, Ohio",1553,1530,23,2945,39,79912
"Vickery CDP, Ohio",115,115,0,238,39,79982
"Vienna Center CDP, Ohio",352,322,30,651,39,80066
"Vincent CDP, Ohio",101,101,0,181,39,80150
"Vinton village, Ohio",162,124,38,288,39,80178
"Wadsworth city, Ohio",13178,12688,490,24073,39,80304
"Waite Hill village, Ohio",245,240,5,554,39,80402
"Wakeman village, Ohio",501,488,13,1169,39,80458
"Walbridge village, Ohio",1780,1641,139,3023,39,80486
"Waldo village, Ohio",185,181,4,365,39,80500
"Walnut Creek CDP, Ohio",615,476,139,1302,39,80612
"Walton Hills village, Ohio",1205,1110,95,2140,39,80738
"Wapakoneta city, Ohio",5063,4892,171,9879,39,80766
"Warren city, Ohio",14373,13141,1232,39204,39,80892
"Warrensville Heights city, Ohio",6453,5798,655,13659,39,80990
"Warsaw village, Ohio",256,249,7,519,39,81032
"Washington Court House city, Ohio",6836,6424,412,14387,39,81718
"Washingtonville village, Ohio",310,283,27,746,39,81732
"Waterford CDP, Ohio",113,113,0,373,39,81760
"Waterville city, Ohio",2948,2815,133,5980,39,81858
"Wauseon city, Ohio",3496,3420,76,7301,39,81928
"Waverly village, Ohio",1940,1877,63,4154,39,81935
"Wayne village, Ohio",621,558,63,1078,39,82334
"Wayne Lakes village, Ohio",420,404,16,827,39,82348
"Waynesburg village, Ohio",520,473,47,1091,39,82376
"Waynesfield village, Ohio",325,303,22,628,39,82390
"Waynesville village, Ohio",1285,1217,68,2709,39,82418
"Wellington village, Ohio",2352,2313,39,4339,39,82642
"Wellston city, Ohio",2197,2075,122,5420,39,82712
"Wellsville village, Ohio",1571,1392,179,3109,39,82740
"West Alexandria village, Ohio",724,691,33,1442,39,82880
"West Carrollton city, Ohio",7117,6756,361,13060,39,83090
"West Elkton village, Ohio",80,59,21,151,39,83216
"Westerville city, Ohio",20178,19603,575,38911,39,83342
"West Farmington village, Ohio",275,273,2,560,39,83384
"Westfield Center village, Ohio",610,575,35,1312,39,83468
"West Hill CDP, Ohio",1075,1001,74,2232,39,83541
"West Jefferson village, Ohio",2357,2305,52,4186,39,83580
"West Lafayette village, Ohio",1226,1138,88,2622,39,83608
"Westlake city, Ohio",17535,16895,640,34027,39,83622
"West Leipsic village, Ohio",141,132,9,247,39,83706
"West Liberty village, Ohio",770,741,29,1751,39,83734
"West Logan CDP, Ohio",176,159,17,562,39,83776
"West Manchester village, Ohio",227,222,5,355,39,83804
"West Mansfield village, Ohio",475,443,32,882,39,83818
"West Millgrove village, Ohio",67,65,2,110,39,83888
"West Milton village, Ohio",2469,2398,71,4717,39,83902
"Westminster CDP, Ohio",378,328,50,616,39,83930
"Weston village, Ohio",767,753,14,1449,39,83972
"West Portsmouth CDP, Ohio",905,905,0,2540,39,84140
"West Rushville village, Ohio",110,107,3,278,39,84182
"West Salem village, Ohio",774,755,19,1528,39,84196
"West Union village, Ohio",1050,945,105,2993,39,84294
"West Unity village, Ohio",946,864,82,1878,39,84308
"Wetherington CDP, Ohio",569,569,0,1237,39,84528
"Wharton village, Ohio",191,184,7,381,39,84574
"Wheelersburg CDP, Ohio",2825,2619,206,6215,39,84588
"Whitehall city, Ohio",10521,9402,1119,20035,39,84742
"Whitehouse village, Ohio",2501,2443,58,4771,39,84770
"White Oak CDP, Ohio",10608,10210,398,19101,39,84812
"Whites Landing CDP, Ohio",192,122,70,384,39,84882
"Wickliffe city, Ohio",7198,6849,349,12661,39,85036
"Wightmans Grove CDP, Ohio",7,7,0,16,39,85085
"Wilberforce CDP, Ohio",1121,977,144,2190,39,85092
"Wilkesville village, Ohio",115,114,1,206,39,85190
"Wilkshire Hills CDP, Ohio",1566,1517,49,2957,39,85228
"Willard city, Ohio",2704,2593,111,6189,39,85232
"Williamsburg village, Ohio",1379,1333,46,2583,39,85288
"Williamsdale CDP, Ohio",590,571,19,872,39,85344
"Williamsport village, Ohio",477,459,18,958,39,85414
"Williston CDP, Ohio",92,92,0,356,39,85442
"Willoughby city, Ohio",13187,12628,559,23823,39,85484
"Willoughby Hills city, Ohio",6215,5817,398,9972,39,85512
"Willowick city, Ohio",8159,7804,355,14213,39,85638
"Willshire village, Ohio",204,202,2,386,39,85736
"Wilmington city, Ohio",6013,5714,299,12669,39,85792
"Wilmot village, Ohio",148,147,1,286,39,85806
"Wilson village, Ohio",53,44,9,125,39,85834
"Winchester village, Ohio",405,362,43,1242,39,85876
"Windham village, Ohio",685,590,95,1777,39,85946
"Winesburg CDP, Ohio",167,167,0,239,39,86072
"Wintersville village, Ohio",1657,1574,83,3983,39,86184
"Withamsville CDP, Ohio",4107,4010,97,7803,39,86254
"Wolfhurst CDP, Ohio",492,422,70,1290,39,86282
"Woodlawn village, Ohio",2267,2199,68,3862,39,86366
"Woodmere village, Ohio",366,323,43,683,39,86394
"Woodsdale CDP, Ohio",439,407,32,802,39,86422
"Woodsfield village, Ohio",802,687,115,2321,39,86436
"Woodstock village, Ohio",112,106,6,218,39,86478
"Woodville village, Ohio",1059,1001,58,1912,39,86492
"Woodworth CDP, Ohio",609,609,0,1917,39,86534
"Wooster city, Ohio",14230,13569,661,27021,39,86548
"Worthington city, Ohio",7642,7365,277,14997,39,86604
"Wren village, Ohio",89,89,0,201,39,86632
"Wright-Patterson AFB CDP, Ohio",626,573,53,1554,39,86660
"Wyoming city, Ohio",3975,3908,67,8720,39,86730
"Xenia city, Ohio",11742,10911,831,25499,39,86772
"Yankee Lake village, Ohio",33,33,0,89,39,86856
"Yellow Springs village, Ohio",1779,1702,77,3739,39,86940
"Yorkshire village, Ohio",44,44,0,67,39,87164
"Yorkville village, Ohio",424,393,31,959,39,87178
"Youngstown city, Ohio",25663,22265,3398,60048,39,88000
"Zaleski village, Ohio",250,250,0,418,39,88028
"Zanesfield village, Ohio",122,120,2,206,39,88070
"Zanesville city, Ohio",11011,10075,936,24772,39,88084
"Zoar village, Ohio",101,101,0,206,39,88168
"Achille town, Oklahoma",186,175,11,414,40,00100
"Ada city, Oklahoma",7708,7339,369,16537,40,00200
"Adair town, Oklahoma",367,360,7,751,40,00250
"Adams CDP, Oklahoma",94,94,0,249,40,00300
"Adamson CDP, Oklahoma",0,0,0,0,40,00350
"Addington town, Oklahoma",21,21,0,95,40,00450
"Afton town, Oklahoma",303,273,30,779,40,00600
"Agra town, Oklahoma",200,197,3,594,40,00700
"Akins CDP, Oklahoma",190,174,16,499,40,00900
"Albany CDP, Oklahoma",25,25,0,114,40,00950
"Albion town, Oklahoma",23,21,2,66,40,01050
"Alderson town, Oklahoma",120,116,4,196,40,01150
"Alex town, Oklahoma",241,230,11,633,40,01250
"Aline town, Oklahoma",121,118,3,203,40,01350
"Allen town, Oklahoma",353,328,25,930,40,01400
"Altus city, Oklahoma",8379,7983,396,18711,40,01700
"Alva city, Oklahoma",2679,2543,136,5020,40,01800
"Amber town, Oklahoma",195,185,10,412,40,01900
"Ames town, Oklahoma",146,141,5,232,40,01950
"Amorita town, Oklahoma",13,13,0,24,40,02000
"Anadarko city, Oklahoma",2428,2238,190,5723,40,02050
"Antlers city, Oklahoma",812,708,104,2361,40,02250
"Apache town, Oklahoma",464,429,35,1065,40,02300
"Arapaho town, Oklahoma",256,247,9,795,40,02500
"Arcadia town, Oklahoma",45,42,3,106,40,02550
"Ardmore city, Oklahoma",11411,10822,589,24784,40,02600
"Arkoma town, Oklahoma",744,666,78,1866,40,02650
"Armstrong town, Oklahoma",51,47,4,119,40,02750
"Arnett town, Oklahoma",247,233,14,533,40,02800
"Arpelar CDP, Oklahoma",145,145,0,315,40,02900
"Asher town, Oklahoma",129,120,9,499,40,03000
"Ashland town, Oklahoma",22,19,3,46,40,03050
"Atoka city, Oklahoma",1016,943,73,3160,40,03300
"Atwood town, Oklahoma",26,24,2,91,40,03350
"Avant town, Oklahoma",94,92,2,239,40,03500
"Avard CDP, Oklahoma",6,6,0,13,40,03550
"Bache CDP, Oklahoma",27,27,0,81,40,03750
"Badger Lee CDP, Oklahoma",6,0,6,45,40,03815
"Baker CDP, Oklahoma",67,67,0,97,40,03900
"Ballou CDP, Oklahoma",89,89,0,157,40,04075
"Barber CDP, Oklahoma",155,155,0,333,40,04200
"Barnsdall city, Oklahoma",436,409,27,1019,40,04250
"Baron CDP, Oklahoma",165,165,0,390,40,04350
"Bartlesville city, Oklahoma",17205,16492,713,37314,40,04450
"Bearden town, Oklahoma",60,58,2,124,40,04700
"Beaver town, Oklahoma",715,694,21,1524,40,04750
"Bee CDP, Oklahoma",17,17,0,145,40,04950
"Beggs city, Oklahoma",429,397,32,1126,40,05000
"Belfonte CDP, Oklahoma",96,84,12,249,40,05070
"Bell CDP, Oklahoma",67,49,18,343,40,05090
"Bennington town, Oklahoma",101,99,2,328,40,05400
"Bentley CDP, Oklahoma",42,38,4,80,40,05450
"Bernice town, Oklahoma",136,130,6,370,40,05550
"Bessie town, Oklahoma",110,95,15,247,40,05650
"Bethany city, Oklahoma",9959,9488,471,20620,40,05700
"Bethel Acres town, Oklahoma",1432,1406,26,3066,40,05800
"Big Cabin town, Oklahoma",82,81,1,176,40,05900
"Billings town, Oklahoma",174,169,5,463,40,06100
"Binger town, Oklahoma",188,175,13,478,40,06200
"Bison CDP, Oklahoma",36,36,0,71,40,06350
"Bixby city, Oklahoma",14280,13765,515,28731,40,06400
"Blackburn town, Oklahoma",33,31,2,94,40,06450
"Blackgum CDP, Oklahoma",14,0,14,54,40,06500
"Blackwell city, Oklahoma",2761,2579,182,6132,40,06600
"Blair town, Oklahoma",277,271,6,555,40,06650
"Blanchard city, Oklahoma",4590,4345,245,8708,40,06700
"Blanco CDP, Oklahoma",25,22,3,76,40,06750
"Blue CDP, Oklahoma",39,35,4,94,40,06900
"Bluejacket town, Oklahoma",114,107,7,271,40,06950
"Boise City city, Oklahoma",554,554,0,1140,40,07300
"Bokchito town, Oklahoma",201,188,13,510,40,07350
"Bokoshe town, Oklahoma",146,135,11,436,40,07450
"Boley town, Oklahoma",100,93,7,1108,40,07500
"Boswell town, Oklahoma",233,215,18,767,40,07750
"Bowlegs town, Oklahoma",135,124,11,372,40,07950
"Bowring CDP, Oklahoma",35,35,0,82,40,08000
"Box CDP, Oklahoma",27,27,0,139,40,08050
"Boynton town, Oklahoma",56,51,5,145,40,08150
"Bradley town, Oklahoma",35,31,4,139,40,08300
"Braggs town, Oklahoma",69,67,2,199,40,08400
"Braman town, Oklahoma",50,50,0,132,40,08450
"Bray town, Oklahoma",511,490,21,1024,40,08550
"Breckenridge town, Oklahoma",64,64,0,164,40,08600
"Brent CDP, Oklahoma",272,272,0,693,40,08650
"Briartown CDP, Oklahoma",49,46,3,116,40,08700
"Bridge Creek town, Oklahoma",278,270,8,440,40,08725
"Bridgeport city, Oklahoma",56,48,8,125,40,08750
"Briggs CDP, Oklahoma",532,485,47,1175,40,08775
"Bristow city, Oklahoma",1545,1481,64,4253,40,08900
"Broken Arrow city, Oklahoma",60615,57983,2632,114237,40,09050
"Broken Bow city, Oklahoma",1620,1620,0,4222,40,09100
"Bromide town, Oklahoma",44,43,1,122,40,09150
"Brooksville town, Oklahoma",25,19,6,49,40,09400
"Brush Creek CDP, Oklahoma",102,102,0,102,40,09612
"Brushy CDP, Oklahoma",418,379,39,973,40,09650
"Bryant CDP, Oklahoma",14,14,0,14,40,09700
"Buffalo town, Oklahoma",541,526,15,1273,40,09850
"Bug Tussle CDP, Oklahoma",87,72,15,181,40,09875
"Bull Hollow CDP, Oklahoma",86,47,39,125,40,09887
"Bunch CDP, Oklahoma",12,12,0,37,40,09900
"Burbank town, Oklahoma",65,60,5,122,40,09950
"Burlington town, Oklahoma",105,105,0,183,40,10050
"Burneyville CDP, Oklahoma",345,330,15,860,40,10150
"Burns Flat town, Oklahoma",852,803,49,2042,40,10250
"Bushyhead CDP, Oklahoma",704,631,73,1444,40,10400
"Butler town, Oklahoma",109,109,0,246,40,10450
"Butler CDP, Oklahoma",11,11,0,169,40,10460
"Byars town, Oklahoma",58,58,0,222,40,10550
"Byng town, Oklahoma",716,681,35,1473,40,10600
"Byron town, Oklahoma",7,7,0,11,40,10650
"Cache city, Oklahoma",1348,1266,82,2974,40,10700
"Caddo town, Oklahoma",499,473,26,1045,40,10800
"Calera town, Oklahoma",1448,1421,27,2896,40,10950
"Calumet town, Oklahoma",139,135,4,435,40,11050
"Calvin town, Oklahoma",125,125,0,411,40,11100
"Camargo town, Oklahoma",91,71,20,174,40,11150
"Cameron town, Oklahoma",130,124,6,283,40,11300
"Canadian town, Oklahoma",84,81,3,212,40,11450
"Canadian Shores CDP, Oklahoma",72,69,3,281,40,11530
"Caney town, Oklahoma",43,42,1,153,40,11550
"Caney CDP, Oklahoma",238,237,1,401,40,11562
"Caney Ridge CDP, Oklahoma",39,39,0,71,40,11575
"Canton town, Oklahoma",184,150,34,520,40,11600
"Canute town, Oklahoma",232,232,0,498,40,11650
"Capron town, Oklahoma",0,0,0,0,40,11750
"Carlisle CDP, Oklahoma",120,120,0,567,40,11975
"Carlton Landing town, Oklahoma",19,19,0,43,40,11990
"Carmen town, Oklahoma",135,129,6,313,40,12000
"Carnegie town, Oklahoma",653,600,53,1585,40,12050
"Carney town, Oklahoma",224,221,3,518,40,12100
"Carrier town, Oklahoma",45,43,2,89,40,12200
"Carter town, Oklahoma",84,82,2,166,40,12300
"Cartwright CDP, Oklahoma",325,325,0,723,40,12550
"Cashion town, Oklahoma",721,700,21,1319,40,12650
"Castle town, Oklahoma",43,39,4,152,40,12750
"Catoosa city, Oklahoma",4154,3920,234,7680,40,12900
"Cave Spring CDP, Oklahoma",42,42,0,76,40,12910
"Cayuga CDP, Oklahoma",70,64,6,150,40,12915
"Cedar Crest CDP, Oklahoma",104,104,0,257,40,12930
"Cedar Lake CDP, Oklahoma",160,157,3,360,40,12937
"Cedar Valley city, Oklahoma",184,181,3,500,40,12960
"Cement town, Oklahoma",251,227,24,536,40,13000
"Centrahoma city, Oklahoma",10,10,0,54,40,13100
"Central High town, Oklahoma",638,597,41,1480,40,13135
"Chance CDP, Oklahoma",125,125,0,317,40,13475
"Chandler city, Oklahoma",1191,1171,20,2886,40,13500
"Chattanooga town, Oklahoma",177,167,10,432,40,13600
"Checotah city, Oklahoma",1160,1051,109,3048,40,13650
"Chelsea town, Oklahoma",896,788,108,1914,40,13700
"Cherokee city, Oklahoma",742,691,51,1556,40,13750
"Cherry Tree CDP, Oklahoma",284,276,8,726,40,13775
"Chester CDP, Oklahoma",30,30,0,74,40,13800
"Chewey CDP, Oklahoma",87,87,0,346,40,13850
"Cheyenne town, Oklahoma",375,351,24,817,40,13900
"Chickasha city, Oklahoma",7528,7098,430,16231,40,13950
"Choctaw city, Oklahoma",5452,5317,135,12154,40,14200
"Chouteau town, Oklahoma",836,812,24,2071,40,14300
"Christie CDP, Oklahoma",82,82,0,135,40,14350
"Cimarron City town, Oklahoma",66,63,3,161,40,14500
"Claremore city, Oklahoma",9514,8958,556,19724,40,14700
"Clarita CDP, Oklahoma",38,31,7,179,40,14750
"Clarksville CDP, Oklahoma",0,0,0,0,40,14800
"Clayton town, Oklahoma",285,245,40,662,40,14900
"Clearview town, Oklahoma",25,25,0,44,40,15050
"Cleora CDP, Oklahoma",736,684,52,1508,40,15250
"Cleo Springs town, Oklahoma",117,117,0,360,40,15300
"Cleveland city, Oklahoma",1439,1375,64,3213,40,15350
"Clinton city, Oklahoma",4417,4417,0,8499,40,15400
"Cloud Creek CDP, Oklahoma",58,54,4,206,40,15625
"Coalgate city, Oklahoma",803,732,71,1886,40,15800
"Colbert town, Oklahoma",696,659,37,1336,40,16050
"Colcord town, Oklahoma",344,318,26,827,40,16100
"Cole town, Oklahoma",410,398,12,853,40,16200
"Coleman CDP, Oklahoma",161,157,4,297,40,16250
"Collinsville city, Oklahoma",4380,4019,361,8073,40,16350
"Colony town, Oklahoma",96,88,8,151,40,16400
"Comanche city, Oklahoma",478,445,33,1635,40,16450
"Commerce city, Oklahoma",936,899,37,2302,40,16500
"Connerville CDP, Oklahoma",42,42,0,125,40,16700
"Cookson CDP, Oklahoma",524,524,0,1095,40,16950
"Cooperton town, Oklahoma",1,1,0,5,40,17050
"Copan town, Oklahoma",331,309,22,886,40,17100
"Copeland CDP, Oklahoma",630,590,40,1406,40,17110
"Corn town, Oklahoma",238,206,32,601,40,17300
"Cornish town, Oklahoma",52,52,0,132,40,17350
"Cottonwood CDP, Oklahoma",42,38,4,101,40,17450
"Council Hill town, Oklahoma",34,30,4,88,40,17550
"Covington town, Oklahoma",214,200,14,392,40,17700
"Coweta city, Oklahoma",4819,4562,257,9903,40,17800
"Cowlington town, Oklahoma",21,21,0,90,40,17850
"Coyle town, Oklahoma",171,155,16,600,40,17950
"Crescent city, Oklahoma",706,670,36,1552,40,18250
"Crescent Springs CDP, Oklahoma",92,92,0,271,40,18275
"Cromwell town, Oklahoma",84,78,6,245,40,18450
"Crowder town, Oklahoma",148,142,6,393,40,18550
"Cumberland CDP, Oklahoma",218,189,29,749,40,18750
"Cushing city, Oklahoma",3696,3528,168,8336,40,18850
"Custer City town, Oklahoma",257,253,4,582,40,18950
"Cyril town, Oklahoma",305,253,52,713,40,19000
"Dacoma town, Oklahoma",49,49,0,119,40,19050
"Dale CDP, Oklahoma",59,59,0,257,40,19150
"Davenport town, Oklahoma",278,276,2,686,40,19350
"Davidson town, Oklahoma",105,99,6,247,40,19400
"Davis city, Oklahoma",1271,1189,82,2821,40,19450
"Deer Creek town, Oklahoma",37,37,0,83,40,19650
"Deer Lick CDP, Oklahoma",40,40,0,92,40,19665
"Delaware town, Oklahoma",119,109,10,329,40,19850
"Del City city, Oklahoma",9998,9379,619,21682,40,19900
"Dennis CDP, Oklahoma",79,79,0,214,40,20100
"Depew town, Oklahoma",174,166,8,395,40,20300
"Devol town, Oklahoma",84,71,13,166,40,20450
"Dewar town, Oklahoma",274,241,33,739,40,20500
"Dewey city, Oklahoma",1292,1266,26,3379,40,20550
"Dibble town, Oklahoma",508,460,48,1093,40,20650
"Dickson town, Oklahoma",677,661,16,1445,40,20700
"Dill City town, Oklahoma",150,141,9,302,40,20850
"Disney town, Oklahoma",85,78,7,178,40,20900
"Dixon CDP, Oklahoma",85,85,0,168,40,21000
"Dodge CDP, Oklahoma",36,23,13,42,40,21020
"Dotyville CDP, Oklahoma",65,65,0,84,40,21150
"Dougherty town, Oklahoma",90,76,14,212,40,21200
"Douglas town, Oklahoma",13,12,1,32,40,21250
"Dover town, Oklahoma",131,131,0,288,40,21350
"Dripping Springs CDP, Oklahoma",25,23,2,46,40,21672
"Drowning Creek CDP, Oklahoma",11,11,0,129,40,21676
"Drummond town, Oklahoma",190,174,16,412,40,21700
"Drumright city, Oklahoma",1021,988,33,2285,40,21750
"Dry Creek CDP, Oklahoma",68,68,0,215,40,21755
"Duchess Landing CDP, Oklahoma",0,0,0,0,40,21760
"Duncan city, Oklahoma",10049,9525,524,22759,40,21900
"Durant city, Oklahoma",9065,8569,496,18759,40,22050
"Durham CDP, Oklahoma",10,10,0,37,40,22100
"Dustin town, Oklahoma",78,59,19,447,40,22200
"Dwight Mission CDP, Oklahoma",6,6,0,35,40,22275
"Eagle City CDP, Oklahoma",6,6,0,16,40,22300
"Eagletown CDP, Oklahoma",173,169,4,400,40,22350
"Eakly town, Oklahoma",193,189,4,460,40,22400
"Earl CDP, Oklahoma",41,41,0,79,40,22450
"Earlsboro town, Oklahoma",212,192,20,495,40,22500
"East Duke town, Oklahoma",165,165,0,346,40,22550
"Edgewater Park CDP, Oklahoma",45,39,6,147,40,23100
"Edmond city, Oklahoma",48574,46883,1691,94503,40,23200
"Eldon CDP, Oklahoma",138,138,0,327,40,23300
"Eldorado town, Oklahoma",206,204,2,418,40,23350
"Elgin city, Oklahoma",1297,1242,55,3498,40,23450
"Elk City city, Oklahoma",5636,5347,289,11494,40,23500
"Elmer town, Oklahoma",20,20,0,40,40,23550
"Elm Grove CDP, Oklahoma",41,41,0,154,40,23575
"Elmore City town, Oklahoma",250,237,13,728,40,23600
"Elohim City CDP, Oklahoma",12,12,0,37,40,23675
"El Reno city, Oklahoma",8069,7550,519,17474,40,23700
"Emet CDP, Oklahoma",12,12,0,51,40,23850
"Empire City town, Oklahoma",356,347,9,761,40,23900
"Enid city, Oklahoma",23766,22640,1126,50961,40,23950
"Enterprise CDP, Oklahoma",74,56,18,141,40,24050
"Erick city, Oklahoma",323,314,9,716,40,24200
"Erin Springs town, Oklahoma",52,52,0,83,40,24300
"Etowah town, Oklahoma",27,27,0,104,40,24460
"Etta CDP, Oklahoma",0,0,0,36,40,24500
"Eufaula city, Oklahoma",746,727,19,2776,40,24650
"Evening Shade CDP, Oklahoma",142,140,2,390,40,24762
"Fairfax town, Oklahoma",459,390,69,1172,40,24850
"Fairfield CDP, Oklahoma",204,204,0,535,40,24875
"Fairland town, Oklahoma",516,500,16,1234,40,24900
"Fairmont town, Oklahoma",85,80,5,124,40,24950
"Fair Oaks town, Oklahoma",45,44,1,76,40,25000
"Fairview city, Oklahoma",1063,1058,5,2703,40,25100
"Fallis town, Oklahoma",31,31,0,35,40,25250
"Fanshawe town, Oklahoma",105,101,4,356,40,25400
"Fargo town, Oklahoma",170,155,15,400,40,25450
"Faxon town, Oklahoma",27,27,0,64,40,25650
"Fay CDP, Oklahoma",25,25,0,56,40,25700
"Felt CDP, Oklahoma",29,29,0,78,40,25850
"Finley CDP, Oklahoma",0,0,0,0,40,26000
"Fittstown CDP, Oklahoma",30,30,0,47,40,26200
"Fitzhugh town, Oklahoma",114,72,42,309,40,26250
"Fletcher town, Oklahoma",497,480,17,1148,40,26350
"Flint Creek CDP, Oklahoma",358,340,18,969,40,26415
"Flute Springs CDP, Oklahoma",45,36,9,97,40,26525
"Foraker town, Oklahoma",11,11,0,13,40,26750
"Forest Park town, Oklahoma",409,404,5,881,40,26850
"Forgan town, Oklahoma",166,163,3,286,40,26900
"Fort Cobb town, Oklahoma",216,214,2,499,40,27100
"Fort Coffee town, Oklahoma",137,136,1,381,40,27150
"Fort Gibson town, Oklahoma",1904,1850,54,3810,40,27200
"Fort Supply town, Oklahoma",165,148,17,324,40,27350
"Fort Towson town, Oklahoma",238,194,44,548,40,27400
"Foss town, Oklahoma",51,43,8,157,40,27450
"Foster town, Oklahoma",108,102,6,254,40,27500
"Fox CDP, Oklahoma",25,25,0,53,40,27550
"Foyil town, Oklahoma",278,248,30,583,40,27600
"Francis town, Oklahoma",163,144,19,323,40,27650
"Frederick city, Oklahoma",1370,1331,39,3486,40,27800
"Freedom town, Oklahoma",94,94,0,168,40,27850
"Friendship town, Oklahoma",6,6,0,13,40,27900
"Gage town, Oklahoma",192,152,40,431,40,28250
"Gans town, Oklahoma",129,116,13,352,40,28350
"Garber city, Oklahoma",373,357,16,664,40,28500
"Garvin town, Oklahoma",76,72,4,154,40,28700
"Gate town, Oklahoma",48,44,4,90,40,28800
"Geary city, Oklahoma",323,320,3,853,40,28900
"Gene Autry town, Oklahoma",108,93,15,208,40,28950
"Geronimo town, Oklahoma",606,557,49,1191,40,29100
"Gerty town, Oklahoma",27,26,1,81,40,29150
"Gideon CDP, Oklahoma",110,106,4,270,40,29300
"Glencoe town, Oklahoma",214,190,24,481,40,29400
"Glenpool city, Oklahoma",7723,7415,308,13683,40,29600
"Golden CDP, Oklahoma",29,22,7,40,40,29800
"Goldsby town, Oklahoma",1245,1203,42,2744,40,29850
"Goltry town, Oklahoma",152,152,0,277,40,29900
"Goodwell town, Oklahoma",520,483,37,1059,40,30200
"Gore town, Oklahoma",389,334,55,1129,40,30300
"Gotebo town, Oklahoma",167,166,1,278,40,30350
"Gould town, Oklahoma",38,38,0,110,40,30400
"Gowen CDP, Oklahoma",27,27,0,157,40,30500
"Gracemont town, Oklahoma",123,117,6,292,40,30600
"Grainola town, Oklahoma",18,18,0,40,40,30750
"Grandfield city, Oklahoma",328,293,35,912,40,30850
"Grand Lake Towne town, Oklahoma",26,26,0,237,40,30900
"Grandview CDP, Oklahoma",434,434,0,1012,40,30915
"Granite town, Oklahoma",296,294,2,1473,40,30950
"Grant CDP, Oklahoma",111,95,16,247,40,31000
"Grayson town, Oklahoma",38,36,2,132,40,31150
"Greasy CDP, Oklahoma",96,86,10,225,40,31165
"Greenfield town, Oklahoma",44,44,0,117,40,31250
"Greenville CDP, Oklahoma",52,52,0,119,40,31375
"Gregory CDP, Oklahoma",210,210,0,395,40,31425
"Grove city, Oklahoma",2935,2894,41,7012,40,31600
"Guthrie city, Oklahoma",4869,4751,118,10872,40,31700
"Guymon city, Oklahoma",6702,6514,188,12743,40,31750
"Haileyville city, Oklahoma",260,232,28,656,40,31900
"Hallett town, Oklahoma",28,28,0,73,40,32050
"Hammon town, Oklahoma",166,157,9,391,40,32250
"Hanna town, Oklahoma",23,23,0,83,40,32350
"Hanson CDP, Oklahoma",78,78,0,171,40,32400
"Hardesty town, Oklahoma",330,329,1,373,40,32550
"Harrah city, Oklahoma",2865,2768,97,6259,40,32750
"Hartshorne city, Oklahoma",714,672,42,1754,40,32850
"Haskell town, Oklahoma",583,540,43,1824,40,32900
"Hastings town, Oklahoma",26,26,0,109,40,33000
"Haworth town, Oklahoma",120,105,15,283,40,33150
"Haywood CDP, Oklahoma",58,54,4,190,40,33250
"Headrick town, Oklahoma",36,34,2,86,40,33300
"Healdton city, Oklahoma",934,904,30,2361,40,33350
"Heavener city, Oklahoma",1165,1094,71,3012,40,33400
"Helena town, Oklahoma",134,126,8,1459,40,33450
"Hendrix town, Oklahoma",26,26,0,60,40,33600
"Hennepin CDP, Oklahoma",82,82,0,144,40,33650
"Hennessey town, Oklahoma",1175,1114,61,2669,40,33700
"Henryetta city, Oklahoma",2266,2042,224,5639,40,33750
"Hickory town, Oklahoma",64,60,4,135,40,34150
"Hillsdale town, Oklahoma",41,37,4,77,40,34650
"Hinton town, Oklahoma",1733,1671,62,4811,40,34750
"Hitchcock town, Oklahoma",6,6,0,17,40,34850
"Hitchita town, Oklahoma",11,11,0,55,40,34900
"Hobart city, Oklahoma",1408,1305,103,3386,40,35000
"Hochatown CDP, Oklahoma",102,102,0,206,40,35030
"Hodgen CDP, Oklahoma",24,24,0,50,40,35150
"Hoffman town, Oklahoma",31,29,2,95,40,35300
"Holdenville city, Oklahoma",1983,1831,152,5900,40,35400
"Hollis city, Oklahoma",737,653,84,1552,40,35500
"Hollister town, Oklahoma",15,6,9,41,40,35550
"Homestead CDP, Oklahoma",5,5,0,32,40,35800
"Hominy city, Oklahoma",795,742,53,3327,40,35850
"Honey Hill CDP, Oklahoma",46,46,0,183,40,35875
"Hooker city, Oklahoma",605,579,26,1561,40,36000
"Hoot Owl town, Oklahoma",0,0,0,0,40,36020
"Hopeton CDP, Oklahoma",5,5,0,5,40,36050
"Horntown town, Oklahoma",45,45,0,119,40,36090
"Hough CDP, Oklahoma",26,26,0,28,40,36115
"Howe town, Oklahoma",343,332,11,752,40,36150
"Hoyt CDP, Oklahoma",12,12,0,97,40,36200
"Hugo city, Oklahoma",1998,1826,172,5178,40,36300
"Hulbert town, Oklahoma",208,184,24,485,40,36400
"Hunter town, Oklahoma",56,52,4,131,40,36600
"Hydro town, Oklahoma",488,468,20,1128,40,36700
"Idabel city, Oklahoma",2933,2691,242,6994,40,36750
"Indiahoma town, Oklahoma",133,132,1,288,40,36850
"Indianola CDP, Oklahoma",0,0,0,0,40,36945
"Indianola town, Oklahoma",43,37,6,141,40,36950
"Ingalls CDP, Oklahoma",82,82,0,130,40,37000
"Inola town, Oklahoma",926,842,84,1879,40,37100
"Iron Post CDP, Oklahoma",12,12,0,36,40,37275
"Isabella CDP, Oklahoma",62,62,0,86,40,37350
"IXL town, Oklahoma",13,13,0,30,40,37410
"Jay city, Oklahoma",1152,1033,119,2900,40,37650
"Jefferson town, Oklahoma",1,1,0,11,40,37750
"Jenks city, Oklahoma",13102,12561,541,25872,40,37800
"Jennings town, Oklahoma",105,103,2,291,40,37850
"Jet town, Oklahoma",106,106,0,251,40,38000
"Johnson town, Oklahoma",224,207,17,752,40,38200
"Johnson Prairie CDP, Oklahoma",74,74,0,135,40,38201
"Jones town, Oklahoma",1289,1223,66,2925,40,38350
"Justice CDP, Oklahoma",763,750,13,1630,40,38475
"Kansas town, Oklahoma",383,371,12,770,40,38600
"Katie town, Oklahoma",186,185,1,391,40,38700
"Kaw City city, Oklahoma",104,101,3,288,40,38800
"Keefton CDP, Oklahoma",292,292,0,845,40,38850
"Kellyville town, Oklahoma",534,520,14,1086,40,39000
"Kemp town, Oklahoma",79,79,0,237,40,39050
"Kendrick town, Oklahoma",40,40,0,86,40,39150
"Kenefic town, Oklahoma",64,62,2,146,40,39200
"Kenton CDP, Oklahoma",0,0,0,0,40,39400
"Kenwood CDP, Oklahoma",498,464,34,1279,40,39450
"Keota town, Oklahoma",169,169,0,525,40,39500
"Ketchum town, Oklahoma",264,243,21,533,40,39550
"Keyes town, Oklahoma",71,70,1,186,40,39600
"Keys CDP, Oklahoma",466,437,29,1063,40,39625
"Kiefer town, Oklahoma",1206,1161,45,2284,40,39750
"Kildare town, Oklahoma",38,33,5,78,40,39800
"Kingfisher city, Oklahoma",2270,2228,42,4947,40,39850
"Kingston town, Oklahoma",735,704,31,1726,40,39900
"Kinta town, Oklahoma",99,89,10,279,40,39950
"Kiowa town, Oklahoma",290,264,26,687,40,40000
"Knowles town, Oklahoma",8,8,0,11,40,40100
"Konawa city, Oklahoma",376,362,14,1169,40,40200
"Krebs city, Oklahoma",783,742,41,1994,40,40300
"Kremlin town, Oklahoma",199,195,4,318,40,40400
"Lahoma town, Oklahoma",322,315,7,652,40,40700
"Lake Aluma town, Oklahoma",29,27,2,53,40,40800
"Lake Ellsworth Addition CDP, Oklahoma",79,79,0,183,40,40875
"Lakeside Village CDP, Oklahoma",28,28,0,102,40,41050
"Lamar town, Oklahoma",69,66,3,200,40,41250
"Lambert town, Oklahoma",4,4,0,7,40,41300
"Lamont town, Oklahoma",179,179,0,267,40,41350
"Lane CDP, Oklahoma",110,110,0,314,40,41400
"Langley town, Oklahoma",312,296,16,571,40,41500
"Langston town, Oklahoma",541,424,117,1691,40,41550
"Latta CDP, Oklahoma",542,511,31,1286,40,41680
"Laverne town, Oklahoma",506,491,15,1035,40,41700
"Lawrence Creek town, Oklahoma",26,26,0,112,40,41760
"Lawton city, Oklahoma",35938,33155,2783,91023,40,41850
"Lawtonka Acres CDP, Oklahoma",76,76,0,119,40,41856
"Leach CDP, Oklahoma",89,86,3,270,40,41900
"Lebanon CDP, Oklahoma",103,99,4,212,40,41950
"Leedey town, Oklahoma",243,231,12,553,40,42050
"Le Flore town, Oklahoma",50,49,1,148,40,42150
"Lehigh city, Oklahoma",100,89,11,241,40,42200
"Lenapah town, Oklahoma",118,116,2,268,40,42300
"Leon town, Oklahoma",23,21,2,86,40,42450
"Leonard CDP, Oklahoma",83,63,20,192,40,42500
"Lequire CDP, Oklahoma",70,60,10,131,40,42600
"Lexington city, Oklahoma",754,715,39,2037,40,42700
"Liberty CDP, Oklahoma",92,92,0,274,40,42850
"Liberty town, Oklahoma",107,105,2,198,40,42860
"Lima town, Oklahoma",28,26,2,69,40,43000
"Limestone CDP, Oklahoma",441,433,8,802,40,43057
"Lindsay city, Oklahoma",1326,1283,43,2863,40,43150
"Little City CDP, Oklahoma",13,13,0,71,40,43400
"Little Ponderosa CDP, Oklahoma",179,179,0,269,40,43425
"Little Rock CDP, Oklahoma",89,63,26,172,40,43442
"Loco town, Oklahoma",27,22,5,70,40,43450
"Locust Grove town, Oklahoma",652,611,41,1424,40,43500
"Lone Chimney town, Oklahoma",39,39,0,61,40,43725
"Lone Grove city, Oklahoma",2488,2385,103,5026,40,43750
"Lone Wolf town, Oklahoma",132,128,4,437,40,43850
"Long CDP, Oklahoma",156,156,0,390,40,43900
"Longdale town, Oklahoma",63,62,1,163,40,43950
"Longtown CDP, Oklahoma",945,903,42,2807,40,43975
"Lookeba town, Oklahoma",41,41,0,88,40,44000
"Lost City CDP, Oklahoma",277,261,16,769,40,44075
"Lotsee town, Oklahoma",3,3,0,5,40,44100
"Loveland town, Oklahoma",3,3,0,5,40,44150
"Lovell CDP, Oklahoma",25,25,0,49,40,44200
"Lowrey CDP, Oklahoma",100,94,6,348,40,44275
"Loyal town, Oklahoma",44,31,13,112,40,44300
"Lucien CDP, Oklahoma",109,81,28,114,40,44350
"Luther town, Oklahoma",790,790,0,1365,40,44500
"Lyons Switch CDP, Oklahoma",273,243,30,570,40,44775
"McAlester city, Oklahoma",7493,6897,596,18110,40,44800
"McBride CDP, Oklahoma",28,28,0,83,40,44900
"McCord CDP, Oklahoma",747,674,73,1625,40,44925
"McCurtain town, Oklahoma",145,138,7,420,40,44950
"McLoud city, Oklahoma",1430,1377,53,4394,40,45350
"Macomb town, Oklahoma",7,7,0,18,40,45500
"Madill city, Oklahoma",1608,1514,94,3929,40,45750
"Mallard Bay CDP, Oklahoma",77,63,14,281,40,45930
"Manchester town, Oklahoma",43,43,0,137,40,46000
"Mangum city, Oklahoma",986,877,109,2775,40,46050
"Manitou town, Oklahoma",64,64,0,229,40,46150
"Mannford town, Oklahoma",1417,1390,27,3275,40,46200
"Mannsville town, Oklahoma",395,377,18,966,40,46300
"Maramec town, Oklahoma",26,22,4,66,40,46400
"Marble City town, Oklahoma",67,54,13,153,40,46450
"Marietta CDP, Oklahoma",50,50,0,127,40,46488
"Marietta city, Oklahoma",1188,1144,44,2820,40,46500
"Marland town, Oklahoma",101,75,26,298,40,46550
"Marlow city, Oklahoma",1507,1435,72,4417,40,46600
"Marshall town, Oklahoma",202,202,0,335,40,46650
"Martha town, Oklahoma",65,55,10,127,40,46700
"Maud city, Oklahoma",322,303,19,872,40,46900
"May town, Oklahoma",13,8,5,39,40,47000
"Maysville town, Oklahoma",543,539,4,1479,40,47150
"Mazie CDP, Oklahoma",41,41,0,117,40,47200
"Mead town, Oklahoma",174,171,3,363,40,47250
"Medford city, Oklahoma",421,420,1,949,40,47300
"Medicine Park town, Oklahoma",172,166,6,319,40,47350
"Meeker town, Oklahoma",520,506,14,1292,40,47450
"Mehan CDP, Oklahoma",20,20,0,68,40,47550
"Meno town, Oklahoma",144,143,1,226,40,47750
"Meridian town, Oklahoma",4,4,0,26,40,47800
"Miami city, Oklahoma",5419,5240,179,12995,40,48000
"Middleberg CDP, Oklahoma",33,33,0,133,40,48100
"Midwest City city, Oklahoma",27838,25814,2024,58124,40,48350
"Milburn town, Oklahoma",111,105,6,268,40,48400
"Milfay CDP, Oklahoma",49,49,0,98,40,48450
"Mill Creek town, Oklahoma",104,101,3,262,40,48500
"Millerton town, Oklahoma",89,89,0,210,40,48600
"Minco city, Oklahoma",733,704,29,1502,40,48750
"Moffett town, Oklahoma",19,19,0,56,40,49000
"Monroe CDP, Oklahoma",41,22,19,132,40,49050
"Moodys CDP, Oklahoma",480,448,32,1099,40,49100
"Moore city, Oklahoma",33281,31930,1351,62685,40,49200
"Mooreland town, Oklahoma",458,455,3,1028,40,49250
"Morris city, Oklahoma",676,624,52,1615,40,49400
"Morrison town, Oklahoma",407,394,13,699,40,49450
"Mounds town, Oklahoma",431,420,11,1099,40,49550
"Mountain Park town, Oklahoma",129,125,4,363,40,49600
"Mountain View town, Oklahoma",291,289,2,604,40,49650
"Moyers CDP, Oklahoma",25,25,0,113,40,49750
"Mulberry CDP, Oklahoma",24,24,0,66,40,49825
"Muldrow town, Oklahoma",1445,1380,65,3294,40,49850
"Mule Barn town, Oklahoma",0,0,0,0,40,49860
"Mulhall town, Oklahoma",185,177,8,282,40,49900
"Murphy CDP, Oklahoma",47,47,0,138,40,49950
"Muskogee city, Oklahoma",16045,15002,1043,36933,40,50050
"Mustang city, Oklahoma",10792,10353,439,20518,40,50100
"Mutual town, Oklahoma",11,11,0,27,40,50150
"Narcissa CDP, Oklahoma",30,30,0,111,40,50200
"Nardin CDP, Oklahoma",65,65,0,112,40,50250
"Nash town, Oklahoma",54,41,13,127,40,50300
"Nashoba CDP, Oklahoma",19,19,0,45,40,50350
"Nelagoney CDP, Oklahoma",27,27,0,61,40,50800
"Nescatunga CDP, Oklahoma",48,40,8,129,40,50975
"New Alluwe town, Oklahoma",23,21,2,64,40,51050
"Newcastle city, Oklahoma",6009,5825,184,11508,40,51150
"New Cordell city, Oklahoma",1267,1205,62,2769,40,51250
"New Eucha CDP, Oklahoma",191,191,0,330,40,51275
"Newkirk city, Oklahoma",740,695,45,1892,40,51300
"New Woodville town, Oklahoma",12,12,0,28,40,51750
"Nichols Hills city, Oklahoma",1807,1802,5,3854,40,51800
"Nicoma Park city, Oklahoma",1108,1070,38,2542,40,51850
"Nicut CDP, Oklahoma",123,106,17,348,40,51900
"Ninnekah town, Oklahoma",444,431,13,989,40,52100
"Noble city, Oklahoma",3571,3449,122,7168,40,52150
"Norge town, Oklahoma",72,70,2,149,40,52450
"Norman city, Oklahoma",68461,64518,3943,127701,40,52500
"North Enid town, Oklahoma",521,475,46,1214,40,52600
"North Miami town, Oklahoma",104,102,2,290,40,52700
"Norwood CDP, Oklahoma",682,649,33,1402,40,52859
"Notchietown CDP, Oklahoma",124,101,23,298,40,52862
"Nowata city, Oklahoma",1464,1362,102,3543,40,52900
"Oak Grove town, Oklahoma",37,37,0,64,40,53210
"Oak Hill-Piney CDP, Oklahoma",73,62,11,143,40,53301
"Oakhurst CDP, Oklahoma",1102,1037,65,2010,40,53350
"Oakland town, Oklahoma",618,546,72,1163,40,53400
"Oaks town, Oklahoma",72,66,6,277,40,53550
"Oakwood town, Oklahoma",36,35,1,61,40,53600
"Ochelata town, Oklahoma",299,290,9,612,40,53700
"Oilton city, Oklahoma",321,310,11,806,40,54000
"Okarche town, Oklahoma",641,608,33,1383,40,54050
"Okay town, Oklahoma",199,182,17,432,40,54100
"Okeene town, Oklahoma",462,417,45,1044,40,54150
"Okemah city, Oklahoma",1069,1057,12,3078,40,54200
"Oklahoma City city, Oklahoma",352132,336414,15718,681088,40,55000
"Okmulgee city, Oklahoma",4754,4318,436,11366,40,55150
"Oktaha town, Oklahoma",127,116,11,270,40,55200
"Old Eucha CDP, Oklahoma",8,7,1,16,40,55275
"Old Green CDP, Oklahoma",131,110,21,522,40,55285
"Olive CDP, Oklahoma",22,22,0,79,40,55350
"Olustee town, Oklahoma",219,214,5,659,40,55450
"Oologah town, Oklahoma",928,858,70,1783,40,55750
"Optima town, Oklahoma",118,118,0,237,40,55850
"Orlando town, Oklahoma",52,52,0,106,40,56050
"Osage town, Oklahoma",39,35,4,87,40,56150
"Owasso city, Oklahoma",20176,19255,921,38134,40,56650
"Paden town, Oklahoma",171,164,7,375,40,56800
"Panama town, Oklahoma",515,497,18,1278,40,56900
"Panola CDP, Oklahoma",11,11,0,101,40,56950
"Paoli town, Oklahoma",252,250,2,662,40,57100
"Paradise Hill town, Oklahoma",15,15,0,83,40,57150
"Park Hill CDP, Oklahoma",1643,1583,60,3587,40,57300
"Pauls Valley city, Oklahoma",2619,2537,82,6031,40,57550
"Pawhuska city, Oklahoma",1421,1383,38,3009,40,57600
"Pawnee city, Oklahoma",779,739,40,1929,40,57650
"Peavine CDP, Oklahoma",140,137,3,318,40,57875
"Peckham CDP, Oklahoma",30,27,3,40,40,57900
"Peggs CDP, Oklahoma",386,379,7,875,40,57950
"Pensacola town, Oklahoma",49,46,3,110,40,58050
"Peoria town, Oklahoma",39,36,3,105,40,58100
"Perkins city, Oklahoma",1419,1264,155,3218,40,58150
"Perry city, Oklahoma",2051,1996,55,4526,40,58250
"Pershing CDP, Oklahoma",0,0,0,0,40,58300
"Pettit CDP, Oklahoma",428,428,0,739,40,58400
"Phillips town, Oklahoma",42,41,1,95,40,58500
"Pickett CDP, Oklahoma",469,459,10,988,40,58650
"Piedmont city, Oklahoma",4173,4111,62,7629,40,58700
"Piney CDP, Oklahoma",0,0,0,23,40,59100
"Pinhook Corner CDP, Oklahoma",26,26,0,71,40,59125
"Pink town, Oklahoma",872,822,50,2119,40,59150
"Pin Oak Acres CDP, Oklahoma",298,284,14,557,40,59175
"Pittsburg town, Oklahoma",60,59,1,156,40,59350
"Platter CDP, Oklahoma",51,51,0,106,40,59500
"Pocasset town, Oklahoma",70,69,1,161,40,59700
"Pocola town, Oklahoma",1937,1885,52,4297,40,59750
"Ponca City city, Oklahoma",11384,10618,766,24441,40,59850
"Pond Creek city, Oklahoma",440,425,15,980,40,59950
"Pontotoc CDP, Oklahoma",8,8,0,83,40,60000
"Porter town, Oklahoma",249,226,23,581,40,60150
"Porum town, Oklahoma",184,165,19,729,40,60250
"Poteau city, Oklahoma",3765,3532,233,8852,40,60350
"Prague city, Oklahoma",807,779,28,1886,40,60500
"Preston CDP, Oklahoma",66,63,3,197,40,60650
"Proctor CDP, Oklahoma",45,45,0,192,40,60750
"Prue town, Oklahoma",158,153,5,409,40,60850
"Pryor Creek city, Oklahoma",4239,3893,346,9480,40,61000
"Pump Back CDP, Oklahoma",86,86,0,138,40,61020
"Pumpkin Hollow CDP, Oklahoma",52,52,0,99,40,61113
"Purcell city, Oklahoma",2840,2730,110,6632,40,61150
"Putnam town, Oklahoma",15,15,0,46,40,61250
"Quapaw town, Oklahoma",360,341,19,851,40,61400
"Quay CDP, Oklahoma",6,6,0,13,40,61450
"Quinlan CDP, Oklahoma",0,0,0,0,40,61500
"Quinton town, Oklahoma",317,282,35,886,40,61550
"Ralston town, Oklahoma",144,131,13,318,40,61650
"Ramona town, Oklahoma",295,283,12,697,40,61700
"Randlett town, Oklahoma",185,179,6,365,40,61850
"Ratliff City town, Oklahoma",71,70,1,101,40,61900
"Rattan town, Oklahoma",130,120,10,323,40,61950
"Ravia town, Oklahoma",200,182,18,488,40,62000
"Reagan CDP, Oklahoma",13,11,2,40,40,62100
"Redbird town, Oklahoma",56,53,3,104,40,62200
"Redbird Smith CDP, Oklahoma",319,287,32,637,40,62275
"Red Oak town, Oklahoma",183,164,19,574,40,62550
"Red Rock town, Oklahoma",108,90,18,216,40,62650
"Remy CDP, Oklahoma",227,227,0,696,40,62875
"Renfrow town, Oklahoma",4,2,2,51,40,62900
"Rentiesville town, Oklahoma",53,51,2,108,40,62950
"Reydon town, Oklahoma",76,74,2,181,40,63100
"Ringling town, Oklahoma",265,257,8,853,40,63350
"Ringwood town, Oklahoma",197,197,0,532,40,63450
"Ripley town, Oklahoma",113,106,7,290,40,63500
"River Bottom CDP, Oklahoma",92,88,4,242,40,63537
"Rock Island town, Oklahoma",280,262,18,772,40,63600
"Rocky town, Oklahoma",105,88,17,266,40,63700
"Rocky Ford CDP, Oklahoma",97,95,2,191,40,63715
"Rocky Mountain CDP, Oklahoma",241,232,9,598,40,63720
"Rocky Point CDP, Oklahoma",238,233,5,773,40,63730
"Roff town, Oklahoma",254,249,5,695,40,63750
"Roland town, Oklahoma",1643,1634,9,3409,40,63800
"Roosevelt town, Oklahoma",116,100,16,268,40,63900
"Rose CDP, Oklahoma",105,105,0,230,40,63950
"Rosedale town, Oklahoma",12,12,0,29,40,64000
"Rosston town, Oklahoma",8,8,0,31,40,64050
"Rush Springs town, Oklahoma",491,458,33,1265,40,64300
"Ryan town, Oklahoma",260,241,19,824,40,64600
"St. Louis town, Oklahoma",44,39,5,85,40,64850
"Salina town, Oklahoma",464,418,46,1266,40,64950
"Sallisaw city, Oklahoma",3275,3066,209,8524,40,65000
"Sams Corner CDP, Oklahoma",47,47,0,145,40,65062
"Sand Hill CDP, Oklahoma",122,119,3,321,40,65240
"Sand Point CDP, Oklahoma",157,139,18,239,40,65250
"Sand Springs city, Oklahoma",9566,9134,432,19925,40,65300
"Sapulpa city, Oklahoma",10342,10005,337,22030,40,65400
"Sasakwa town, Oklahoma",23,20,3,64,40,65500
"Savanna town, Oklahoma",242,233,9,533,40,65600
"Sawyer town, Oklahoma",147,140,7,421,40,65650
"Sayre city, Oklahoma",974,854,120,5459,40,65700
"Schulter town, Oklahoma",184,179,5,510,40,65900
"Scipio CDP, Oklahoma",31,31,0,38,40,65950
"Seiling city, Oklahoma",295,295,0,806,40,66250
"Selman CDP, Oklahoma",0,0,0,0,40,66300
"Seminole city, Oklahoma",2930,2721,209,7144,40,66350
"Sentinel town, Oklahoma",547,533,14,973,40,66400
"Sequoyah CDP, Oklahoma",369,352,17,653,40,66450
"Seward CDP, Oklahoma",0,0,0,0,40,66500
"Shady Grove CDP (Cherokee County), Oklahoma",215,209,6,521,40,66510
"Shady Grove CDP (McIntosh County), Oklahoma",153,153,0,385,40,66520
"Shady Point town, Oklahoma",461,421,40,1075,40,66550
"Shamrock town, Oklahoma",0,0,0,41,40,66600
"Sharon town, Oklahoma",87,87,0,138,40,66650
"Shattuck town, Oklahoma",558,517,41,1262,40,66750
"Shawnee city, Oklahoma",13811,12867,944,31391,40,66800
"Shidler city, Oklahoma",192,189,3,394,40,67200
"Short CDP, Oklahoma",76,76,0,241,40,67400
"Silo town, Oklahoma",180,163,17,468,40,67550
"Simms CDP, Oklahoma",122,118,4,508,40,67625
"Skedee town, Oklahoma",16,14,2,49,40,67800
"Skiatook city, Oklahoma",4146,3940,206,8463,40,67850
"Slaughterville town, Oklahoma",1811,1720,91,4187,40,67950
"Slick town, Oklahoma",57,57,0,174,40,68000
"Smith Village town, Oklahoma",33,33,0,60,40,68200
"Smithville town, Oklahoma",52,52,0,97,40,68250
"Snake Creek CDP, Oklahoma",147,147,0,295,40,68275
"Snyder city, Oklahoma",505,489,16,1322,40,68400
"Soper town, Oklahoma",97,90,7,245,40,68500
"Sour John CDP, Oklahoma",10,10,0,92,40,68537
"South Coffeyville town, Oklahoma",328,316,12,691,40,68600
"Sparks town, Oklahoma",59,55,4,124,40,68950
"Sparrowhawk CDP, Oklahoma",118,118,0,176,40,68951
"Spaulding town, Oklahoma",51,51,0,116,40,69000
"Spavinaw town, Oklahoma",140,129,11,423,40,69050
"Spencer city, Oklahoma",2009,1871,138,3969,40,69200
"Sperry town, Oklahoma",445,421,24,1088,40,69300
"Spiro town, Oklahoma",795,712,83,2095,40,69350
"Sportmans Shores CDP, Oklahoma",61,48,13,158,40,69392
"Sportsmen Acres town, Oklahoma",206,204,2,460,40,69400
"Springer town, Oklahoma",292,287,5,756,40,69500
"Steely Hollow CDP, Oklahoma",85,82,3,258,40,70037
"Sterling town, Oklahoma",278,273,5,737,40,70150
"Stidham town, Oklahoma",11,11,0,23,40,70200
"Stigler city, Oklahoma",1138,995,143,2687,40,70250
"Stillwater city, Oklahoma",23717,22458,1259,48644,40,70300
"Stilwell city, Oklahoma",1437,1327,110,3732,40,70350
"Stonewall town, Oklahoma",215,211,4,428,40,70500
"Stoney Point CDP, Oklahoma",76,69,7,209,40,70512
"Strang town, Oklahoma",27,27,0,64,40,70750
"Stratford town, Oklahoma",495,470,25,1352,40,70800
"Stringtown town, Oklahoma",188,178,10,438,40,70850
"Strong City town, Oklahoma",21,21,0,46,40,70950
"Stroud city, Oklahoma",1260,1155,105,2748,40,71000
"Stuart town, Oklahoma",79,78,1,171,40,71050
"Sugden town, Oklahoma",16,16,0,43,40,71250
"Sulphur city, Oklahoma",1899,1899,0,5025,40,71350
"Summit town, Oklahoma",16,15,1,83,40,71450
"Sumner CDP, Oklahoma",12,12,0,12,40,71500
"Sunray CDP, Oklahoma",378,374,4,758,40,71650
"Sweetwater town, Oklahoma",66,66,0,143,40,71900
"Swink CDP, Oklahoma",23,19,4,47,40,71950
"Sycamore CDP, Oklahoma",39,39,0,68,40,71965
"Taft town, Oklahoma",39,39,0,97,40,72050
"Tagg Flats CDP, Oklahoma",0,0,0,0,40,72075
"Tahlequah city, Oklahoma",8095,7524,571,16389,40,72100
"Talala town, Oklahoma",146,134,12,283,40,72200
"Talihina town, Oklahoma",345,327,18,870,40,72250
"Taloga town, Oklahoma",127,126,1,303,40,72350
"Tamaha town, Oklahoma",42,40,2,196,40,72400
"Tatums town, Oklahoma",44,41,3,152,40,72500
"Taylor Ferry CDP, Oklahoma",391,372,19,811,40,72610
"Tecumseh city, Oklahoma",2790,2673,117,6326,40,72650
"Temple town, Oklahoma",328,328,0,842,40,72750
"Tenkiller CDP, Oklahoma",107,107,0,313,40,72775
"Teresita CDP, Oklahoma",64,52,12,183,40,72800
"Terlton town, Oklahoma",18,18,0,46,40,72850
"Terral town, Oklahoma",141,127,14,326,40,72900
"Texanna CDP, Oklahoma",766,740,26,2293,40,72950
"Texhoma town, Oklahoma",460,450,10,929,40,73100
"Texola town, Oklahoma",1,1,0,11,40,73150
"Thackerville town, Oklahoma",264,201,63,493,40,73200
"The Village city, Oklahoma",5959,5835,124,9479,40,73250
"Thomas city, Oklahoma",613,584,29,1298,40,73450
"Tiawah CDP, Oklahoma",92,92,0,159,40,73600
"Tipton town, Oklahoma",302,270,32,729,40,73850
"Tishomingo city, Oklahoma",993,913,80,3110,40,73900
"Titanic CDP, Oklahoma",147,120,27,386,40,73950
"Tonkawa city, Oklahoma",1340,1248,92,3027,40,74150
"Tonkawa Tribal Housing CDP, Oklahoma",105,94,11,344,40,74159
"Toppers CDP, Oklahoma",400,389,11,1156,40,74180
"Tribbey town, Oklahoma",148,129,19,352,40,74400
"Tryon town, Oklahoma",238,238,0,529,40,74550
"Tullahassee town, Oklahoma",88,88,0,121,40,74650
"Tulsa city, Oklahoma",208988,196785,12203,411938,40,75000
"Tupelo city, Oklahoma",133,117,16,388,40,75050
"Turley CDP, Oklahoma",1305,1160,145,2917,40,75150
"Turpin CDP, Oklahoma",137,137,0,377,40,75200
"Tushka town, Oklahoma",181,171,10,425,40,75250
"Tuskahoma CDP, Oklahoma",14,14,0,64,40,75300
"Tuttle city, Oklahoma",3869,3698,171,7533,40,75450
"Twin Lakes CDP, Oklahoma",0,0,0,41,40,75575
"Twin Oaks CDP, Oklahoma",142,140,2,319,40,75600
"Tyrone town, Oklahoma",240,240,0,1082,40,75750
"Union City town, Oklahoma",545,534,11,1326,40,75950
"Utica CDP, Oklahoma",30,30,0,42,40,76350
"Valley Brook town, Oklahoma",380,347,33,806,40,76500
"Valley Park town, Oklahoma",9,9,0,14,40,76600
"Valliant town, Oklahoma",274,241,33,720,40,76650
"Vanoss CDP, Oklahoma",30,30,0,54,40,76850
"Velma town, Oklahoma",248,244,4,558,40,76900
"Vera town, Oklahoma",242,236,6,480,40,76950
"Verden town, Oklahoma",144,144,0,500,40,77000
"Verdigris town, Oklahoma",2801,2738,63,5308,40,77050
"Vian town, Oklahoma",530,469,61,1371,40,77250
"Vici town, Oklahoma",274,274,0,700,40,77300
"Vinita city, Oklahoma",2115,1972,143,5207,40,77550
"Wagoner city, Oklahoma",3819,3497,322,7813,40,77850
"Wainwright town, Oklahoma",43,39,4,118,40,77900
"Wakita town, Oklahoma",106,102,4,340,40,77950
"Walters city, Oklahoma",997,974,23,2281,40,78150
"Wanette town, Oklahoma",91,90,1,244,40,78200
"Wann town, Oklahoma",54,47,7,125,40,78250
"Wapanucka town, Oklahoma",138,125,13,450,40,78300
"Wardville CDP, Oklahoma",5,5,0,48,40,78350
"Warner town, Oklahoma",701,632,69,1574,40,78400
"Warr Acres city, Oklahoma",4847,4680,167,10424,40,78500
"Warwick town, Oklahoma",73,69,4,197,40,78650
"Washington town, Oklahoma",313,304,9,659,40,78700
"Washita CDP, Oklahoma",45,45,0,81,40,78750
"Watonga city, Oklahoma",840,720,120,2651,40,78950
"Watova CDP, Oklahoma",26,26,0,31,40,79000
"Watts town, Oklahoma",76,76,0,257,40,79100
"Wauhillau CDP, Oklahoma",121,117,4,410,40,79150
"Waukomis town, Oklahoma",519,503,16,1087,40,79200
"Waurika city, Oklahoma",601,559,42,1824,40,79250
"Wayne town, Oklahoma",363,361,2,811,40,79300
"Waynoka city, Oklahoma",308,285,23,760,40,79350
"Weatherford city, Oklahoma",6672,6325,347,11999,40,79450
"Webb City town, Oklahoma",16,11,5,48,40,79600
"Webbers Falls town, Oklahoma",151,124,27,393,40,79650
"Welch town, Oklahoma",224,215,9,616,40,79750
"Weleetka town, Oklahoma",315,303,12,1070,40,79800
"Welling CDP, Oklahoma",236,236,0,702,40,79850
"Wellston town, Oklahoma",338,323,15,794,40,79900
"Welty CDP, Oklahoma",47,47,0,143,40,80000
"West Peavine CDP, Oklahoma",71,71,0,131,40,80230
"Westport town, Oklahoma",172,167,5,367,40,80250
"West Siloam Springs town, Oklahoma",507,473,34,1368,40,80350
"Westville town, Oklahoma",632,563,69,1672,40,80450
"Wetumka city, Oklahoma",501,473,28,1498,40,80500
"Wewoka city, Oklahoma",955,858,97,3124,40,80550
"Whippoorwill CDP, Oklahoma",16,13,3,47,40,80675
"White Eagle CDP, Oklahoma",199,180,19,440,40,80750
"Whitefield town, Oklahoma",195,175,20,468,40,80800
"Whitehorn Cove CDP, Oklahoma",560,544,16,1234,40,80813
"White Oak CDP, Oklahoma",72,71,1,221,40,80850
"Whitesboro CDP, Oklahoma",47,39,8,145,40,80900
"White Water CDP, Oklahoma",6,6,0,37,40,80912
"Wickliffe CDP, Oklahoma",406,389,17,829,40,80975
"Wilburton city, Oklahoma",1204,1085,119,2828,40,81000
"Willow town, Oklahoma",112,112,0,163,40,81300
"Wilson city, Oklahoma",673,648,25,1611,40,81500
"Winchester town, Oklahoma",217,204,13,524,40,81575
"Wister town, Oklahoma",298,291,7,954,40,81750
"Woodall CDP, Oklahoma",531,508,23,1186,40,81912
"Woodlawn Park town, Oklahoma",53,53,0,147,40,82000
"Woodward city, Oklahoma",6164,5778,386,12067,40,82150
"Wright City town, Oklahoma",231,219,12,579,40,82200
"Wyandotte town, Oklahoma",213,194,19,506,40,82250
"Wynnewood city, Oklahoma",732,699,33,1767,40,82400
"Wynona town, Oklahoma",140,129,11,318,40,82450
"Yale city, Oklahoma",457,422,35,1179,40,82500
"Yeager town, Oklahoma",39,39,0,128,40,82650
"Yukon city, Oklahoma",12755,12250,505,24198,40,82950
"Zeb CDP, Oklahoma",254,214,40,553,40,83030
"Zena CDP, Oklahoma",52,40,12,174,40,83050
"Zion CDP, Oklahoma",15,15,0,36,40,83125
"Adair Village city, Oregon",628,597,31,1185,41,00275
"Adams city, Oregon",170,169,1,490,41,00350
"Adrian city, Oregon",93,93,0,198,41,00500
"Albany city, Oregon",27489,25659,1830,56348,41,01000
"Aloha CDP, Oregon",29922,28383,1539,53532,41,01650
"Alpine CDP, Oregon",126,106,20,244,41,01700
"Alsea CDP, Oregon",44,44,0,139,41,01800
"Altamont CDP, Oregon",7899,7172,727,20345,41,01850
"Amity city, Oregon",917,890,27,1764,41,02000
"Annex CDP, Oregon",171,169,2,333,41,02200
"Antelope city, Oregon",50,50,0,71,41,02250
"Arlington city, Oregon",310,289,21,658,41,02800
"Ashland city, Oregon",10862,10245,617,21401,41,03050
"Astoria city, Oregon",4942,4755,187,10184,41,03150
"Athena city, Oregon",677,606,71,1333,41,03200
"Aumsville city, Oregon",2195,2090,105,4219,41,03250
"Aurora city, Oregon",592,583,9,1055,41,03300
"Baker City city, Oregon",4274,4027,247,10110,41,03650
"Bandon city, Oregon",1066,917,149,3317,41,03800
"Banks city, Oregon",1216,1120,96,2047,41,03850
"Barlow city, Oregon",119,119,0,157,41,04000
"Barnesdale CDP, Oregon",62,62,0,185,41,04125
"Barview CDP, Oregon",772,693,79,1726,41,04400
"Bay City city, Oregon",984,949,35,2224,41,04800
"Bayshore CDP, Oregon",202,202,0,956,41,04850
"Bayside Gardens CDP, Oregon",475,475,0,980,41,04925
"Beatty CDP, Oregon",17,17,0,18,41,05150
"Beaver CDP, Oregon",78,78,0,206,41,05200
"Beavercreek CDP, Oregon",2309,2239,70,4532,41,05250
"Beaver Marsh CDP, Oregon",52,52,0,116,41,05300
"Beaverton city, Oregon",56549,54335,2214,97554,41,05350
"Bellfountain CDP, Oregon",10,10,0,43,41,05700
"Bend city, Oregon",55078,53007,2071,99442,41,05800
"Bethany CDP, Oregon",15895,14998,897,30983,41,05950
"Biggs Junction CDP, Oregon",0,0,0,0,41,06400
"Black Butte Ranch CDP, Oregon",4,4,0,126,41,06650
"Blodgett CDP, Oregon",0,0,0,0,41,06950
"Bly CDP, Oregon",12,0,12,126,41,07150
"Boardman city, Oregon",1803,1770,33,3830,41,07200
"Bonanza town, Oregon",336,325,11,545,41,07300
"Boring CDP, Oregon",974,902,72,1987,41,07550
"Brogan CDP, Oregon",6,6,0,16,41,08600
"Brookings city, Oregon",3464,3181,283,6719,41,08650
"Brooks CDP, Oregon",184,184,0,311,41,08750
"Brownsville city, Oregon",904,886,18,1832,41,09050
"Bull Mountain CDP, Oregon",5331,5217,114,9319,41,09535
"Bunker Hill CDP, Oregon",935,865,70,2103,41,09600
"Burns city, Oregon",1276,1192,84,2735,41,09800
"Butte Falls town, Oregon",180,164,16,401,41,10050
"Butteville CDP, Oregon",107,107,0,285,41,10100
"Camp Sherman CDP, Oregon",79,77,2,313,41,10550
"Canby city, Oregon",9165,8880,285,18127,41,10750
"Cannon Beach city, Oregon",717,705,12,1271,41,10850
"Canyon City town, Oregon",384,363,21,834,41,10950
"Canyonville city, Oregon",646,561,85,1949,41,11000
"Cape Meares CDP, Oregon",54,54,0,199,41,11050
"Carlton city, Oregon",1173,1112,61,2339,41,11150
"Cascade Locks city, Oregon",787,757,30,1418,41,11600
"Cascadia CDP, Oregon",35,35,0,115,41,11700
"Cave Junction city, Oregon",638,572,66,1910,41,11850
"Cayuse CDP, Oregon",19,19,0,58,41,11900
"Cedar Hills CDP, Oregon",5201,4967,234,9076,41,12050
"Cedar Mill CDP, Oregon",9781,9119,662,19151,41,12150
"Central Point city, Oregon",10478,10048,430,19123,41,12400
"Chemult CDP, Oregon",43,43,0,96,41,12750
"Chenoweth CDP, Oregon",862,751,111,1717,41,12800
"Cherry Grove CDP, Oregon",183,181,2,489,41,12850
"Cheshire CDP, Oregon",112,112,0,266,41,13000
"Chiloquin city, Oregon",337,252,85,696,41,13050
"Clatskanie city, Oregon",801,728,73,1975,41,13750
"Cloverdale CDP, Oregon",84,84,0,168,41,14200
"Coburg city, Oregon",668,585,83,1539,41,14400
"Columbia City city, Oregon",809,786,23,1773,41,14750
"Condon city, Oregon",223,195,28,697,41,15000
"Coos Bay city, Oregon",7611,7245,366,15949,41,15250
"Coquille city, Oregon",1374,1292,82,4009,41,15350
"Cornelius city, Oregon",7085,6776,309,13245,41,15550
"Corvallis city, Oregon",32304,29720,2584,60050,41,15800
"Cottage Grove city, Oregon",5300,4978,322,10583,41,15950
"Cove city, Oregon",257,251,6,676,41,16250
"Crabtree CDP, Oregon",210,210,0,496,41,16350
"Crane CDP, Oregon",90,90,0,160,41,16450
"Crawfordsville CDP, Oregon",199,199,0,525,41,16650
"Crescent CDP, Oregon",147,147,0,278,41,16750
"Crescent Lake CDP, Oregon",0,0,0,14,41,16800
"Creswell city, Oregon",3008,2978,30,5607,41,16950
"Crooked River Ranch CDP, Oregon",2021,1845,176,4464,41,16975
"Culver city, Oregon",1303,1286,17,2173,41,17300
"Dallas city, Oregon",7519,7130,389,16945,41,17700
"Damascus CDP, Oregon",5433,5281,152,10555,41,17800
"Days Creek CDP, Oregon",61,61,0,163,41,18150
"Dayton city, Oregon",1195,1007,188,2677,41,18250
"Dayville town, Oregon",111,104,7,257,41,18300
"Deer Island CDP, Oregon",64,48,16,230,41,18450
"Depoe Bay city, Oregon",1044,907,137,2066,41,18850
"Deschutes River Woods CDP, Oregon",3256,3059,197,5595,41,19020
"Detroit city, Oregon",40,40,0,102,41,19100
"Dexter CDP, Oregon",501,501,0,1068,41,19250
"Dillard CDP, Oregon",129,101,28,316,41,19600
"Dilley CDP, Oregon",145,135,10,244,41,19650
"Donald city, Oregon",641,564,77,1151,41,20100
"Drain city, Oregon",505,477,28,1055,41,20500
"Dufur city, Oregon",361,349,12,857,41,20900
"Dundee city, Oregon",1716,1618,98,3224,41,21050
"Dunes City city, Oregon",408,402,6,1223,41,21150
"Dunthorpe CDP, Oregon",868,858,10,1767,41,21215
"Durham city, Oregon",998,966,32,1860,41,21250
"Eagle Crest CDP, Oregon",1128,1069,59,3074,41,21450
"Eagle Point city, Oregon",4709,4100,609,9735,41,21550
"Echo city, Oregon",245,225,20,478,41,22200
"Elgin city, Oregon",681,667,14,1603,41,22550
"Elkton city, Oregon",52,52,0,146,41,22800
"Elmira CDP, Oregon",181,160,21,408,41,23000
"Enterprise city, Oregon",1015,908,107,2172,41,23500
"Eola CDP, Oregon",0,0,0,0,41,23550
"Estacada city, Oregon",2113,1985,128,4619,41,23800
"Eugene city, Oregon",95442,88654,6788,176755,41,23850
"Fair Oaks CDP, Oregon",79,65,14,204,41,24100
"Fairview city, Oregon",5937,5683,254,10515,41,24250
"Fairview CDP, Oregon",248,219,29,495,41,24300
"Falcon Heights CDP, Oregon",452,452,0,818,41,24350
"Falls City city, Oregon",606,521,85,1321,41,24550
"Florence city, Oregon",3386,3162,224,9384,41,26050
"Foots Creek CDP, Oregon",347,347,0,983,41,26165
"Forest Grove city, Oregon",13362,12782,580,26160,41,26200
"Fort Hill CDP, Oregon",0,0,0,65,41,26400
"Fort Klamath CDP, Oregon",32,32,0,104,41,26450
"Fossil city, Oregon",184,172,12,485,41,26650
"Four Corners CDP, Oregon",8735,8301,434,16163,41,26750
"Garden Home-Whitford CDP, Oregon",4150,3887,263,7086,41,27825
"Gardiner CDP, Oregon",85,85,0,278,41,27850
"Garibaldi city, Oregon",304,297,7,716,41,28000
"Gaston city, Oregon",299,296,3,617,41,28100
"Gates city, Oregon",180,176,4,451,41,28200
"Gearhart city, Oregon",938,914,24,2060,41,28450
"Gervais city, Oregon",1499,1396,103,2605,41,28650
"Gilchrist CDP, Oregon",97,73,24,309,41,28800
"Gladstone city, Oregon",6686,6292,394,11996,41,29000
"Glasgow CDP, Oregon",308,308,0,920,41,29100
"Glendale city, Oregon",391,343,48,827,41,29350
"Glide CDP, Oregon",640,592,48,1523,41,29750
"Gold Beach city, Oregon",1130,1021,109,2533,41,29900
"Gold Hill city, Oregon",522,505,17,1261,41,29950
"Gopher Flats CDP, Oregon",143,143,0,384,41,30165
"Government Camp CDP, Oregon",49,47,2,101,41,30250
"Grand Ronde CDP, Oregon",322,298,24,1410,41,30300
"Granite city, Oregon",2,2,0,9,41,30500
"Grants Pass city, Oregon",17817,16700,1117,39131,41,30550
"Grass Valley city, Oregon",121,120,1,278,41,30650
"Green CDP, Oregon",4030,3877,153,8151,41,30750
"Greenhorn city, Oregon",0,0,0,0,41,31050
"Green Meadows CDP, Oregon",302,302,0,560,41,31115
"Gresham city, Oregon",59455,56015,3440,113525,41,31250
"Haines city, Oregon",100,84,16,220,41,31600
"Halfway city, Oregon",135,126,9,415,41,31650
"Halsey city, Oregon",804,761,43,1419,41,31750
"Happy Valley city, Oregon",12485,12009,476,24381,41,32050
"Harbor CDP, Oregon",525,495,30,2003,41,32100
"Harper CDP, Oregon",70,70,0,184,41,32400
"Harrisburg city, Oregon",1642,1552,90,3663,41,32550
"Hayesville CDP, Oregon",10299,9700,599,21822,41,32850
"Hebo CDP, Oregon",64,64,0,241,41,33100
"Heceta Beach CDP, Oregon",651,540,111,2122,41,33150
"Helix city, Oregon",198,195,3,358,41,33250
"Heppner city, Oregon",532,519,13,1318,41,33550
"Hermiston city, Oregon",10027,9283,744,19267,41,33700
"Hillsboro city, Oregon",60961,58183,2778,106612,41,34100
"Hines city, Oregon",684,638,46,1608,41,34250
"Holley CDP, Oregon",138,109,29,294,41,34650
"Hood River city, Oregon",4631,4497,134,8292,41,34900
"Hubbard city, Oregon",1926,1877,49,3427,41,35450
"Huntington city, Oregon",230,214,16,682,41,35700
"Idanha city, Oregon",59,55,4,141,41,35800
"Idaville CDP, Oregon",64,39,25,167,41,35850
"Imbler city, Oregon",209,203,6,336,41,36050
"Independence city, Oregon",5574,5329,245,9981,41,36150
"Ione city, Oregon",149,149,0,397,41,36400
"Irrigon city, Oregon",896,833,63,1869,41,36500
"Island City city, Oregon",495,481,14,1054,41,36750
"Jacksonville city, Oregon",1484,1354,130,3008,41,37000
"Jasper CDP, Oregon",291,238,53,574,41,37150
"Jeffers Gardens CDP, Oregon",53,25,28,117,41,37202
"Jefferson city, Oregon",1616,1460,156,3324,41,37250
"Jennings Lodge CDP, Oregon",4083,3847,236,7662,41,37400
"John Day city, Oregon",766,703,63,1561,41,37550
"Johnson City city, Oregon",232,232,0,430,41,37650
"Jordan Valley city, Oregon",81,77,4,164,41,37850
"Joseph city, Oregon",436,413,23,1048,41,37900
"Junction City city, Oregon",3761,3536,225,6831,41,38000
"Juniper Canyon CDP, Oregon",1109,1109,0,2849,41,38075
"Juntura CDP, Oregon",8,8,0,21,41,38150
"Keizer city, Oregon",19430,18534,896,39122,41,38500
"Keno CDP, Oregon",815,783,32,1881,41,38750
"Kerby CDP, Oregon",81,17,64,321,41,38900
"King City city, Oregon",1822,1749,73,5063,41,39150
"Kings Valley CDP, Oregon",117,117,0,147,41,39350
"Kirkpatrick CDP, Oregon",151,144,7,242,41,39566
"Klamath Falls city, Oregon",9525,8751,774,21806,41,39700
"Knappa CDP, Oregon",382,374,8,945,41,39850
"Labish Village CDP, Oregon",274,274,0,496,41,40050
"Lacomb CDP, Oregon",432,384,48,685,41,40150
"Lafayette city, Oregon",2428,2315,113,4391,41,40300
"La Grande city, Oregon",6149,5667,482,13097,41,40350
"Lake Oswego city, Oregon",19925,19002,923,40457,41,40550
"Lakeside city, Oregon",609,593,16,1838,41,40650
"Lakeview town, Oregon",1488,1377,111,2947,41,40700
"Langlois CDP, Oregon",37,37,0,300,41,40950
"La Pine city, Oregon",903,854,49,2483,41,41050
"Lebanon city, Oregon",8968,8314,654,18587,41,41650
"Lexington town, Oregon",53,51,2,140,41,42200
"Lincoln Beach CDP, Oregon",1265,1219,46,2779,41,42550
"Lincoln City city, Oregon",4364,4192,172,9790,41,42600
"Lonerock city, Oregon",7,7,0,18,41,43400
"Long Creek city, Oregon",47,44,3,190,41,43550
"Lookingglass CDP, Oregon",262,223,39,762,41,43650
"Lostine city, Oregon",169,148,21,381,41,43900
"Lowell city, Oregon",527,516,11,1211,41,44050
"Lyons city, Oregon",590,539,51,1175,41,44300
"McKay CDP, Oregon",65,65,0,89,41,44625
"McMinnville city, Oregon",15268,14703,565,34432,41,45000
"Madras city, Oregon",3364,3026,338,7494,41,45250
"Malin city, Oregon",345,323,22,881,41,45400
"Manzanita city, Oregon",171,150,21,538,41,45700
"Mapleton CDP, Oregon",141,139,2,449,41,45750
"Marcola CDP, Oregon",149,149,0,400,41,45850
"Marion CDP, Oregon",185,185,0,294,41,45900
"Marlene Village CDP, Oregon",3104,2820,284,5286,41,46100
"Maupin city, Oregon",128,128,0,356,41,46500
"Maywood Park city, Oregon",553,542,11,1043,41,46730
"Meacham CDP, Oregon",22,11,11,132,41,46800
"Medford city, Oregon",41817,39745,2072,85539,41,47000
"Mehama CDP, Oregon",297,287,10,534,41,47300
"Melrose CDP, Oregon",444,433,11,797,41,47350
"Merlin CDP, Oregon",893,796,97,1814,41,47650
"Merrill city, Oregon",360,323,37,905,41,47700
"Metolius city, Oregon",436,421,15,921,41,47750
"Metzger CDP, Oregon",1990,1828,162,3932,41,47800
"Mill City city, Oregon",786,708,78,1760,41,48150
"Millersburg city, Oregon",1495,1451,44,2964,41,48300
"Milton-Freewater city, Oregon",2938,2712,226,7137,41,48600
"Milwaukie city, Oregon",12602,11903,699,21195,41,48650
"Mission CDP, Oregon",371,296,75,1024,41,49000
"Mitchell city, Oregon",82,72,10,202,41,49150
"Molalla city, Oregon",5740,5339,401,10147,41,49450
"Monmouth city, Oregon",5496,5228,268,11054,41,49550
"Monroe city, Oregon",423,389,34,853,41,49600
"Monument city, Oregon",66,61,5,154,41,49750
"Moro city, Oregon",157,153,4,365,41,50000
"Mosier city, Oregon",340,340,0,630,41,50050
"Mount Angel city, Oregon",1417,1258,159,3413,41,50150
"Mount Hood CDP, Oregon",118,118,0,360,41,50200
"Mount Hood Villages CDP, Oregon",2477,2361,116,4663,41,50236
"Mount Vernon city, Oregon",345,300,45,595,41,50250
"Mulino CDP, Oregon",1115,986,129,2203,41,50450
"Myrtle Creek city, Oregon",1627,1486,141,3488,41,50950
"Myrtle Point city, Oregon",963,864,99,2689,41,51050
"Neahkahnie CDP, Oregon",107,107,0,302,41,51450
"Nehalem city, Oregon",152,128,24,269,41,51700
"Neotsu CDP, Oregon",214,214,0,547,41,51900
"Nesika Beach CDP, Oregon",83,80,3,355,41,51950
"Neskowin CDP, Oregon",121,87,34,177,41,52000
"Netarts CDP, Oregon",242,242,0,622,41,52050
"Newberg city, Oregon",13881,13426,455,25379,41,52100
"New Hope CDP, Oregon",417,368,49,1399,41,52275
"New Pine Creek CDP, Oregon",70,70,0,242,41,52400
"Newport city, Oregon",4509,4201,308,10319,41,52450
"North Bend city, Oregon",5251,4842,409,10250,41,53000
"North Plains city, Oregon",1873,1761,112,3365,41,53150
"North Powder city, Oregon",252,244,8,658,41,53300
"Nyssa city, Oregon",1329,1230,99,3202,41,53750
"Oak Grove CDP, Oregon",9103,8377,726,17535,41,53900
"Oak Hills CDP, Oregon",6105,5908,197,11780,41,53988
"Oakland city, Oregon",548,465,83,1288,41,54000
"Oakridge city, Oregon",978,748,230,3208,41,54100
"Oatfield CDP, Oregon",6520,6228,292,13073,41,54325
"O'Brien CDP, Oregon",193,156,37,619,41,54350
"Oceanside CDP, Oregon",158,158,0,472,41,54450
"Ochoco West CDP, Oregon",99,99,0,234,41,54527
"Odell CDP, Oregon",1584,1508,76,3003,41,54550
"Ontario city, Oregon",4985,4636,349,11610,41,54900
"Oregon City city, Oregon",19915,18921,994,37418,41,55200
"Oregon Shores CDP, Oregon",104,104,0,388,41,55268
"Orient CDP, Oregon",234,234,0,508,41,55500
"Pacific City CDP, Oregon",622,622,0,1767,41,56150
"Paisley city, Oregon",114,104,10,283,41,56250
"Parkdale CDP, Oregon",100,100,0,213,41,56500
"Pendleton city, Oregon",7391,6847,544,17005,41,57150
"Peoria CDP, Oregon",32,32,0,32,41,57300
"Philomath city, Oregon",3362,3235,127,5429,41,57450
"Phoenix city, Oregon",2084,1999,85,4389,41,57500
"Pilot Rock city, Oregon",575,556,19,1271,41,57650
"Pine Grove CDP, Oregon",14,14,0,92,41,57850
"Pine Hollow CDP, Oregon",158,158,0,481,41,57875
"Pistol River CDP, Oregon",0,0,0,0,41,58050
"Pleasant Valley CDP, Oregon",253,231,22,509,41,58500
"Plush CDP, Oregon",41,41,0,67,41,58550
"Portland city, Oregon",389536,367733,21803,646101,41,59000
"Port Orford city, Oregon",317,275,42,897,41,59250
"Powers city, Oregon",264,230,34,756,41,59600
"Prairie City city, Oregon",277,259,18,717,41,59650
"Prescott city, Oregon",14,14,0,60,41,59750
"Prineville city, Oregon",5413,5065,348,10915,41,59850
"Prineville Lake Acres CDP, Oregon",389,382,7,1266,41,59916
"Pronghorn CDP, Oregon",109,109,0,183,41,60070
"Prospect CDP, Oregon",184,180,4,661,41,60100
"Rainier city, Oregon",735,735,0,2010,41,60850
"Raleigh Hills CDP, Oregon",3740,3577,163,6737,41,60900
"Redmond city, Oregon",17884,16596,1288,34191,41,61200
"Redwood CDP, Oregon",1480,1344,136,3275,41,61250
"Reedsport city, Oregon",1535,1515,20,4307,41,61300
"Rhododendron CDP, Oregon",50,50,0,147,41,61550
"Richland city, Oregon",51,41,10,199,41,61700
"Rickreall CDP, Oregon",0,0,0,0,41,61800
"Riddle city, Oregon",570,523,47,1157,41,61850
"Rivergrove city, Oregon",266,241,25,558,41,62250
"River Point CDP, Oregon",82,73,9,234,41,62292
"River Road CDP, Oregon",4523,4205,318,8675,41,62300
"Riverside CDP, Oregon",193,193,0,352,41,62412
"Rockaway Beach city, Oregon",564,525,39,1393,41,62900
"Rockcreek CDP, Oregon",5765,5511,254,9923,41,63010
"Rocky Point CDP, Oregon",69,69,0,308,41,63250
"Rogue River city, Oregon",654,574,80,1997,41,63450
"Roseburg city, Oregon",9813,9324,489,23657,41,63650
"Roseburg North CDP, Oregon",1723,1583,140,4478,41,63660
"Rose Lodge CDP, Oregon",659,659,0,1491,41,63800
"Rowena CDP, Oregon",66,33,33,121,41,63950
"Ruch CDP, Oregon",664,648,16,1368,41,64150
"Rufus city, Oregon",82,77,5,220,41,64200
"Running Y Ranch CDP, Oregon",379,368,11,832,41,64282
"St. Helens city, Oregon",7196,6854,342,14015,41,64600
"St. Paul city, Oregon",217,216,1,401,41,64850
"Salem city, Oregon",85384,80168,5216,175754,41,64900
"Sandy city, Oregon",6775,6452,323,12592,41,65250
"San Marine CDP, Oregon",289,272,17,528,41,65300
"Santa Clara CDP, Oregon",5782,5503,279,11377,41,65400
"Saunders Lake CDP, Oregon",813,813,0,1766,41,65450
"Scappoose city, Oregon",3979,3881,98,8003,41,65500
"Scio city, Oregon",409,381,28,860,41,65650
"Scotts Mills city, Oregon",178,178,0,422,41,65800
"Seaside city, Oregon",3521,3242,279,7142,41,65950
"Selma CDP, Oregon",348,333,15,892,41,66150
"Seneca city, Oregon",87,87,0,167,41,66200
"Seventh Mountain CDP, Oregon",205,205,0,511,41,66385
"Shady Cove city, Oregon",1132,1030,102,3084,41,66550
"Shaniko city, Oregon",6,6,0,18,41,66700
"Shedd CDP, Oregon",55,41,14,168,41,66900
"Sheridan city, Oregon",3100,2890,210,6237,41,67050
"Sherwood city, Oregon",10389,10092,297,20286,41,67100
"Siletz city, Oregon",569,539,30,1134,41,67500
"Silver Lake CDP, Oregon",134,134,0,253,41,67600
"Silverton city, Oregon",4863,4584,279,10439,41,67650
"Sisters city, Oregon",1322,1269,53,2992,41,67950
"Sodaville city, Oregon",150,142,8,364,41,68550
"South Lebanon CDP, Oregon",521,521,0,1084,41,68875
"Sportsmans Park CDP, Oregon",13,13,0,67,41,69387
"Sprague River CDP, Oregon",0,0,0,0,41,69400
"Spray town, Oregon",59,53,6,199,41,69450
"Springfield city, Oregon",33014,30994,2020,61740,41,69600
"Stafford CDP, Oregon",566,566,0,1567,41,69800
"Stanfield city, Oregon",1083,1010,73,2128,41,69900
"Stayton city, Oregon",3903,3715,188,8210,41,70200
"Sublimity city, Oregon",1044,1018,26,2945,41,70700
"Summerville town, Oregon",75,59,16,130,41,70850
"Summit CDP, Oregon",107,99,8,177,41,70870
"Sumpter city, Oregon",15,11,4,206,41,71000
"Sunriver CDP, Oregon",481,481,0,1516,41,71250
"Sutherlin city, Oregon",3886,3663,223,8513,41,71650
"Svensen CDP, Oregon",403,393,10,812,41,71800
"Sweet Home city, Oregon",4002,3688,314,9852,41,71950
"Takilma CDP, Oregon",259,244,15,633,41,72400
"Talent city, Oregon",3165,3080,85,6256,41,72500
"Tangent city, Oregon",691,651,40,1299,41,72600
"Terrebonne CDP, Oregon",677,499,178,1298,41,72800
"Tetherow CDP, Oregon",290,275,15,716,41,72820
"The Dalles city, Oregon",7710,7165,545,15988,41,72950
"Three Rivers CDP, Oregon",1992,1829,163,3762,41,73225
"Tigard city, Oregon",30942,29378,1564,55161,41,73650
"Tillamook city, Oregon",2291,2177,114,5215,41,73700
"Toledo city, Oregon",1730,1474,256,3549,41,74000
"Trail CDP, Oregon",299,279,20,644,41,74400
"Trent CDP, Oregon",47,47,0,325,41,74550
"Tri-City CDP, Oregon",1393,1202,191,3810,41,74650
"Troutdale city, Oregon",8751,8369,382,16150,41,74850
"Tualatin city, Oregon",15484,14745,739,27804,41,74950
"Tumalo CDP, Oregon",345,345,0,687,41,75050
"Turner city, Oregon",1527,1435,92,2792,41,75150
"Tutuilla CDP, Oregon",204,197,7,395,41,75185
"Tygh Valley CDP, Oregon",11,11,0,54,41,75500
"Ukiah city, Oregon",113,92,21,265,41,75550
"Umapine CDP, Oregon",206,206,0,596,41,75600
"Umatilla city, Oregon",2435,2201,234,7433,41,75650
"Union city, Oregon",1076,1049,27,2209,41,75850
"Unity city, Oregon",9,9,0,37,41,76250
"Vale city, Oregon",784,704,80,2037,41,76600
"Veneta city, Oregon",2125,2022,103,5177,41,77050
"Vernonia city, Oregon",1291,1191,100,2285,41,77250
"Waldport city, Oregon",802,663,139,1950,41,78000
"Wallowa city, Oregon",325,316,9,724,41,78150
"Wallowa Lake CDP, Oregon",83,83,0,96,41,78160
"Wamic CDP, Oregon",28,28,0,52,41,78300
"Warm Springs CDP, Oregon",1024,911,113,2453,41,78600
"Warren CDP, Oregon",614,594,20,1608,41,78800
"Warrenton city, Oregon",2790,2656,134,6254,41,78900
"Wasco city, Oregon",196,192,4,482,41,78950
"Waterloo town, Oregon",106,98,8,238,41,79050
"Wedderburn CDP, Oregon",33,33,0,213,41,79500
"Westfir city, Oregon",145,127,18,394,41,79950
"West Haven-Sylvan CDP, Oregon",5132,4934,198,8376,41,80025
"West Linn city, Oregon",12766,12168,598,27167,41,80150
"Weston city, Oregon",193,189,4,483,41,80350
"Westport CDP, Oregon",187,187,0,367,41,80400
"West Scio CDP, Oregon",17,17,0,35,41,80750
"West Slope CDP, Oregon",3779,3657,122,6663,41,80900
"Wheeler city, Oregon",169,157,12,429,41,81300
"White City CDP, Oregon",4862,4609,253,11123,41,81450
"Willamina city, Oregon",1137,1064,73,2287,41,82350
"Williams CDP, Oregon",531,531,0,1173,41,82450
"Wilsonville city, Oregon",13679,12881,798,25992,41,82800
"Wimer CDP, Oregon",175,147,28,488,41,82850
"Winchester Bay CDP, Oregon",68,34,34,237,41,83050
"Winston city, Oregon",2559,2486,73,5618,41,83400
"Woodburn city, Oregon",12110,11532,578,26222,41,83750
"Wood Village city, Oregon",2171,2120,51,4548,41,83950
"Yachats city, Oregon",314,278,36,772,41,84200
"Yamhill city, Oregon",588,576,12,1184,41,84250
"Yoncalla city, Oregon",434,376,58,1104,41,84600
"Aaronsburg CDP (Centre County), Pennsylvania",275,269,6,651,42,00100
"Aaronsburg CDP (Washington County), Pennsylvania",33,33,0,291,42,00104
"Abbottstown borough, Pennsylvania",467,450,17,850,42,00116
"Ackermanville CDP, Pennsylvania",136,136,0,280,42,00244
"Adamsburg borough, Pennsylvania",64,64,0,97,42,00332
"Adamstown borough, Pennsylvania",1307,1289,18,2460,42,00364
"Adamsville CDP, Pennsylvania",38,38,0,83,42,00372
"Addison borough, Pennsylvania",134,130,4,272,42,00396
"Akron borough, Pennsylvania",2198,2131,67,4135,42,00540
"Alba borough, Pennsylvania",76,76,0,148,42,00572
"Albion borough, Pennsylvania",584,559,25,1320,42,00628
"Albrightsville CDP, Pennsylvania",28,28,0,194,42,00652
"Alburtis borough, Pennsylvania",1477,1372,105,2569,42,00660
"Aldan borough, Pennsylvania",2499,2375,124,4226,42,00676
"Alexandria borough, Pennsylvania",190,177,13,369,42,00756
"Alfarata CDP, Pennsylvania",106,106,0,146,42,00764
"Aliquippa city, Pennsylvania",4352,3988,364,9198,42,00820
"Alleghenyville CDP, Pennsylvania",480,468,12,849,42,00924
"Allenport CDP, Pennsylvania",298,263,35,587,42,00980
"Allenport borough, Pennsylvania",205,196,9,466,42,00988
"Allensville CDP, Pennsylvania",170,164,6,392,42,01004
"Allentown city, Pennsylvania",63061,57253,5808,125292,42,02000
"Allenwood CDP, Pennsylvania",142,142,0,314,42,02016
"Allison CDP, Pennsylvania",133,133,0,344,42,02040
"Allison Park CDP, Pennsylvania",12844,12270,574,22701,42,02056
"Allport CDP, Pennsylvania",203,203,0,280,42,02072
"Almedia CDP, Pennsylvania",633,618,15,1225,42,02088
"Alsace Manor CDP, Pennsylvania",144,144,0,326,42,02128
"Altamont CDP, Pennsylvania",284,270,14,531,42,02144
"Altoona city, Pennsylvania",20812,19554,1258,43821,42,02184
"Alverda CDP, Pennsylvania",75,74,1,167,42,02216
"Ambler borough, Pennsylvania",3838,3645,193,6775,42,02264
"Ambridge borough, Pennsylvania",3874,3468,406,6937,42,02288
"Amity Gardens CDP, Pennsylvania",1977,1962,15,4204,42,02349
"Ancient Oaks CDP, Pennsylvania",3736,3656,80,7363,42,02416
"Annville CDP, Pennsylvania",2724,2579,145,4829,42,02608
"Apollo borough, Pennsylvania",657,604,53,1247,42,02720
"Applewold borough, Pennsylvania",157,152,5,320,42,02752
"Arcadia University CDP, Pennsylvania",299,291,8,672,42,02826
"Archbald borough, Pennsylvania",3922,3850,72,7316,42,02832
"Ardmore CDP, Pennsylvania",8072,7681,391,14075,42,02896
"Arendtsville borough, Pennsylvania",421,415,6,760,42,02928
"Aristes CDP, Pennsylvania",93,93,0,199,42,02968
"Arlington Heights CDP, Pennsylvania",2886,2797,89,6444,42,03008
"Armagh borough, Pennsylvania",47,45,2,88,42,03032
"Arnold city, Pennsylvania",2283,1966,317,4778,42,03088
"Arnold City CDP, Pennsylvania",139,120,19,407,42,03096
"Arnot CDP, Pennsylvania",249,237,12,476,42,03104
"Arona borough, Pennsylvania",183,177,6,255,42,03120
"Ashland borough, Pennsylvania",1212,1139,73,2493,42,03264
"Ashley borough, Pennsylvania",1105,1021,84,2612,42,03272
"Ashville borough, Pennsylvania",106,103,3,205,42,03296
"Aspers CDP, Pennsylvania",150,141,9,234,42,03312
"Aspinwall borough, Pennsylvania",1527,1481,46,2890,42,03320
"Atglen borough, Pennsylvania",643,634,9,1174,42,03384
"Athens borough, Pennsylvania",1616,1559,57,3270,42,03392
"Atkinson Mills CDP, Pennsylvania",75,71,4,126,42,03424
"Atlantic CDP, Pennsylvania",29,24,5,64,42,03440
"Atlas CDP, Pennsylvania",253,207,46,664,42,03464
"Atlasburg CDP, Pennsylvania",303,303,0,556,42,03472
"Atwood borough, Pennsylvania",78,72,6,179,42,03480
"Auburn borough, Pennsylvania",333,304,29,546,42,03488
"Audubon CDP, Pennsylvania",4292,4076,216,9141,42,03544
"Austin borough, Pennsylvania",252,228,24,622,42,03576
"Avalon borough, Pennsylvania",2719,2612,107,4739,42,03608
"Avella CDP, Pennsylvania",406,313,93,798,42,03616
"Avis borough, Pennsylvania",648,602,46,1371,42,03632
"Avoca borough, Pennsylvania",1438,1392,46,2527,42,03640
"Avon CDP, Pennsylvania",779,755,24,1401,42,03648
"Avondale borough, Pennsylvania",634,619,15,1275,42,03656
"Avonia CDP, Pennsylvania",837,822,15,1621,42,03676
"Avonmore borough, Pennsylvania",622,596,26,1079,42,03688
"Baden borough, Pennsylvania",2043,1992,51,3891,42,03736
"Baidland CDP, Pennsylvania",989,883,106,1742,42,03768
"Baileyville CDP, Pennsylvania",15,15,0,116,42,03792
"Bainbridge CDP, Pennsylvania",957,936,21,1397,42,03800
"Bairdford CDP, Pennsylvania",356,356,0,653,42,03816
"Bakerstown CDP, Pennsylvania",1483,1483,0,2859,42,03864
"Bala Cynwyd CDP, Pennsylvania",4295,4102,193,9020,42,03895
"Bald Eagle CDP, Pennsylvania",88,82,6,161,42,03904
"Baldwin borough, Pennsylvania",11656,11210,446,21266,42,03928
"Bally borough, Pennsylvania",641,631,10,1121,42,03984
"Bangor borough, Pennsylvania",2610,2465,145,5172,42,04032
"Barkeyville borough, Pennsylvania",132,124,8,252,42,04136
"Barrville CDP, Pennsylvania",26,26,0,58,42,04344
"Bath borough, Pennsylvania",1349,1270,79,2814,42,04432
"Baumstown CDP, Pennsylvania",118,118,0,168,42,04488
"Beallsville borough, Pennsylvania",238,221,17,442,42,04568
"Bear Creek Village borough, Pennsylvania",165,163,2,365,42,04599
"Bear Lake borough, Pennsylvania",107,92,15,194,42,04608
"Bear Rocks CDP, Pennsylvania",574,513,61,1057,42,04616
"Beaver borough, Pennsylvania",2274,2132,142,4407,42,04688
"Beaverdale CDP, Pennsylvania",271,267,4,650,42,04768
"Beaver Falls city, Pennsylvania",4237,3748,489,8934,42,04792
"Beaver Meadows borough, Pennsylvania",475,430,45,801,42,04816
"Beaver Springs CDP, Pennsylvania",308,308,0,730,42,04824
"Beavertown CDP, Pennsylvania",12,9,3,23,42,04832
"Beavertown borough, Pennsylvania",383,357,26,837,42,04848
"Bechtelsville borough, Pennsylvania",515,495,20,907,42,04896
"Bedford borough, Pennsylvania",1580,1553,27,2855,42,04944
"Beech Creek borough, Pennsylvania",353,333,20,692,42,04984
"Beech Mountain Lakes CDP, Pennsylvania",1096,1096,0,1940,42,05028
"Belfast CDP, Pennsylvania",686,662,24,1237,42,05152
"Bell Acres borough, Pennsylvania",856,834,22,1615,42,05216
"Bellefonte borough, Pennsylvania",3420,3381,39,6071,42,05256
"Belle Vernon borough, Pennsylvania",426,386,40,803,42,05288
"Belleville CDP, Pennsylvania",752,690,62,1820,42,05304
"Bellevue borough, Pennsylvania",5401,5202,199,8236,42,05312
"Bellwood borough, Pennsylvania",924,879,45,1681,42,05384
"Belmont CDP, Pennsylvania",1304,1273,31,2743,42,05400
"Ben Avon borough, Pennsylvania",1118,1077,41,1878,42,05504
"Ben Avon Heights borough, Pennsylvania",177,172,5,312,42,05520
"Bendersville borough, Pennsylvania",374,344,30,711,42,05536
"Benson borough, Pennsylvania",64,64,0,139,42,05648
"Bentleyville borough, Pennsylvania",957,911,46,2409,42,05672
"Benton borough, Pennsylvania",198,192,6,502,42,05680
"Berlin borough, Pennsylvania",833,782,51,2297,42,05776
"Bernville borough, Pennsylvania",458,447,11,837,42,05848
"Berrysburg borough, Pennsylvania",151,142,9,293,42,05856
"Berwick borough, Pennsylvania",5207,4999,208,10318,42,05888
"Berwyn CDP, Pennsylvania",1692,1606,86,3700,42,05904
"Bessemer borough, Pennsylvania",493,450,43,912,42,05936
"Bethany borough, Pennsylvania",108,99,9,235,42,05976
"Bethel CDP, Pennsylvania",135,135,0,313,42,06000
"Bethel Park municipality, Pennsylvania",18062,17374,688,33275,42,06064
"Bethlehem city, Pennsylvania",38434,36274,2160,76555,42,06088
"Beurys Lake CDP, Pennsylvania",30,28,2,85,42,06171
"Big Bass Lake CDP, Pennsylvania",746,720,26,1420,42,06236
"Big Beaver borough, Pennsylvania",882,794,88,1796,42,06240
"Bigler CDP, Pennsylvania",389,378,11,476,42,06280
"Biglerville borough, Pennsylvania",682,614,68,1213,42,06296
"Big Run borough, Pennsylvania",255,239,16,536,42,06344
"Birchwood Lakes CDP, Pennsylvania",728,620,108,1500,42,06490
"Bird-in-Hand CDP, Pennsylvania",395,374,21,724,42,06496
"Birdsboro borough, Pennsylvania",3059,2872,187,5106,42,06504
"Birmingham borough, Pennsylvania",32,31,1,63,42,06560
"Black Lick CDP, Pennsylvania",361,361,0,999,42,06744
"Blain borough, Pennsylvania",123,121,2,235,42,06824
"Blairsville borough, Pennsylvania",1510,1483,27,3215,42,06904
"Blakely borough, Pennsylvania",3274,3159,115,6646,42,06928
"Blanchard CDP, Pennsylvania",279,279,0,505,42,06960
"Blandburg CDP, Pennsylvania",140,130,10,315,42,06976
"Blandon CDP, Pennsylvania",4428,4358,70,7484,42,06984
"Blawnox borough, Pennsylvania",801,766,35,1532,42,07000
"Bloomfield borough, Pennsylvania",512,488,24,1183,42,07040
"Blooming Valley borough, Pennsylvania",222,219,3,374,42,07120
"Bloomsburg town, Pennsylvania",5639,5333,306,12836,42,07128
"Blossburg borough, Pennsylvania",970,926,44,1835,42,07160
"Blue Ball CDP, Pennsylvania",625,625,0,952,42,07208
"Blue Bell CDP, Pennsylvania",3232,3019,213,6428,42,07224
"Blue Knob CDP, Pennsylvania",8,8,0,38,42,07272
"Blue Ridge Summit CDP, Pennsylvania",503,502,1,1039,42,07312
"Boalsburg CDP, Pennsylvania",2339,2244,95,4298,42,07368
"Bobtown CDP, Pennsylvania",249,249,0,780,42,07384
"Boiling Springs CDP, Pennsylvania",1849,1792,57,3584,42,07472
"Bolivar borough, Pennsylvania",154,149,5,386,42,07480
"Bonneauville borough, Pennsylvania",1012,995,17,1857,42,07560
"Boothwyn CDP, Pennsylvania",3405,3275,130,5506,42,07616
"Boston CDP, Pennsylvania",105,105,0,281,42,07688
"Boswell borough, Pennsylvania",574,568,6,1411,42,07712
"Bowers CDP, Pennsylvania",103,94,9,259,42,07800
"Bowmanstown borough, Pennsylvania",701,588,113,1140,42,07880
"Bowmansville CDP, Pennsylvania",1981,1902,79,2965,42,07896
"Boyertown borough, Pennsylvania",2154,2063,91,4244,42,07960
"Brackenridge borough, Pennsylvania",1637,1613,24,3214,42,07976
"Braddock borough, Pennsylvania",752,531,221,1814,42,07992
"Braddock Hills borough, Pennsylvania",765,736,29,1625,42,08008
"Bradenville CDP, Pennsylvania",132,132,0,449,42,08024
"Bradford city, Pennsylvania",3407,3226,181,7847,42,08040
"Bradford Woods borough, Pennsylvania",577,575,2,1235,42,08064
"Branchdale CDP, Pennsylvania",99,99,0,306,42,08208
"Brandonville CDP, Pennsylvania",74,52,22,161,42,08240
"Brave CDP, Pennsylvania",64,60,4,177,42,08312
"Breinigsville CDP, Pennsylvania",4336,4127,209,9035,42,08392
"Brentwood borough, Pennsylvania",5358,5252,106,9982,42,08416
"Bressler CDP, Pennsylvania",1122,1112,10,2220,42,08432
"Briar Creek borough, Pennsylvania",372,246,126,938,42,08472
"Brickerville CDP, Pennsylvania",854,854,0,1407,42,08504
"Bridgeport borough, Pennsylvania",3042,2895,147,5000,42,08568
"Bridgeville borough, Pennsylvania",2698,2516,182,4777,42,08624
"Bridgewater borough, Pennsylvania",429,406,23,788,42,08632
"Brisbin borough, Pennsylvania",184,173,11,387,42,08744
"Bristol borough, Pennsylvania",5237,4933,304,9862,42,08760
"Brittany Farms-The Highlands CDP, Pennsylvania",2600,2448,152,4286,42,08819
"Broad Top City borough, Pennsylvania",238,236,2,462,42,08896
"Brockway borough, Pennsylvania",1035,993,42,2192,42,08960
"Brodheadsville CDP, Pennsylvania",818,796,22,1763,42,09000
"Brookhaven borough, Pennsylvania",4652,4484,168,8268,42,09080
"Brooks Mill CDP, Pennsylvania",83,83,0,97,42,09196
"Brookville borough, Pennsylvania",2039,1873,166,3974,42,09224
"Broomall CDP, Pennsylvania",5904,5737,167,10663,42,09248
"Brownstown borough, Pennsylvania",278,267,11,574,42,09400
"Brownstown CDP, Pennsylvania",2031,1895,136,3582,42,09416
"Brownsville borough, Pennsylvania",1086,1012,74,2422,42,09432
"Browntown CDP, Pennsylvania",788,763,25,1476,42,09496
"Bruin borough, Pennsylvania",189,183,6,387,42,09528
"Bryn Athyn borough, Pennsylvania",571,552,19,1115,42,09696
"Bryn Mawr CDP, Pennsylvania",3218,2979,239,5508,42,09728
"Buckhorn CDP, Pennsylvania",136,129,7,499,42,09792
"Buck Run CDP, Pennsylvania",76,67,9,206,42,09896
"Buffington CDP, Pennsylvania",51,0,51,119,42,10096
"Bulger CDP, Pennsylvania",186,148,38,314,42,10128
"Burgettstown borough, Pennsylvania",710,630,80,1314,42,10224
"Burlington borough, Pennsylvania",70,69,1,154,42,10240
"Burnham borough, Pennsylvania",907,892,15,1687,42,10256
"Burnside borough, Pennsylvania",88,64,24,163,42,10280
"Butler city, Pennsylvania",6462,5856,606,13387,42,10464
"Byrnedale CDP, Pennsylvania",265,257,8,404,42,10600
"Cairnbrook CDP, Pennsylvania",237,237,0,531,42,10720
"California borough, Pennsylvania",2822,2534,288,5328,42,10768
"Callensburg borough, Pennsylvania",69,67,2,163,42,10792
"Callery borough, Pennsylvania",347,281,66,531,42,10800
"Callimont borough, Pennsylvania",22,22,0,52,42,10808
"Caln CDP, Pennsylvania",725,674,51,1463,42,10816
"Calumet CDP, Pennsylvania",632,632,0,1101,42,10832
"Cambridge Springs borough, Pennsylvania",717,672,45,2297,42,10912
"Campbelltown CDP, Pennsylvania",2691,2620,71,5705,42,10960
"Camp Hill borough, Pennsylvania",4575,4454,121,8133,42,11000
"Canadohta Lake CDP, Pennsylvania",161,148,13,381,42,11072
"Canan Station CDP, Pennsylvania",10,10,0,30,42,11088
"Canoe Creek CDP, Pennsylvania",53,53,0,53,42,11136
"Canonsburg borough, Pennsylvania",5711,5345,366,9672,42,11152
"Canton borough, Pennsylvania",750,705,45,1791,42,11160
"Carbondale city, Pennsylvania",3844,3596,248,8818,42,11232
"Carlisle borough, Pennsylvania",10974,10529,445,20846,42,11272
"Carlisle Barracks CDP, Pennsylvania",136,136,0,583,42,11280
"Carmichaels borough, Pennsylvania",267,255,12,465,42,11328
"Carnegie borough, Pennsylvania",4982,4829,153,8067,42,11336
"Carnot-Moon CDP, Pennsylvania",7914,7448,466,13345,42,11348
"Carrolltown borough, Pennsylvania",415,401,14,822,42,11456
"Carroll Valley borough, Pennsylvania",2066,2032,34,3947,42,11472
"Carson Valley CDP, Pennsylvania",32,32,0,91,42,11492
"Casanova CDP, Pennsylvania",189,189,0,213,42,11544
"Cashtown CDP, Pennsylvania",127,127,0,283,42,11576
"Cassandra borough, Pennsylvania",64,58,6,120,42,11616
"Casselman borough, Pennsylvania",36,34,2,64,42,11624
"Cassville borough, Pennsylvania",76,64,12,140,42,11632
"Castanea CDP, Pennsylvania",666,649,17,1137,42,11648
"Castle Shannon borough, Pennsylvania",5056,4986,70,8283,42,11680
"Catasauqua borough, Pennsylvania",3951,3623,328,6512,42,11720
"Catawissa borough, Pennsylvania",826,781,45,1387,42,11736
"Cecil-Bishop CDP, Pennsylvania",1551,1509,42,2684,42,11804
"Cedar Crest CDP, Pennsylvania",27,27,0,72,42,11836
"Cementon CDP, Pennsylvania",832,827,5,1365,42,11976
"Centerport borough, Pennsylvania",204,193,11,341,42,12104
"Centerville borough (Crawford County), Pennsylvania",98,89,9,232,42,12184
"Centerville borough (Washington County), Pennsylvania",1769,1700,69,3244,42,12224
"Central City borough, Pennsylvania",417,398,19,1045,42,12296
"Centralia borough, Pennsylvania",0,0,0,0,42,12312
"Centre Hall borough, Pennsylvania",751,710,41,1472,42,12376
"Cetronia CDP, Pennsylvania",1126,1097,29,2377,42,12424
"Chadds Ford CDP, Pennsylvania",715,709,6,1300,42,12440
"Chalfant borough, Pennsylvania",408,405,3,649,42,12496
"Chalfont borough, Pennsylvania",2643,2445,198,4259,42,12504
"Chalkhill CDP, Pennsylvania",35,35,0,71,42,12512
"Chambersburg borough, Pennsylvania",11041,10513,528,21917,42,12536
"Chapman borough, Pennsylvania",73,70,3,166,42,12656
"Charleroi borough, Pennsylvania",1887,1782,105,4222,42,12704
"Charlottsville CDP, Pennsylvania",22,22,0,165,42,12768
"Chase CDP, Pennsylvania",571,563,8,926,42,12864
"Cheltenham Village CDP, Pennsylvania",1277,1202,75,1849,42,12973
"Cherry Tree borough, Pennsylvania",147,147,0,266,42,13120
"Cherry Valley borough, Pennsylvania",24,24,0,60,42,13152
"Cherryville CDP, Pennsylvania",788,730,58,1472,42,13168
"Chester city, Pennsylvania",15421,12969,2452,33048,42,13208
"Chesterbrook CDP, Pennsylvania",3134,3040,94,5428,42,13216
"Chester Heights borough, Pennsylvania",1517,1454,63,2897,42,13232
"Chester Hill borough, Pennsylvania",389,365,24,717,42,13240
"Chestnut Hill CDP, Pennsylvania",3613,3344,269,6493,42,13336
"Chest Springs borough, Pennsylvania",58,57,1,118,42,13384
"Cheswick borough, Pennsylvania",927,849,78,1638,42,13392
"Chevy Chase Heights CDP, Pennsylvania",851,726,125,1321,42,13400
"Chewton CDP, Pennsylvania",151,137,14,330,42,13408
"Cheyney University CDP, Pennsylvania",43,43,0,152,42,13418
"Chicora borough, Pennsylvania",429,426,3,968,42,13440
"Chinchilla CDP, Pennsylvania",1124,1037,87,2186,42,13480
"Christiana borough, Pennsylvania",431,423,8,956,42,13512
"Church Hill CDP, Pennsylvania",852,844,8,1634,42,13596
"Churchill borough, Pennsylvania",1671,1561,110,3127,42,13608
"Churchtown CDP, Pennsylvania",177,177,0,452,42,13632
"Churchville CDP, Pennsylvania",3161,3071,90,6041,42,13648
"Clairton city, Pennsylvania",2688,2402,286,6182,42,13704
"Clappertown CDP, Pennsylvania",25,25,0,83,42,13728
"Clarence CDP, Pennsylvania",427,410,17,851,42,13768
"Clarendon borough, Pennsylvania",220,199,21,382,42,13776
"Clarion borough, Pennsylvania",2353,2114,239,4205,42,13800
"Clark borough, Pennsylvania",242,231,11,577,42,13832
"Clarks Green borough, Pennsylvania",902,897,5,1594,42,13864
"Clarks Summit borough, Pennsylvania",2884,2827,57,5091,42,13880
"Clarksville borough, Pennsylvania",96,88,8,208,42,13896
"Clay CDP, Pennsylvania",707,707,0,1391,42,13952
"Claysburg CDP, Pennsylvania",525,518,7,1178,42,13992
"Claysville borough, Pennsylvania",306,286,20,677,42,14000
"Clearfield borough, Pennsylvania",3034,2786,248,5937,42,14064
"Cleona borough, Pennsylvania",1036,1003,33,1828,42,14160
"Clifton Heights borough, Pennsylvania",3251,2655,596,6834,42,14264
"Clinton CDP, Pennsylvania",860,738,122,1164,42,14296
"Clintondale CDP, Pennsylvania",91,91,0,129,42,14368
"Clintonville borough, Pennsylvania",233,206,27,498,42,14376
"Clymer borough, Pennsylvania",545,516,29,1109,42,14520
"Coal Center borough, Pennsylvania",88,85,3,160,42,14568
"Coaldale borough (Bedford County), Pennsylvania",20,14,6,85,42,14584
"Coaldale borough (Schuylkill County), Pennsylvania",1110,1024,86,2314,42,14600
"Coalmont borough, Pennsylvania",25,22,3,47,42,14640
"Coalport borough, Pennsylvania",229,222,7,443,42,14656
"Coatesville city, Pennsylvania",6724,6165,559,13316,42,14712
"Coburn CDP, Pennsylvania",47,39,8,123,42,14760
"Cochranton borough, Pennsylvania",419,406,13,1043,42,14800
"Cochranville CDP, Pennsylvania",245,238,7,488,42,14808
"Cokeburg borough, Pennsylvania",374,347,27,784,42,14896
"Collegeville borough, Pennsylvania",2956,2742,214,5172,42,15192
"Collingdale borough, Pennsylvania",4618,4219,399,8865,42,15232
"Collinsburg CDP, Pennsylvania",577,528,49,1065,42,15248
"Colonial Park CDP, Pennsylvania",8825,8358,467,16891,42,15328
"Colony Park CDP, Pennsylvania",418,418,0,1044,42,15368
"Columbia borough, Pennsylvania",5267,5045,222,10203,42,15384
"Columbus CDP, Pennsylvania",383,371,12,851,42,15400
"Colver CDP, Pennsylvania",283,283,0,544,42,15416
"Colwyn borough, Pennsylvania",1532,1178,354,2849,42,15432
"Commodore CDP, Pennsylvania",107,103,4,193,42,15464
"Conashaugh Lakes CDP, Pennsylvania",853,702,151,1550,42,15479
"Conestoga CDP, Pennsylvania",687,687,0,1228,42,15584
"Confluence borough, Pennsylvania",308,269,39,596,42,15680
"Conneaut Lake borough, Pennsylvania",248,244,4,510,42,15744
"Conneaut Lakeshore CDP, Pennsylvania",860,813,47,1933,42,15755
"Conneautville borough, Pennsylvania",372,295,77,745,42,15760
"Connellsville city, Pennsylvania",3448,3196,252,7004,42,15776
"Connoquenessing borough, Pennsylvania",270,264,6,647,42,15808
"Conshohocken borough, Pennsylvania",6737,6501,236,9182,42,15848
"Continental Courts CDP, Pennsylvania",464,446,18,734,42,15860
"Conway borough, Pennsylvania",1058,992,66,2105,42,15872
"Conyngham borough, Pennsylvania",905,905,0,1637,42,15888
"Coopersburg borough, Pennsylvania",1325,1287,38,2332,42,16056
"Cooperstown borough, Pennsylvania",171,148,23,373,42,16080
"Coplay borough, Pennsylvania",1855,1822,33,3390,42,16128
"Coral CDP, Pennsylvania",169,159,10,234,42,16136
"Coraopolis borough, Pennsylvania",2900,2756,144,5510,42,16144
"Cornwall borough, Pennsylvania",2034,2027,7,4578,42,16256
"Cornwells Heights CDP, Pennsylvania",824,774,50,1339,42,16272
"Corry city, Pennsylvania",2684,2401,283,6209,42,16296
"Corsica borough, Pennsylvania",189,180,9,413,42,16304
"Cotton Town CDP, Pennsylvania",0,0,0,28,42,16432
"Coudersport borough, Pennsylvania",1045,1034,11,2384,42,16448
"Courtdale borough, Pennsylvania",284,282,2,614,42,16568
"Cove Forge CDP, Pennsylvania",100,63,37,221,42,16590
"Crabtree CDP, Pennsylvania",75,75,0,189,42,16816
"Crafton borough, Pennsylvania",3664,3440,224,6044,42,16848
"Cranesville borough, Pennsylvania",356,356,0,800,42,16960
"Creekside borough, Pennsylvania",117,104,13,278,42,17024
"Crenshaw CDP, Pennsylvania",142,125,17,306,42,17040
"Cresson borough, Pennsylvania",855,817,38,1529,42,17136
"Cressona borough, Pennsylvania",775,739,36,1312,42,17152
"Cross Creek CDP, Pennsylvania",135,115,20,196,42,17320
"Cross Keys CDP, Pennsylvania",343,330,13,645,42,17368
"Cross Roads borough, Pennsylvania",264,263,1,504,42,17416
"Crown CDP, Pennsylvania",76,76,0,223,42,17440
"Croydon CDP, Pennsylvania",5302,5029,273,9752,42,17448
"Crucible CDP, Pennsylvania",189,189,0,323,42,17528
"Culp CDP, Pennsylvania",27,27,0,50,42,17624
"Cumbola CDP, Pennsylvania",101,100,1,244,42,17680
"Curryville CDP, Pennsylvania",20,20,0,38,42,17784
"Curtisville CDP, Pennsylvania",641,641,0,877,42,17832
"Curwensville borough, Pennsylvania",1205,1097,108,2559,42,17840
"Daisytown borough, Pennsylvania",139,137,2,268,42,17976
"Dale borough, Pennsylvania",410,390,20,1097,42,18000
"Dallas borough, Pennsylvania",1397,1337,60,2694,42,18048
"Dallastown borough, Pennsylvania",2225,2099,126,4164,42,18072
"Dalmatia CDP, Pennsylvania",153,149,4,373,42,18080
"Dalton borough, Pennsylvania",710,706,4,1283,42,18088
"Danville borough, Pennsylvania",1969,1921,48,4265,42,18136
"Darby borough, Pennsylvania",4539,3906,633,10682,42,18152
"Darlington borough, Pennsylvania",119,108,11,244,42,18192
"Dauberville CDP, Pennsylvania",304,255,49,631,42,18256
"Dauphin borough, Pennsylvania",550,531,19,1123,42,18272
"Davidsville CDP, Pennsylvania",317,317,0,887,42,18312
"Dawson borough, Pennsylvania",176,161,15,388,42,18360
"Dayton borough, Pennsylvania",234,194,40,584,42,18400
"Deemston borough, Pennsylvania",304,303,1,643,42,18496
"Deer Lake CDP, Pennsylvania",201,201,0,376,42,18568
"Deer Lake borough, Pennsylvania",440,420,20,795,42,18576
"Defiance CDP, Pennsylvania",126,106,20,396,42,18608
"Delano CDP, Pennsylvania",123,110,13,214,42,18664
"Delaware Water Gap borough, Pennsylvania",373,350,23,652,42,18736
"Delmont borough, Pennsylvania",1679,1523,156,2621,42,18768
"Delta borough, Pennsylvania",342,327,15,647,42,18800
"Denver borough, Pennsylvania",2046,1957,89,3789,42,18888
"Derry borough, Pennsylvania",1289,1170,119,2636,42,18960
"DeSales University CDP, Pennsylvania",436,432,4,942,42,18998
"Devon CDP, Pennsylvania",1209,1168,41,1890,42,19040
"Dewart CDP, Pennsylvania",654,612,42,1285,42,19048
"Dickson City borough, Pennsylvania",2948,2708,240,6026,42,19160
"Dillsburg borough, Pennsylvania",1559,1491,68,2629,42,19208
"Dilworthtown CDP, Pennsylvania",474,465,9,969,42,19232
"Dixonville CDP, Pennsylvania",185,185,0,744,42,19344
"Donaldson CDP, Pennsylvania",185,176,9,352,42,19432
"Donegal borough, Pennsylvania",30,30,0,111,42,19472
"Donora borough, Pennsylvania",2199,1920,279,4561,42,19536
"Dormont borough, Pennsylvania",5581,5285,296,8199,42,19576
"Dorneyville CDP, Pennsylvania",2581,2417,164,5093,42,19584
"Douglassville CDP, Pennsylvania",130,130,0,431,42,19680
"Dover borough, Pennsylvania",1183,1103,80,2054,42,19696
"Downingtown borough, Pennsylvania",5146,4936,210,8088,42,19752
"Doylestown borough, Pennsylvania",4547,4420,127,8305,42,19784
"Dravosburg borough, Pennsylvania",860,801,59,1614,42,19856
"Drexel Hill CDP, Pennsylvania",17659,16126,1533,29231,42,19920
"Driftwood borough, Pennsylvania",6,6,0,35,42,19976
"Dry Tavern CDP, Pennsylvania",325,283,42,627,42,20080
"Dryville CDP, Pennsylvania",116,116,0,185,42,20096
"Dublin borough, Pennsylvania",1289,1215,74,2206,42,20104
"DuBois city, Pennsylvania",4079,3889,190,7509,42,20136
"Duboistown borough, Pennsylvania",730,705,25,1322,42,20144
"Dudley borough, Pennsylvania",84,75,9,187,42,20152
"Dumb Hundred CDP, Pennsylvania",67,67,0,88,42,20214
"Dunbar borough, Pennsylvania",517,486,31,966,42,20216
"Duncannon borough, Pennsylvania",799,754,45,1361,42,20240
"Duncansville borough, Pennsylvania",635,573,62,1164,42,20248
"Dunlevy borough, Pennsylvania",205,195,10,366,42,20328
"Dunlo CDP, Pennsylvania",310,310,0,517,42,20336
"Dunmore borough, Pennsylvania",7157,6816,341,14082,42,20352
"Dunnstown CDP, Pennsylvania",664,644,20,1213,42,20416
"Dupont borough, Pennsylvania",1535,1386,149,2544,42,20424
"Duquesne city, Pennsylvania",2464,2271,193,5241,42,20432
"Duryea borough, Pennsylvania",2647,2499,148,5047,42,20512
"Dushore borough, Pennsylvania",193,173,20,459,42,20528
"Eagle CDP, Pennsylvania",275,275,0,380,42,20600
"Eagle Creek CDP, Pennsylvania",49,49,0,128,42,20604
"Eagle Lake CDP, Pennsylvania",0,0,0,0,42,20634
"Eagles Mere borough, Pennsylvania",36,33,3,100,42,20648
"Eagleview CDP, Pennsylvania",1021,1009,12,2235,42,20662
"Eagleville CDP (Centre County), Pennsylvania",167,151,16,311,42,20664
"Eagleville CDP (Montgomery County), Pennsylvania",2071,1925,146,5162,42,20672
"Earlston CDP, Pennsylvania",593,575,18,971,42,20704
"East Altoona CDP, Pennsylvania",117,117,0,305,42,20752
"East Bangor borough, Pennsylvania",525,498,27,1088,42,20776
"East Berlin borough, Pennsylvania",905,832,73,1573,42,20792
"East Berwick CDP, Pennsylvania",1351,1342,9,2400,42,20800
"East Brady borough, Pennsylvania",508,482,26,1072,42,20840
"East Butler borough, Pennsylvania",531,510,21,906,42,20904
"East Conemaugh borough, Pennsylvania",353,328,25,906,42,20992
"East Earl CDP, Pennsylvania",683,651,32,1144,42,21064
"East Freedom CDP, Pennsylvania",426,426,0,591,42,21176
"East Greenville borough, Pennsylvania",1803,1736,67,3150,42,21200
"East Lansdowne borough, Pennsylvania",1688,1518,170,2703,42,21384
"Eastlawn Gardens CDP, Pennsylvania",2191,2155,36,3536,42,21400
"East McKeesport borough, Pennsylvania",1180,1100,80,2074,42,21444
"Easton city, Pennsylvania",14795,14142,653,28883,42,21648
"East Petersburg borough, Pennsylvania",2873,2809,64,4588,42,21688
"East Pittsburgh borough, Pennsylvania",765,724,41,1866,42,21712
"East Prospect borough, Pennsylvania",413,400,13,783,42,21728
"East Rochester borough, Pennsylvania",287,270,17,534,42,21752
"East Salem CDP, Pennsylvania",85,85,0,141,42,21792
"East Sharpsburg CDP, Pennsylvania",85,79,6,153,42,21808
"East Side borough, Pennsylvania",132,126,6,259,42,21816
"East Stroudsburg borough, Pennsylvania",4888,4491,397,9345,42,21872
"East Uniontown CDP, Pennsylvania",968,877,91,2243,42,21960
"Eastvale borough, Pennsylvania",87,77,10,177,42,21968
"East Vandergrift borough, Pennsylvania",399,385,14,701,42,21976
"East Washington borough, Pennsylvania",1033,1018,15,1706,42,22016
"East Waterford CDP, Pennsylvania",59,59,0,145,42,22024
"East York CDP, Pennsylvania",4484,4428,56,8853,42,22104
"Eau Claire borough, Pennsylvania",135,128,7,327,42,22128
"Ebensburg borough, Pennsylvania",1528,1472,56,3382,42,22144
"Economy borough, Pennsylvania",4858,4697,161,9063,42,22264
"Eddington CDP, Pennsylvania",1068,1010,58,1651,42,22280
"Eddystone borough, Pennsylvania",1112,1003,109,2170,42,22296
"Edenborn CDP, Pennsylvania",42,42,0,118,42,22344
"Edenburg CDP, Pennsylvania",450,450,0,731,42,22352
"Edgewood borough, Pennsylvania",2224,2138,86,3104,42,22520
"Edgewood CDP, Pennsylvania",1011,922,89,2225,42,22528
"Edgeworth borough, Pennsylvania",699,671,28,1520,42,22576
"Edie CDP, Pennsylvania",37,37,0,87,42,22600
"Edinboro borough, Pennsylvania",2226,2176,50,4958,42,22608
"Edwardsville borough, Pennsylvania",2503,2073,430,4925,42,22672
"Effort CDP, Pennsylvania",1048,1030,18,2235,42,22680
"Egypt CDP, Pennsylvania",1549,1521,28,2998,42,22696
"Ehrenfeld borough, Pennsylvania",84,76,8,184,42,22712
"Eighty Four CDP, Pennsylvania",269,269,0,653,42,22736
"Elberta CDP, Pennsylvania",195,190,5,306,42,22776
"Elco borough, Pennsylvania",113,105,8,272,42,22800
"Elderton borough, Pennsylvania",115,104,11,280,42,22832
"Eldorado CDP, Pennsylvania",187,187,0,474,42,22856
"Eldred borough, Pennsylvania",132,115,17,414,42,22888
"Elgin borough, Pennsylvania",105,102,3,232,42,22960
"Elim CDP, Pennsylvania",1793,1683,110,3903,42,22976
"Elizabeth borough, Pennsylvania",720,687,33,1433,42,22992
"Elizabethtown borough, Pennsylvania",6521,6303,218,11805,42,23016
"Elizabethville borough, Pennsylvania",833,822,11,1491,42,23024
"Elkins Park CDP, Pennsylvania",4379,4165,214,6973,42,23128
"Elkland borough, Pennsylvania",750,719,31,1673,42,23152
"Ellport borough, Pennsylvania",508,493,15,1077,42,23280
"Ellsworth borough, Pennsylvania",326,283,43,623,42,23296
"Ellwood City borough, Pennsylvania",4505,4266,239,7684,42,23304
"Elrama CDP, Pennsylvania",161,140,21,248,42,23392
"Elverson borough, Pennsylvania",548,542,6,1365,42,23440
"Elysburg CDP, Pennsylvania",1230,1215,15,2451,42,23472
"Emerald Lakes CDP, Pennsylvania",2201,2002,199,3228,42,23540
"Emigsville CDP, Pennsylvania",2286,2115,171,3846,42,23560
"Emlenton borough, Pennsylvania",334,310,24,650,42,23568
"Emmaus borough, Pennsylvania",6846,6575,271,11644,42,23584
"Emporium borough, Pennsylvania",915,823,92,1988,42,23600
"Emsworth borough, Pennsylvania",1290,1218,72,2524,42,23616
"Englewood CDP, Pennsylvania",295,295,0,804,42,23688
"Enhaut CDP, Pennsylvania",902,887,15,1252,42,23704
"Enlow CDP, Pennsylvania",651,651,0,1205,42,23720
"Enola CDP, Pennsylvania",3812,3551,261,5986,42,23744
"Enon Valley borough, Pennsylvania",156,137,19,326,42,23768
"Ephrata borough, Pennsylvania",7346,7114,232,13738,42,23832
"Erie city, Pennsylvania",45332,42232,3100,94826,42,24000
"Ernest borough, Pennsylvania",217,204,13,381,42,24040
"Espy CDP, Pennsylvania",971,932,39,1568,42,24088
"Etna borough, Pennsylvania",1791,1632,159,3413,42,24160
"Evansburg CDP, Pennsylvania",1159,1071,88,2100,42,24240
"Evans City borough, Pennsylvania",1136,1072,64,2001,42,24248
"Everett borough, Pennsylvania",996,930,66,2154,42,24304
"Everson borough, Pennsylvania",413,400,13,659,42,24336
"Exeter borough, Pennsylvania",2618,2546,72,5509,42,24392
"Export borough, Pennsylvania",435,420,15,851,42,24432
"Exton CDP, Pennsylvania",3511,3466,45,6272,42,24440
"Eyers Grove CDP, Pennsylvania",21,21,0,70,42,24448
"Factoryville borough, Pennsylvania",447,371,76,1224,42,24488
"Fairchance borough, Pennsylvania",787,729,58,1657,42,24536
"Fairdale CDP, Pennsylvania",982,950,32,2293,42,24544
"Fairfield borough, Pennsylvania",280,269,11,683,42,24560
"Fairhope CDP, Pennsylvania",437,416,21,1187,42,24664
"Fairless Hills CDP, Pennsylvania",4864,4617,247,9109,42,24712
"Fairview borough, Pennsylvania",75,61,14,194,42,24832
"Fairview CDP, Pennsylvania",1248,1108,140,2959,42,24856
"Fairview-Ferndale CDP, Pennsylvania",883,833,50,1837,42,24948
"Falls Creek borough, Pennsylvania",560,510,50,1037,42,25136
"Fallston borough, Pennsylvania",104,100,4,211,42,25152
"Falmouth CDP, Pennsylvania",260,252,8,518,42,25168
"Farmersville CDP, Pennsylvania",215,215,0,1110,42,25248
"Farmington CDP, Pennsylvania",106,100,6,971,42,25280
"Farrell city, Pennsylvania",1234,1143,91,4280,42,25360
"Farwell CDP, Pennsylvania",210,191,19,406,42,25376
"Fawn Grove borough, Pennsylvania",192,175,17,450,42,25416
"Fawn Lake Forest CDP, Pennsylvania",242,215,27,667,42,25420
"Faxon CDP, Pennsylvania",487,487,0,1101,42,25424
"Fayette City borough, Pennsylvania",193,185,8,356,42,25456
"Fayetteville CDP, Pennsylvania",1203,1203,0,2745,42,25464
"Feasterville CDP, Pennsylvania",1077,1019,58,1975,42,25496
"Fellsburg CDP, Pennsylvania",610,583,27,1139,42,25568
"Felton borough, Pennsylvania",298,272,26,580,42,25584
"Ferndale borough, Pennsylvania",865,823,42,1566,42,25680
"Fernville CDP, Pennsylvania",193,188,5,398,42,25744
"Finleyville borough, Pennsylvania",226,219,7,363,42,25944
"Fisherville CDP, Pennsylvania",9,9,0,30,42,26036
"Fivepointville CDP, Pennsylvania",551,551,0,1136,42,26232
"Fleetwood borough, Pennsylvania",2408,2342,66,4046,42,26280
"Flemington borough, Pennsylvania",623,588,35,1265,42,26296
"Flourtown CDP, Pennsylvania",2655,2570,85,4599,42,26376
"Flying Hills CDP, Pennsylvania",985,985,0,1716,42,26397
"Folcroft borough, Pennsylvania",3320,2983,337,6758,42,26408
"Folsom CDP, Pennsylvania",4525,4434,91,8535,42,26432
"Foot of Ten CDP, Pennsylvania",279,261,18,550,42,26488
"Force CDP, Pennsylvania",113,113,0,269,42,26504
"Ford City borough, Pennsylvania",1299,1244,55,2850,42,26512
"Ford Cliff borough, Pennsylvania",180,174,6,355,42,26520
"Forest City borough, Pennsylvania",702,642,60,1612,42,26560
"Forest Hills borough, Pennsylvania",4040,3708,332,6397,42,26592
"Forestville CDP, Pennsylvania",331,327,4,533,42,26704
"Forksville borough, Pennsylvania",49,48,1,127,42,26760
"Fort Fetter CDP, Pennsylvania",40,40,0,74,42,26776
"Fort Indiantown Gap CDP, Pennsylvania",0,0,0,0,42,26812
"Fort Loudon CDP, Pennsylvania",772,772,0,1059,42,26824
"Fort Washington CDP, Pennsylvania",3410,3304,106,6312,42,26872
"Forty Fort borough, Pennsylvania",2555,2329,226,4242,42,26880
"Foster Brook CDP, Pennsylvania",468,455,13,1069,42,26960
"Fostoria CDP, Pennsylvania",0,0,0,0,42,26976
"Foundryville CDP, Pennsylvania",45,45,0,96,42,26984
"Fountain Hill borough, Pennsylvania",2279,2118,161,4819,42,27008
"Fountain Springs CDP, Pennsylvania",127,115,12,261,42,27024
"Foxburg borough, Pennsylvania",99,80,19,289,42,27112
"Fox Chapel borough, Pennsylvania",2444,2365,79,5299,42,27120
"Fox Chase CDP, Pennsylvania",794,741,53,1411,42,27130
"Frackville borough, Pennsylvania",1661,1612,49,3861,42,27232
"Frankfort Springs borough, Pennsylvania",71,66,5,156,42,27312
"Franklin borough, Pennsylvania",157,152,5,310,42,27360
"Franklin city, Pennsylvania",2909,2699,210,6066,42,27456
"Franklin Forge CDP, Pennsylvania",11,8,3,16,42,27517
"Franklin Park borough, Pennsylvania",8318,7964,354,15305,42,27552
"Franklintown borough, Pennsylvania",299,261,38,392,42,27576
"Frankstown CDP, Pennsylvania",47,47,0,47,42,27592
"Frazer CDP, Pennsylvania",2276,2247,29,3695,42,27616
"Fredericksburg CDP (Blair County), Pennsylvania",47,47,0,145,42,27641
"Fredericksburg CDP (Crawford County), Pennsylvania",449,449,0,1035,42,27648
"Fredericksburg CDP (Lebanon County), Pennsylvania",883,858,25,1660,42,27656
"Fredericktown CDP, Pennsylvania",144,144,0,296,42,27672
"Fredonia borough, Pennsylvania",194,194,0,368,42,27688
"Freeburg borough, Pennsylvania",349,343,6,799,42,27696
"Freedom borough, Pennsylvania",838,801,37,1625,42,27712
"Freeland borough, Pennsylvania",1688,1616,72,3807,42,27744
"Freemansburg borough, Pennsylvania",1529,1456,73,2861,42,27760
"Freeport borough, Pennsylvania",813,738,75,1725,42,27784
"Friedens CDP, Pennsylvania",569,486,83,1200,42,27928
"Friedensburg CDP, Pennsylvania",304,304,0,665,42,27936
"Friendsville borough, Pennsylvania",96,96,0,164,42,27968
"Friesville CDP, Pennsylvania",143,143,0,252,42,27976
"Frisco CDP, Pennsylvania",489,400,89,872,42,28000
"Frizzleburg CDP, Pennsylvania",118,118,0,300,42,28014
"Frystown CDP, Pennsylvania",15,15,0,55,42,28128
"Fullerton CDP, Pennsylvania",9593,9153,440,16358,42,28144
"Galeton borough, Pennsylvania",388,377,11,844,42,28280
"Gallitzin borough, Pennsylvania",712,662,50,1530,42,28328
"Ganister CDP, Pennsylvania",0,0,0,5,42,28360
"Gap CDP, Pennsylvania",1288,1271,17,2324,42,28376
"Garden View CDP, Pennsylvania",1492,1492,0,2653,42,28456
"Gardners CDP, Pennsylvania",54,54,0,97,42,28488
"Garrett borough, Pennsylvania",210,200,10,409,42,28520
"Gastonville CDP, Pennsylvania",1485,1471,14,2575,42,28600
"Geeseytown CDP, Pennsylvania",54,54,0,54,42,28696
"Geistown borough, Pennsylvania",1121,1096,25,2522,42,28720
"Geneva CDP, Pennsylvania",58,58,0,127,42,28768
"Georgetown borough, Pennsylvania",115,115,0,211,42,28824
"Georgetown CDP (Lancaster County), Pennsylvania",260,238,22,612,42,28828
"Georgetown CDP (Luzerne County), Pennsylvania",1183,1163,20,2034,42,28832
"Gettysburg borough, Pennsylvania",4103,3819,284,7709,42,28960
"Gibraltar CDP, Pennsylvania",452,452,0,772,42,29000
"Gibsonia CDP, Pennsylvania",1488,1417,71,2876,42,29040
"Gilberton borough, Pennsylvania",152,150,2,447,42,29088
"Gilbertsville CDP, Pennsylvania",3335,3248,87,5923,42,29096
"Girard borough, Pennsylvania",1888,1779,109,2991,42,29232
"Girardville borough, Pennsylvania",623,569,54,1260,42,29264
"Glasgow borough, Pennsylvania",49,49,0,69,42,29392
"Glassport borough, Pennsylvania",2595,2339,256,4439,42,29432
"Glenburn CDP, Pennsylvania",541,489,52,1112,42,29496
"Glen Campbell borough, Pennsylvania",71,69,2,162,42,29512
"Glendon borough, Pennsylvania",219,207,12,384,42,29568
"Glenfield borough, Pennsylvania",146,133,13,224,42,29592
"Glen Hope borough, Pennsylvania",77,77,0,190,42,29632
"Glen Lyon CDP, Pennsylvania",664,664,0,1958,42,29680
"Glenmoore CDP, Pennsylvania",480,452,28,916,42,29704
"Glenolden borough, Pennsylvania",3793,3616,177,7190,42,29720
"Glen Osborne borough, Pennsylvania",239,232,7,444,42,29732
"Glen Rock borough, Pennsylvania",1268,1127,141,2364,42,29760
"Glenshaw CDP, Pennsylvania",5074,4742,332,9418,42,29800
"Glenside CDP, Pennsylvania",4350,4196,154,7726,42,29808
"Gold Key Lake CDP, Pennsylvania",1154,1137,17,2582,42,30013
"Goldsboro borough, Pennsylvania",426,404,22,716,42,30016
"Goodville CDP, Pennsylvania",150,150,0,281,42,30096
"Gordon borough, Pennsylvania",469,455,14,989,42,30128
"Gordonville CDP, Pennsylvania",243,243,0,643,42,30136
"Gouglersville CDP, Pennsylvania",310,310,0,595,42,30192
"Gouldsboro CDP, Pennsylvania",401,375,26,720,42,30200
"Graceton CDP, Pennsylvania",73,73,0,150,42,30224
"Grampian borough, Pennsylvania",281,234,47,482,42,30280
"Grantley CDP, Pennsylvania",2391,2261,130,4665,42,30435
"Granville CDP, Pennsylvania",237,237,0,384,42,30472
"Grapeville CDP, Pennsylvania",184,184,0,343,42,30512
"Grassflat CDP, Pennsylvania",182,170,12,406,42,30528
"Gratz borough, Pennsylvania",280,264,16,624,42,30600
"Gray CDP, Pennsylvania",70,70,0,102,42,30628
"Grazierville CDP, Pennsylvania",427,417,10,656,42,30704
"Great Bend borough, Pennsylvania",312,276,36,673,42,30728
"Greencastle borough, Pennsylvania",2075,2041,34,4235,42,30896
"Greenfields CDP, Pennsylvania",385,385,0,957,42,31038
"Green Hills borough, Pennsylvania",2,2,0,5,42,31082
"Green Lane borough, Pennsylvania",205,198,7,375,42,31088
"Greenock CDP, Pennsylvania",1147,1147,0,1895,42,31120
"Greensboro borough, Pennsylvania",220,172,48,361,42,31192
"Greensburg city, Pennsylvania",7587,7091,496,14876,42,31200
"Greens Landing CDP, Pennsylvania",262,250,12,561,42,31208
"Green Tree borough, Pennsylvania",2883,2883,0,4870,42,31256
"Greenville borough, Pennsylvania",2715,2638,77,5568,42,31328
"Greenwood CDP, Pennsylvania",1657,1626,31,3287,42,31368
"Grier City CDP, Pennsylvania",179,161,18,242,42,31536
"Grill CDP, Pennsylvania",1231,1227,4,2015,42,31568
"Grindstone CDP, Pennsylvania",145,123,22,619,42,31592
"Grove City borough, Pennsylvania",3773,3589,184,7908,42,31656
"Guilford CDP, Pennsylvania",2234,2218,16,3955,42,31716
"Guys Mills CDP, Pennsylvania",64,64,0,118,42,31840
"Halfway House CDP, Pennsylvania",2160,1883,277,3317,42,32024
"Halifax borough, Pennsylvania",406,389,17,756,42,32032
"Hallam borough, Pennsylvania",1631,1596,35,2769,42,32056
"Hallstead borough, Pennsylvania",575,543,32,1345,42,32080
"Hamburg borough, Pennsylvania",2518,2456,62,4342,42,32120
"Hamorton CDP, Pennsylvania",87,87,0,120,42,32280
"Hampton CDP, Pennsylvania",904,803,101,1701,42,32320
"Hannasville CDP, Pennsylvania",67,67,0,113,42,32384
"Hanover borough, Pennsylvania",8602,8006,596,16411,42,32448
"Harleigh CDP, Pennsylvania",797,797,0,1091,42,32600
"Harleysville CDP, Pennsylvania",5198,5059,139,8992,42,32616
"Harmonsburg CDP, Pennsylvania",81,71,10,183,42,32656
"Harmony borough, Pennsylvania",647,546,101,1230,42,32688
"Harrisburg city, Pennsylvania",24889,22654,2235,50055,42,32800
"Harrison City CDP, Pennsylvania",28,28,0,79,42,32864
"Harrisville borough, Pennsylvania",418,396,22,865,42,32896
"Hartleton borough, Pennsylvania",131,131,0,276,42,32936
"Hartstown CDP, Pennsylvania",75,68,7,163,42,32976
"Harveys Lake borough, Pennsylvania",1622,1594,28,2793,42,33000
"Harwick CDP, Pennsylvania",460,439,21,862,42,33024
"Hasson Heights CDP, Pennsylvania",700,669,31,1387,42,33072
"Hastings borough, Pennsylvania",535,521,14,1051,42,33080
"Hatboro borough, Pennsylvania",4979,4748,231,8176,42,33088
"Hatfield borough, Pennsylvania",1997,1914,83,3490,42,33112
"Haverford College CDP, Pennsylvania",664,599,65,1463,42,33154
"Hawk Run CDP, Pennsylvania",268,179,89,564,42,33184
"Hawley borough, Pennsylvania",555,514,41,1110,42,33200
"Hawthorn borough, Pennsylvania",219,199,20,480,42,33216
"Haysville borough, Pennsylvania",50,49,1,124,42,33312
"Hayti CDP, Pennsylvania",1408,1330,78,2465,42,33328
"Hazen CDP, Pennsylvania",74,64,10,129,42,33364
"Hazleton city, Pennsylvania",14492,13485,1007,29671,42,33408
"Hebron CDP, Pennsylvania",450,450,0,1080,42,33504
"Heckscherville CDP, Pennsylvania",133,107,26,265,42,33528
"Hegins CDP, Pennsylvania",834,815,19,1071,42,33576
"Heidelberg borough, Pennsylvania",813,773,40,1254,42,33592
"Heidlersburg CDP, Pennsylvania",222,205,17,450,42,33632
"Heilwood CDP, Pennsylvania",114,109,5,234,42,33672
"Hellertown borough, Pennsylvania",3235,3097,138,6109,42,33744
"Hemlock Farms CDP, Pennsylvania",1840,1626,214,3647,42,33772
"Hendersonville CDP, Pennsylvania",67,67,0,151,42,33840
"Henrietta CDP, Pennsylvania",103,103,0,214,42,33888
"Hereford CDP, Pennsylvania",774,755,19,1549,42,34008
"Herminie CDP, Pennsylvania",107,107,0,218,42,34048
"Hermitage city, Pennsylvania",7464,7082,382,16216,42,34064
"Herndon borough, Pennsylvania",168,166,2,359,42,34080
"Hershey CDP, Pennsylvania",8177,7911,266,14682,42,34144
"Hickory CDP, Pennsylvania",206,206,0,636,42,34256
"Hickory Hills CDP, Pennsylvania",176,160,16,351,42,34308
"Highland Park CDP, Pennsylvania",571,571,0,1218,42,34592
"Highspire borough, Pennsylvania",1386,1305,81,2709,42,34664
"Hilldale CDP, Pennsylvania",504,447,57,852,42,34776
"Hiller CDP, Pennsylvania",641,566,75,1296,42,34784
"Hokendauqua CDP, Pennsylvania",1948,1859,89,2960,42,35120
"Holiday Pocono CDP, Pennsylvania",164,118,46,447,42,35172
"Hollidaysburg borough, Pennsylvania",2678,2605,73,5630,42,35224
"Holters Crossing CDP, Pennsylvania",86,79,7,114,42,35336
"Homeacre-Lyndora CDP, Pennsylvania",3915,3742,173,6750,42,35364
"Homer City borough, Pennsylvania",844,793,51,1639,42,35408
"Homestead borough, Pennsylvania",1140,1027,113,2905,42,35424
"Hometown CDP, Pennsylvania",1088,1054,34,1660,42,35448
"Homewood borough, Pennsylvania",44,41,3,96,42,35488
"Homewood at Martinsburg CDP, Pennsylvania",0,0,0,253,42,35500
"Honesdale borough, Pennsylvania",2128,1928,200,4469,42,35520
"Honey Brook borough, Pennsylvania",1081,1056,25,2005,42,35528
"Hookstown borough, Pennsylvania",51,51,0,93,42,35576
"Hooversville borough, Pennsylvania",350,339,11,722,42,35608
"Hop Bottom borough, Pennsylvania",142,137,5,297,42,35624
"Hopeland CDP, Pennsylvania",354,354,0,642,42,35632
"Hopewell borough, Pennsylvania",51,49,2,142,42,35648
"Hopwood CDP, Pennsylvania",755,686,69,1611,42,35728
"Horsham CDP, Pennsylvania",9156,8888,268,15683,42,35800
"Hostetter CDP, Pennsylvania",225,225,0,378,42,35872
"Houserville CDP, Pennsylvania",1285,1242,43,2096,42,35888
"Houston borough, Pennsylvania",609,586,23,1204,42,35896
"Houtzdale borough, Pennsylvania",455,425,30,833,42,35928
"Howard borough, Pennsylvania",358,342,16,697,42,35960
"Hublersburg CDP, Pennsylvania",136,136,0,136,42,36064
"Hudson CDP, Pennsylvania",807,784,23,1463,42,36096
"Hughestown borough, Pennsylvania",806,742,64,1453,42,36152
"Hughesville borough, Pennsylvania",1602,1535,67,2511,42,36160
"Hulmeville borough, Pennsylvania",536,495,41,953,42,36192
"Hummelstown borough, Pennsylvania",2975,2872,103,4536,42,36232
"Hummels Wharf CDP, Pennsylvania",353,353,0,654,42,36240
"Hunker borough, Pennsylvania",157,154,3,340,42,36288
"Hunterstown CDP, Pennsylvania",193,185,8,337,42,36352
"Huntingdon borough, Pennsylvania",3298,3168,130,6904,42,36368
"Hyde CDP, Pennsylvania",494,469,25,1048,42,36568
"Hyde Park CDP, Pennsylvania",1284,1186,98,2332,42,36576
"Hyde Park borough, Pennsylvania",276,252,24,501,42,36592
"Hydetown borough, Pennsylvania",274,253,21,647,42,36616
"Hyndman borough, Pennsylvania",481,457,24,926,42,36640
"Idaville CDP, Pennsylvania",84,80,4,162,42,36712
"Imperial CDP, Pennsylvania",1574,1574,0,2736,42,36768
"Indiana borough, Pennsylvania",7051,6468,583,14082,42,36816
"Indian Lake borough, Pennsylvania",182,176,6,314,42,36888
"Indian Mountain Lake CDP, Pennsylvania",1816,1640,176,4100,42,36904
"Industry borough, Pennsylvania",948,884,64,1678,42,36944
"Ingram borough, Pennsylvania",1986,1930,56,3351,42,37000
"Inkerman CDP, Pennsylvania",366,345,21,1304,42,37008
"Intercourse CDP, Pennsylvania",837,837,0,1691,42,37016
"Iola CDP, Pennsylvania",68,68,0,176,42,37024
"Ironville CDP, Pennsylvania",0,0,0,0,42,37136
"Irvona borough, Pennsylvania",268,261,7,475,42,37192
"Irwin borough, Pennsylvania",2274,2168,106,3878,42,37208
"Ivyland borough, Pennsylvania",622,597,25,1100,42,37304
"Jackson Center borough, Pennsylvania",64,64,0,174,42,37496
"Jacksonville CDP (Centre County), Pennsylvania",40,40,0,56,42,37544
"Jacksonville CDP (Indiana County), Pennsylvania",241,225,16,497,42,37552
"Jacksonwald CDP, Pennsylvania",2467,2164,303,4229,42,37584
"Jacobus borough, Pennsylvania",1291,1198,93,2150,42,37640
"James City CDP, Pennsylvania",107,102,5,194,42,37656
"Jamestown borough, Pennsylvania",253,233,20,650,42,37696
"Jamison City CDP, Pennsylvania",129,129,0,293,42,37728
"Jeannette city, Pennsylvania",4232,3897,335,8790,42,37784
"Jeddo borough, Pennsylvania",114,114,0,179,42,37792
"Jefferson borough (Greene County), Pennsylvania",146,119,27,242,42,37880
"Jefferson borough (York County), Pennsylvania",279,263,16,578,42,37944
"Jefferson Hills borough, Pennsylvania",6727,6457,270,12296,42,37955
"Jenkintown borough, Pennsylvania",2360,2217,143,4703,42,38000
"Jennerstown borough, Pennsylvania",667,631,36,1182,42,38048
"Jermyn borough, Pennsylvania",1031,992,39,2070,42,38096
"Jerome CDP, Pennsylvania",284,269,15,718,42,38104
"Jersey Shore borough, Pennsylvania",1730,1646,84,4160,42,38128
"Jerseytown CDP, Pennsylvania",86,74,12,169,42,38152
"Jessup borough, Pennsylvania",1960,1908,52,4510,42,38160
"Jim Thorpe borough, Pennsylvania",2477,2430,47,4532,42,38200
"Joffre CDP, Pennsylvania",189,175,14,397,42,38240
"Johnsonburg borough, Pennsylvania",1210,1153,57,2293,42,38248
"Johnstown city, Pennsylvania",7880,7321,559,18429,42,38288
"Jonestown CDP, Pennsylvania",21,21,0,64,42,38392
"Jonestown borough, Pennsylvania",1069,1023,46,1979,42,38400
"Jugtown CDP, Pennsylvania",8,8,0,15,42,38514
"Julian CDP, Pennsylvania",183,180,3,238,42,38528
"Juniata Gap CDP, Pennsylvania",293,293,0,598,42,38632
"Juniata Terrace borough, Pennsylvania",313,309,4,572,42,38640
"Kane borough, Pennsylvania",1682,1549,133,3605,42,38688
"Kapp Heights CDP, Pennsylvania",393,374,19,765,42,38744
"Karns City borough, Pennsylvania",86,82,4,185,42,38768
"Kelayres CDP, Pennsylvania",278,248,30,465,42,39056
"Kempton CDP, Pennsylvania",84,84,0,158,42,39224
"Kenhorst borough, Pennsylvania",1828,1721,107,2984,42,39256
"Kenilworth CDP, Pennsylvania",1214,1198,16,2045,42,39272
"Kenmar CDP, Pennsylvania",2013,1698,315,4705,42,39280
"Kennerdell CDP, Pennsylvania",94,94,0,172,42,39336
"Kennett Square borough, Pennsylvania",3435,3273,162,5982,42,39352
"Kerrtown CDP, Pennsylvania",0,0,0,42,42,39504
"Kersey CDP, Pennsylvania",395,371,24,662,42,39512
"Kimberton CDP, Pennsylvania",195,184,11,448,42,39648
"King of Prussia CDP, Pennsylvania",15067,14260,807,24423,42,39736
"Kingston borough, Pennsylvania",6909,6545,364,13317,42,39784
"Kirkwood CDP, Pennsylvania",141,130,11,327,42,39944
"Kiskimere CDP, Pennsylvania",68,40,28,138,42,39960
"Kistler borough, Pennsylvania",144,135,9,290,42,40016
"Kittanning borough, Pennsylvania",1857,1780,77,3926,42,40040
"Klahr CDP, Pennsylvania",0,0,0,30,42,40072
"Klingerstown CDP, Pennsylvania",51,51,0,102,42,40136
"Knox borough, Pennsylvania",515,456,59,1063,42,40272
"Knoxville borough, Pennsylvania",411,404,7,906,42,40360
"Koppel borough, Pennsylvania",370,323,47,743,42,40400
"Kratzerville CDP, Pennsylvania",162,160,2,320,42,40432
"Kreamer CDP, Pennsylvania",330,330,0,536,42,40464
"Kulpmont borough, Pennsylvania",1407,1342,65,2758,42,40584
"Kulpsville CDP, Pennsylvania",4597,4470,127,8876,42,40608
"Kutztown borough, Pennsylvania",2389,2126,263,4213,42,40656
"Kutztown University CDP, Pennsylvania",1828,1672,156,4065,42,40666
"Kylertown CDP, Pennsylvania",259,238,21,398,42,40680
"Laceyville borough, Pennsylvania",181,179,2,379,42,40744
"Laflin borough, Pennsylvania",771,735,36,1427,42,40848
"Lake Arthur Estates CDP, Pennsylvania",269,269,0,479,42,40948
"Lake City borough, Pennsylvania",1527,1478,49,2925,42,40960
"Lake Heritage CDP, Pennsylvania",1397,1360,37,2731,42,40981
"Lake Latonka CDP, Pennsylvania",350,350,0,724,42,40982
"Lake Meade CDP, Pennsylvania",1519,1480,39,2504,42,40988
"Lakemont CDP, Pennsylvania",741,699,42,1511,42,40992
"Lake Winola CDP, Pennsylvania",311,292,19,602,42,41080
"Lake Wynonah CDP, Pennsylvania",1533,1501,32,2975,42,41099
"Lamar CDP, Pennsylvania",382,358,24,641,42,41104
"Lampeter CDP, Pennsylvania",1093,1081,12,1995,42,41192
"Lancaster city, Pennsylvania",31588,29265,2323,57970,42,41216
"Landingville borough, Pennsylvania",92,92,0,252,42,41264
"Landisburg borough, Pennsylvania",64,64,0,170,42,41272
"Landisville CDP, Pennsylvania",1377,1312,65,2613,42,41304
"Lanesboro borough, Pennsylvania",174,169,5,593,42,41336
"Langeloth CDP, Pennsylvania",311,311,0,542,42,41376
"Langhorne borough, Pennsylvania",853,790,63,1578,42,41392
"Langhorne Manor borough, Pennsylvania",645,587,58,1563,42,41416
"Lansdale borough, Pennsylvania",10539,10187,352,18727,42,41432
"Lansdowne borough, Pennsylvania",6531,6103,428,11051,42,41440
"Lansford borough, Pennsylvania",1807,1452,355,4129,42,41464
"Laporte borough, Pennsylvania",72,72,0,254,42,41512
"Larke CDP, Pennsylvania",36,36,0,50,42,41580
"Larksville borough, Pennsylvania",2276,2089,187,4240,42,41608
"Latrobe borough, Pennsylvania",4597,4420,177,8047,42,41680
"Lattimer CDP, Pennsylvania",321,321,0,584,42,41700
"Laureldale borough, Pennsylvania",2500,2295,205,4238,42,41768
"Laurel Mountain borough, Pennsylvania",65,60,5,106,42,41834
"Laurel Run borough, Pennsylvania",194,150,44,449,42,41848
"Laurelton CDP, Pennsylvania",191,191,0,366,42,41856
"Laurys Station CDP, Pennsylvania",472,472,0,728,42,41880
"Lavelle CDP, Pennsylvania",255,255,0,388,42,41904
"Lawnton CDP, Pennsylvania",2679,2636,43,5164,42,41944
"Lawrence CDP, Pennsylvania",565,534,31,1003,42,41968
"Lawrence Park CDP, Pennsylvania",1815,1781,34,3818,42,41992
"Lawrenceville borough, Pennsylvania",300,298,2,583,42,42016
"Lawson Heights CDP, Pennsylvania",1401,1303,98,2477,42,42032
"Leamersville CDP, Pennsylvania",0,0,0,17,42,42136
"Lebanon city, Pennsylvania",12828,11543,1285,26679,42,42168
"Lebanon South CDP, Pennsylvania",1063,1020,43,2083,42,42192
"Leechburg borough, Pennsylvania",1076,1033,43,2138,42,42280
"Leeper CDP, Pennsylvania",4,4,0,137,42,42328
"Leesport borough, Pennsylvania",1243,1166,77,2139,42,42352
"Leetsdale borough, Pennsylvania",611,591,20,1125,42,42392
"Lehighton borough, Pennsylvania",2579,2337,242,5279,42,42472
"Leith-Hatfield CDP, Pennsylvania",987,986,1,2315,42,42596
"Lemont CDP, Pennsylvania",984,896,88,2085,42,42632
"Lemont Furnace CDP, Pennsylvania",391,374,17,1034,42,42640
"Lemoyne borough, Pennsylvania",2901,2901,0,4663,42,42648
"Lenape Heights CDP, Pennsylvania",752,736,16,1321,42,42672
"Lenhartsville borough, Pennsylvania",84,82,2,166,42,42688
"Lenkerville CDP, Pennsylvania",149,149,0,812,42,42704
"Leola CDP, Pennsylvania",4122,3874,248,7945,42,42776
"LeRaysville borough, Pennsylvania",167,161,6,289,42,42824
"Level Green CDP, Pennsylvania",2415,2337,78,4140,42,42912
"Levittown CDP, Pennsylvania",28324,26951,1373,51152,42,42928
"Lewisberry borough, Pennsylvania",288,286,2,525,42,42968
"Lewisburg borough, Pennsylvania",2293,2257,36,5284,42,42976
"Lewis Run borough, Pennsylvania",343,332,11,690,42,42984
"Lewistown borough, Pennsylvania",3623,3358,265,8522,42,43000
"Liberty borough (Allegheny County), Pennsylvania",1345,1215,130,2194,42,43064
"Liberty borough (Tioga County), Pennsylvania",98,95,3,234,42,43128
"Lightstreet CDP, Pennsylvania",559,536,23,1298,42,43224
"Ligonier borough, Pennsylvania",857,829,28,1510,42,43232
"Lilly borough, Pennsylvania",343,322,21,777,42,43248
"Lima CDP, Pennsylvania",595,501,94,2644,42,43272
"Lime Ridge CDP, Pennsylvania",404,404,0,853,42,43320
"Lincoln borough, Pennsylvania",530,511,19,998,42,43408
"Lincoln Park CDP, Pennsylvania",912,859,53,1794,42,43496
"Lincoln University CDP, Pennsylvania",1093,1007,86,1984,42,43544
"Lincolnville CDP, Pennsylvania",26,26,0,62,42,43552
"Linds Crossing CDP, Pennsylvania",114,89,25,151,42,43628
"Linesville borough, Pennsylvania",429,391,38,946,42,43656
"Linglestown CDP, Pennsylvania",3782,3656,126,6786,42,43672
"Linntown CDP, Pennsylvania",938,850,88,1687,42,43704
"Linwood CDP, Pennsylvania",2074,1924,150,3287,42,43720
"Lionville CDP, Pennsylvania",4218,3972,246,6724,42,43744
"Lititz borough, Pennsylvania",5008,4876,132,9559,42,43816
"Little Britain CDP, Pennsylvania",190,161,29,287,42,43828
"Little Meadows borough, Pennsylvania",107,103,4,206,42,43928
"Littlestown borough, Pennsylvania",2251,2196,55,4779,42,43944
"Liverpool borough, Pennsylvania",460,432,28,918,42,43968
"Lock Haven city, Pennsylvania",4279,3967,312,8422,42,44128
"Locustdale CDP, Pennsylvania",114,114,0,275,42,44224
"Loganton borough, Pennsylvania",241,234,7,420,42,44400
"Loganville borough, Pennsylvania",990,943,47,1563,42,44416
"Long Branch borough, Pennsylvania",221,208,13,473,42,44512
"Longfellow CDP, Pennsylvania",40,37,3,97,42,44528
"Loop CDP, Pennsylvania",995,995,0,1801,42,44632
"Lorain borough, Pennsylvania",280,258,22,523,42,44664
"Lorane CDP, Pennsylvania",2521,2293,228,4365,42,44672
"Loretto borough, Pennsylvania",302,281,21,1317,42,44704
"Lower Allen CDP, Pennsylvania",4136,4015,121,7350,42,44824
"Lower Burrell city, Pennsylvania",5834,5703,131,11701,42,44864
"Loyalhanna CDP, Pennsylvania",1683,1625,58,3436,42,45192
"Lucerne Mines CDP, Pennsylvania",362,362,0,881,42,45312
"Lumber City CDP, Pennsylvania",109,77,32,252,42,45452
"Luzerne borough, Pennsylvania",1475,1371,104,2718,42,45568
"Lykens borough, Pennsylvania",839,795,44,1631,42,45592
"Lynnwood-Pricedale CDP, Pennsylvania",883,870,13,1918,42,45732
"Lyons borough, Pennsylvania",314,312,2,517,42,45752
"McAdoo borough, Pennsylvania",1273,1197,76,2583,42,45824
"McAlisterville CDP, Pennsylvania",290,290,0,805,42,45848
"McClure borough, Pennsylvania",488,475,13,1171,42,45992
"McConnellsburg borough, Pennsylvania",424,368,56,1056,42,46000
"McConnellstown CDP, Pennsylvania",784,778,6,1432,42,46016
"McDonald borough, Pennsylvania",1102,1044,58,2263,42,46072
"McElhattan CDP, Pennsylvania",367,352,15,959,42,46112
"McEwensville borough, Pennsylvania",164,155,9,339,42,46120
"McGovern CDP, Pennsylvania",2435,2337,98,4194,42,46160
"McKean borough, Pennsylvania",230,216,14,469,42,46216
"McKeansburg CDP, Pennsylvania",79,75,4,163,42,46232
"McKee CDP, Pennsylvania",201,201,0,249,42,46240
"McKeesport city, Pennsylvania",7445,6861,584,17749,42,46256
"McKees Rocks borough, Pennsylvania",2656,2245,411,5893,42,46264
"McKinley CDP, Pennsylvania",1391,1301,90,2446,42,46280
"McKnightstown CDP, Pennsylvania",273,273,0,457,42,46312
"McMurray CDP, Pennsylvania",2193,2099,94,4157,42,46344
"McSherrystown borough, Pennsylvania",1615,1585,30,3087,42,46376
"Macungie borough, Pennsylvania",1913,1872,41,3249,42,46392
"McVeytown borough, Pennsylvania",196,179,17,342,42,46400
"Madison borough, Pennsylvania",180,180,0,363,42,46488
"Madisonburg CDP, Pennsylvania",51,51,0,136,42,46504
"Mahaffey borough, Pennsylvania",133,127,6,305,42,46568
"Mahanoy City borough, Pennsylvania",1380,1191,189,3548,42,46592
"Mainville CDP, Pennsylvania",87,61,26,148,42,46720
"Maitland CDP, Pennsylvania",207,207,0,303,42,46728
"Malvern borough, Pennsylvania",2110,1986,124,3389,42,46792
"Mammoth CDP, Pennsylvania",201,201,0,391,42,46800
"Manchester borough, Pennsylvania",1479,1453,26,2802,42,46864
"Manheim borough, Pennsylvania",2646,2492,154,5028,42,46888
"Manns Choice borough, Pennsylvania",156,141,15,279,42,46944
"Manor borough, Pennsylvania",2199,1956,243,3547,42,47000
"Manorville borough, Pennsylvania",201,184,17,426,42,47064
"Mansfield borough, Pennsylvania",1662,1556,106,3024,42,47080
"Maple Glen CDP, Pennsylvania",3974,3825,149,6637,42,47152
"Mapleton borough, Pennsylvania",191,177,14,361,42,47248
"Mapletown CDP, Pennsylvania",26,22,4,108,42,47264
"Marcus Hook borough, Pennsylvania",1051,952,99,2290,42,47344
"Marianna borough, Pennsylvania",226,212,14,465,42,47400
"Marianne CDP, Pennsylvania",501,497,4,1033,42,47404
"Marienville CDP, Pennsylvania",358,330,28,3191,42,47416
"Marietta borough, Pennsylvania",1465,1380,85,2769,42,47424
"Marion CDP, Pennsylvania",444,444,0,1126,42,47464
"Marion Center borough, Pennsylvania",201,194,7,492,42,47472
"Marion Heights borough, Pennsylvania",252,239,13,654,42,47480
"Marklesburg borough, Pennsylvania",152,147,5,351,42,47544
"Markleysburg borough, Pennsylvania",105,99,6,265,42,47560
"Marlin CDP, Pennsylvania",260,246,14,345,42,47600
"Mars borough, Pennsylvania",595,579,16,1169,42,47672
"Marshallton CDP (Chester County), Pennsylvania",273,258,15,597,42,47728
"Marshallton CDP (Northumberland County), Pennsylvania",619,531,88,1228,42,47736
"Martinsburg borough, Pennsylvania",788,759,29,1651,42,47872
"Martinsburg Junction CDP, Pennsylvania",8,8,0,20,42,47880
"Martins Creek CDP, Pennsylvania",185,185,0,380,42,47896
"Marysville borough, Pennsylvania",1533,1458,75,2651,42,47968
"Masontown borough, Pennsylvania",1310,1185,125,3263,42,48000
"Masthope CDP, Pennsylvania",150,114,36,597,42,48032
"Matamoras borough, Pennsylvania",1382,1358,24,2396,42,48048
"Mather CDP, Pennsylvania",235,207,28,487,42,48064
"Mattawana CDP, Pennsylvania",187,187,0,398,42,48072
"Maxatawny CDP, Pennsylvania",57,32,25,64,42,48120
"Mayfield borough, Pennsylvania",1097,1051,46,1835,42,48176
"Maytown CDP, Pennsylvania",2582,2499,83,4077,42,48224
"Meadowlands CDP, Pennsylvania",110,110,0,189,42,48320
"Meadowood CDP, Pennsylvania",1486,1398,88,2936,42,48336
"Meadville city, Pennsylvania",5975,5563,412,12929,42,48360
"Mechanicsburg borough, Pennsylvania",5519,5363,156,9402,42,48376
"Mechanicsville borough, Pennsylvania",226,214,12,422,42,48448
"Media borough, Pennsylvania",3931,3690,241,5860,42,48480
"Mercer borough, Pennsylvania",854,805,49,1950,42,48696
"Mercersburg borough, Pennsylvania",1201,1169,32,2083,42,48704
"Meridian CDP, Pennsylvania",1978,1951,27,3965,42,48728
"Merion Station CDP, Pennsylvania",2896,2793,103,5393,42,48768
"Mertztown CDP, Pennsylvania",394,394,0,666,42,48824
"Meshoppen borough, Pennsylvania",168,151,17,442,42,48856
"Messiah College CDP, Pennsylvania",1556,1464,92,2246,42,48868
"Mexico CDP, Pennsylvania",267,246,21,492,42,48904
"Meyersdale borough, Pennsylvania",1158,1132,26,2118,42,48912
"Middleburg borough, Pennsylvania",704,686,18,1329,42,48960
"Middleport borough, Pennsylvania",135,118,17,222,42,49048
"Middletown borough, Pennsylvania",4962,4750,212,9525,42,49128
"Middletown CDP, Pennsylvania",3842,3607,235,7245,42,49144
"Midland borough, Pennsylvania",1344,1194,150,2658,42,49184
"Midway CDP, Pennsylvania",383,374,9,814,42,49224
"Midway borough, Pennsylvania",453,402,51,919,42,49240
"Mifflin borough, Pennsylvania",161,157,4,351,42,49272
"Mifflinburg borough, Pennsylvania",1876,1818,58,3479,42,49288
"Mifflintown borough, Pennsylvania",479,443,36,886,42,49304
"Mifflinville CDP, Pennsylvania",629,629,0,1204,42,49312
"Milesburg borough, Pennsylvania",631,630,1,1148,42,49368
"Milford borough, Pennsylvania",839,815,24,1378,42,49400
"Milford Square CDP, Pennsylvania",891,891,0,1293,42,49440
"Millbourne borough, Pennsylvania",752,726,26,1425,42,49504
"Mill Creek borough, Pennsylvania",156,150,6,314,42,49552
"Millersburg borough, Pennsylvania",1295,1285,10,2546,42,49680
"Millerstown CDP, Pennsylvania",0,0,0,0,42,49704
"Millerstown borough, Pennsylvania",351,343,8,732,42,49720
"Millersville borough, Pennsylvania",4342,4165,177,8426,42,49728
"Millerton CDP, Pennsylvania",212,195,17,386,42,49736
"Mill Hall borough, Pennsylvania",771,688,83,1499,42,49760
"Millheim borough, Pennsylvania",372,372,0,598,42,49768
"Mill Run CDP, Pennsylvania",48,48,0,107,42,49848
"Millsboro CDP, Pennsylvania",164,164,0,310,42,49880
"Millvale borough, Pennsylvania",2135,2023,112,3377,42,49920
"Mill Village borough, Pennsylvania",164,154,10,304,42,49936
"Millville borough, Pennsylvania",497,480,17,1000,42,49944
"Millwood CDP, Pennsylvania",186,163,23,387,42,49960
"Milroy CDP, Pennsylvania",950,897,53,1556,42,50000
"Milton borough, Pennsylvania",3656,3400,256,6610,42,50016
"Minersville borough, Pennsylvania",2166,2107,59,4377,42,50088
"Mingoville CDP, Pennsylvania",69,69,0,214,42,50104
"Misericordia University CDP, Pennsylvania",118,118,0,901,42,50160
"Mocanaqua CDP, Pennsylvania",337,318,19,612,42,50208
"Modena borough, Pennsylvania",303,290,13,551,42,50232
"Mohnton borough, Pennsylvania",1599,1454,145,2923,42,50272
"Mohrsville CDP, Pennsylvania",240,240,0,442,42,50280
"Monaca borough, Pennsylvania",2939,2728,211,5587,42,50320
"Monessen city, Pennsylvania",3246,3035,211,6876,42,50344
"Monongahela city, Pennsylvania",2163,1994,169,4147,42,50408
"Monroe borough, Pennsylvania",265,263,2,558,42,50432
"Monroeville municipality, Pennsylvania",15511,14762,749,28517,42,50528
"Mont Alto borough, Pennsylvania",978,935,43,1562,42,50544
"Montandon CDP, Pennsylvania",404,386,18,852,42,50552
"Mont Clare CDP, Pennsylvania",1580,1500,80,2194,42,50560
"Montgomery borough, Pennsylvania",627,588,39,1421,42,50632
"Montgomeryville CDP, Pennsylvania",7132,6614,518,13008,42,50672
"Montoursville borough, Pennsylvania",2359,2255,104,4724,42,50720
"Montrose borough, Pennsylvania",675,621,54,1396,42,50736
"Montrose Manor CDP, Pennsylvania",211,193,18,421,42,50748
"Monument CDP, Pennsylvania",15,11,4,70,42,50760
"Moores Mill CDP, Pennsylvania",0,0,0,0,42,50860
"Moose Run CDP, Pennsylvania",121,121,0,187,42,50879
"Moosic borough, Pennsylvania",3302,3200,102,5930,42,50880
"Morea CDP, Pennsylvania",51,51,0,110,42,50924
"Morgan Hill CDP, Pennsylvania",608,599,9,1176,42,51008
"Morgantown CDP, Pennsylvania",708,681,27,1389,42,51016
"Morrisdale CDP, Pennsylvania",402,388,14,803,42,51120
"Morrisville borough, Pennsylvania",5920,5509,411,9721,42,51144
"Morrisville CDP, Pennsylvania",430,430,0,951,42,51152
"Morton borough, Pennsylvania",1592,1509,83,2759,42,51176
"Moscow borough, Pennsylvania",885,856,29,1838,42,51208
"Moshannon CDP, Pennsylvania",109,109,0,205,42,51240
"Mount Aetna CDP, Pennsylvania",280,244,36,468,42,51320
"Mountainhome CDP, Pennsylvania",642,642,0,1033,42,51344
"Mountain Top CDP, Pennsylvania",6256,6060,196,11791,42,51384
"Mount Carbon borough, Pennsylvania",21,19,2,36,42,51488
"Mount Carmel borough, Pennsylvania",2390,2221,169,5723,42,51496
"Mount Cobb CDP, Pennsylvania",1150,1020,130,1987,42,51536
"Mount Eagle CDP, Pennsylvania",61,61,0,94,42,51552
"Mount Gretna borough, Pennsylvania",71,71,0,197,42,51568
"Mount Gretna Heights CDP, Pennsylvania",147,133,14,237,42,51576
"Mount Holly Springs borough, Pennsylvania",1189,1115,74,2325,42,51592
"Mount Jewett borough, Pennsylvania",342,328,14,677,42,51632
"Mount Joy borough, Pennsylvania",4639,4512,127,8274,42,51656
"Mount Morris CDP, Pennsylvania",306,300,6,688,42,51720
"Mount Oliver borough, Pennsylvania",1561,1404,157,3357,42,51744
"Mount Penn borough, Pennsylvania",1969,1969,0,3222,42,51760
"Mount Pleasant borough, Pennsylvania",2040,1915,125,4242,42,51880
"Mount Pleasant Mills CDP, Pennsylvania",157,157,0,286,42,51904
"Mount Pocono borough, Pennsylvania",1666,1557,109,3098,42,51912
"Mount Union borough, Pennsylvania",977,840,137,2130,42,51984
"Mountville borough, Pennsylvania",1548,1531,17,3002,42,52016
"Mount Wolf borough, Pennsylvania",660,623,37,1196,42,52056
"Muhlenberg Park CDP, Pennsylvania",573,563,10,1176,42,52216
"Muir CDP, Pennsylvania",312,307,5,541,42,52224
"Muncy borough, Pennsylvania",1233,1181,52,2570,42,52264
"Mundys Corner CDP, Pennsylvania",848,836,12,1771,42,52312
"Munhall borough, Pennsylvania",5641,5271,370,10738,42,52320
"Murrysville municipality, Pennsylvania",10491,10125,366,20820,42,52432
"Muse CDP, Pennsylvania",1525,1474,51,2501,42,52440
"Myerstown borough, Pennsylvania",1436,1373,63,3107,42,52488
"Nanticoke city, Pennsylvania",5121,4810,311,10606,42,52584
"Nanty-Glo borough, Pennsylvania",987,940,47,2434,42,52616
"Naomi CDP, Pennsylvania",44,19,25,86,42,52632
"Narberth borough, Pennsylvania",2858,2722,136,4478,42,52664
"Nazareth borough, Pennsylvania",2998,2952,46,6015,42,52808
"Nealmont CDP, Pennsylvania",0,0,0,24,42,52816
"Needmore CDP, Pennsylvania",68,68,0,112,42,52872
"Nemacolin CDP, Pennsylvania",290,290,0,943,42,52968
"Nescopeck borough, Pennsylvania",753,731,22,1426,42,52984
"Nesquehoning borough, Pennsylvania",1517,1293,224,3341,42,53088
"New Albany borough, Pennsylvania",162,154,8,337,42,53152
"New Alexandria borough, Pennsylvania",138,127,11,405,42,53160
"New Baltimore borough, Pennsylvania",86,86,0,147,42,53168
"New Beaver borough, Pennsylvania",605,575,30,1307,42,53184
"New Bedford CDP, Pennsylvania",377,377,0,875,42,53192
"New Berlin borough, Pennsylvania",361,351,10,672,42,53200
"New Berlinville CDP, Pennsylvania",1182,1000,182,1643,42,53208
"New Bethlehem borough, Pennsylvania",325,317,8,845,42,53248
"New Boston CDP, Pennsylvania",67,62,5,143,42,53272
"New Brighton borough, Pennsylvania",2611,2526,85,5645,42,53288
"New Britain borough, Pennsylvania",1561,1505,56,2846,42,53296
"New Buffalo borough, Pennsylvania",52,52,0,112,42,53320
"Newburg CDP, Pennsylvania",131,123,8,227,42,53328
"Newburg borough (Clearfield County), Pennsylvania",25,25,0,59,42,53336
"Newburg borough (Cumberland County), Pennsylvania",256,238,18,386,42,53344
"New Castle city, Pennsylvania",9236,7797,1439,21863,42,53368
"New Castle Northwest CDP, Pennsylvania",725,706,19,1440,42,53392
"New Centerville borough, Pennsylvania",61,61,0,118,42,53416
"New Columbia CDP, Pennsylvania",488,488,0,855,42,53432
"New Columbus borough, Pennsylvania",114,113,1,245,42,53448
"New Cumberland borough, Pennsylvania",4263,3972,291,7515,42,53464
"New Eagle borough, Pennsylvania",1004,862,142,2164,42,53496
"Newell borough, Pennsylvania",251,243,8,668,42,53504
"New Florence borough, Pennsylvania",323,290,33,703,42,53544
"New Freedom borough, Pennsylvania",2555,2535,20,4962,42,53568
"New Freeport CDP, Pennsylvania",28,23,5,80,42,53576
"New Galilee borough, Pennsylvania",158,155,3,334,42,53592
"New Holland borough, Pennsylvania",2889,2814,75,5734,42,53696
"New Hope borough, Pennsylvania",1394,1276,118,2624,42,53712
"New Jerusalem CDP, Pennsylvania",373,373,0,630,42,53728
"New Kensington city, Pennsylvania",5688,5292,396,12163,42,53736
"New Kingstown CDP, Pennsylvania",356,296,60,715,42,53752
"New Lebanon borough, Pennsylvania",52,50,2,155,42,53768
"Newmanstown CDP, Pennsylvania",1490,1490,0,2796,42,53856
"New Market CDP, Pennsylvania",467,429,38,979,42,53872
"New Milford borough, Pennsylvania",361,325,36,677,42,53880
"New Morgan borough, Pennsylvania",22,22,0,70,42,53916
"New Oxford borough, Pennsylvania",833,789,44,1720,42,53920
"New Paris borough, Pennsylvania",126,126,0,217,42,53928
"New Philadelphia borough, Pennsylvania",502,485,17,1052,42,53944
"Newport borough, Pennsylvania",854,819,35,1584,42,53968
"New Ringgold borough, Pennsylvania",135,123,12,251,42,54016
"Newry borough, Pennsylvania",99,99,0,195,42,54024
"New Salem CDP, Pennsylvania",396,331,65,677,42,54040
"New Salem borough, Pennsylvania",584,563,21,991,42,54056
"New Schaefferstown CDP, Pennsylvania",100,100,0,193,42,54064
"New Stanton borough, Pennsylvania",1330,1261,69,2433,42,54104
"Newton Hamilton borough, Pennsylvania",146,140,6,276,42,54160
"Newtown borough, Pennsylvania",1216,1178,38,2169,42,54184
"Newtown CDP, Pennsylvania",122,122,0,202,42,54264
"Newtown Grant CDP, Pennsylvania",3277,3058,219,5850,42,54268
"New Tripoli CDP, Pennsylvania",445,436,9,681,42,54288
"Newville borough, Pennsylvania",792,766,26,1359,42,54320
"New Washington borough, Pennsylvania",13,12,1,31,42,54344
"New Wilmington borough, Pennsylvania",1173,1163,10,2157,42,54352
"Nicholson borough, Pennsylvania",368,363,5,753,42,54400
"Nittany CDP, Pennsylvania",457,457,0,849,42,54520
"Nixon CDP, Pennsylvania",868,844,24,1483,42,54552
"Noblestown CDP, Pennsylvania",252,252,0,532,42,54568
"Norristown borough, Pennsylvania",19006,17825,1181,35712,42,54656
"Northampton borough, Pennsylvania",5401,5181,220,10341,42,54696
"North Apollo borough, Pennsylvania",614,594,20,1239,42,54728
"North Belle Vernon borough, Pennsylvania",830,761,69,1598,42,54776
"North Bend CDP, Pennsylvania",121,111,10,289,42,54784
"North Braddock borough, Pennsylvania",2433,2036,397,4320,42,54816
"North Catasauqua borough, Pennsylvania",1713,1660,53,2956,42,54872
"North Charleroi borough, Pennsylvania",575,551,24,1521,42,54888
"North East borough, Pennsylvania",1735,1559,176,4092,42,54952
"Northern Cambria borough, Pennsylvania",1594,1509,85,3548,42,55000
"North Irwin borough, Pennsylvania",508,499,9,820,42,55136
"North Philipsburg CDP, Pennsylvania",209,170,39,693,42,55304
"Northumberland borough, Pennsylvania",2025,1997,28,3892,42,55456
"North Vandergrift CDP, Pennsylvania",144,107,37,341,42,55480
"North Wales borough, Pennsylvania",2077,2020,57,3415,42,55512
"North Warren CDP, Pennsylvania",893,825,68,1922,42,55520
"Northwest Harborcreek CDP, Pennsylvania",4183,3954,229,9054,42,55572
"Northwood CDP, Pennsylvania",95,82,13,147,42,55584
"North York borough, Pennsylvania",1448,1285,163,2374,42,55608
"Norvelt CDP, Pennsylvania",469,469,0,1005,42,55616
"Norwood borough, Pennsylvania",3353,3062,291,5926,42,55664
"Nottingham CDP, Pennsylvania",882,818,64,1460,42,55704
"Noxen CDP, Pennsylvania",277,229,48,603,42,55728
"Nuangola borough, Pennsylvania",390,383,7,712,42,55752
"Numidia CDP, Pennsylvania",144,144,0,322,42,55792
"Nuremberg CDP, Pennsylvania",106,98,8,268,42,55808
"Oakdale borough, Pennsylvania",790,746,44,1459,42,55840
"Oak Hills CDP, Pennsylvania",1159,1119,40,2430,42,55969
"Oakland CDP (Cambria County), Pennsylvania",824,789,35,1666,42,55996
"Oakland CDP (Lawrence County), Pennsylvania",769,746,23,1356,42,56000
"Oakland borough, Pennsylvania",258,228,30,535,42,56008
"Oakmont borough, Pennsylvania",3725,3542,183,6734,42,56088
"Oakwood CDP, Pennsylvania",976,950,26,2248,42,56232
"Oberlin CDP, Pennsylvania",169,169,0,337,42,56264
"Ohiopyle borough, Pennsylvania",25,22,3,51,42,56408
"Ohioville borough, Pennsylvania",1612,1584,28,3344,42,56432
"Oil City city, Pennsylvania",4541,4189,352,9599,42,56456
"Oklahoma CDP, Pennsylvania",626,626,0,1366,42,56488
"Oklahoma borough, Pennsylvania",460,460,0,964,42,56496
"Old Forge borough, Pennsylvania",4706,4445,261,8506,42,56576
"Old Orchard CDP, Pennsylvania",854,819,35,1826,42,56624
"Oley CDP, Pennsylvania",558,558,0,1131,42,56664
"Oliver CDP, Pennsylvania",1206,1129,77,2283,42,56704
"Olivia CDP, Pennsylvania",43,43,0,43,42,56761
"Olyphant borough, Pennsylvania",2744,2638,106,5372,42,56792
"Oneida CDP, Pennsylvania",220,220,0,373,42,56816
"Orangeville borough, Pennsylvania",169,160,9,404,42,56912
"Orbisonia borough, Pennsylvania",165,162,3,481,42,56928
"Orchard Hills CDP, Pennsylvania",830,806,24,1920,42,56960
"Ore Hill CDP, Pennsylvania",61,61,0,138,42,57016
"Oreland CDP, Pennsylvania",3366,3177,189,6123,42,57024
"Oreminea CDP, Pennsylvania",47,47,0,100,42,57040
"Orrstown borough, Pennsylvania",161,148,13,353,42,57112
"Orrtanna CDP, Pennsylvania",27,22,5,81,42,57120
"Orviston CDP, Pennsylvania",39,38,1,97,42,57160
"Orwigsburg borough, Pennsylvania",1282,1266,16,3001,42,57184
"Orwin CDP, Pennsylvania",121,121,0,255,42,57192
"Osceola Mills borough, Pennsylvania",531,491,40,1176,42,57232
"Oswayo borough, Pennsylvania",53,50,3,102,42,57280
"Oval CDP, Pennsylvania",173,169,4,381,42,57376
"Oxford borough, Pennsylvania",2430,2313,117,5724,42,57480
"Paint borough, Pennsylvania",447,398,49,1122,42,57544
"Palmdale CDP, Pennsylvania",779,730,49,1302,42,57648
"Palmer Heights CDP, Pennsylvania",1973,1838,135,3894,42,57680
"Palmerton borough, Pennsylvania",3036,2982,54,5602,42,57696
"Palmyra borough, Pennsylvania",4343,4194,149,7783,42,57720
"Palo Alto borough, Pennsylvania",490,470,20,953,42,57752
"Paoli CDP, Pennsylvania",3179,2979,200,6121,42,57816
"Paradise CDP, Pennsylvania",620,613,7,1272,42,57840
"Pardeesville CDP, Pennsylvania",317,317,0,605,42,57904
"Paris CDP, Pennsylvania",298,298,0,635,42,57928
"Park Crest CDP, Pennsylvania",240,223,17,583,42,57968
"Parker city, Pennsylvania",229,217,12,660,42,57976
"Parkesburg borough, Pennsylvania",2265,2124,141,3889,42,58032
"Park Forest Village CDP, Pennsylvania",4576,4362,214,8962,42,58036
"Parkside borough, Pennsylvania",1281,1228,53,2052,42,58176
"Parkville CDP, Pennsylvania",4495,4328,167,8226,42,58240
"Parryville borough, Pennsylvania",210,204,6,370,42,58304
"Patterson Heights borough, Pennsylvania",405,364,41,686,42,58384
"Patton borough, Pennsylvania",833,800,33,1888,42,58432
"Paxtang borough, Pennsylvania",970,917,53,1681,42,58504
"Paxtonia CDP, Pennsylvania",2887,2806,81,5480,42,58528
"Paxtonville CDP, Pennsylvania",112,112,0,198,42,58536
"Pen Argyl borough, Pennsylvania",2019,1934,85,3511,42,58696
"Penbrook borough, Pennsylvania",1806,1660,146,3255,42,58712
"Pen Mar CDP, Pennsylvania",652,629,23,1177,42,58776
"Penn borough, Pennsylvania",413,402,11,1033,42,58872
"Penndel borough, Pennsylvania",1499,1446,53,2498,42,58936
"Penn Estates CDP, Pennsylvania",2490,2330,160,4108,42,58948
"Penn Farms CDP, Pennsylvania",1415,1415,0,2498,42,58950
"Penn Lake Park borough, Pennsylvania",196,190,6,372,42,59054
"Pennsburg borough, Pennsylvania",2323,2292,31,3915,42,59120
"Pennsbury Village borough, Pennsylvania",496,488,8,633,42,59152
"Penns Creek CDP, Pennsylvania",412,381,31,794,42,59160
"Pennside CDP, Pennsylvania",3106,2982,124,5235,42,59176
"Penn State Berks CDP, Pennsylvania",372,356,16,834,42,59207
"Penn State Erie (Behrend) CDP, Pennsylvania",580,495,85,1543,42,59212
"Pennville CDP, Pennsylvania",977,947,30,2258,42,59296
"Pennwyn CDP, Pennsylvania",265,265,0,510,42,59304
"Penn Wynne CDP, Pennsylvania",2959,2794,165,6127,42,59312
"Penryn CDP, Pennsylvania",509,509,0,1033,42,59344
"Perkasie borough, Pennsylvania",5815,5593,222,9130,42,59384
"Perryopolis borough, Pennsylvania",783,725,58,1537,42,59520
"Peru CDP, Pennsylvania",32,32,0,65,42,59580
"Petersburg borough, Pennsylvania",196,176,20,383,42,59616
"Petrolia borough, Pennsylvania",67,64,3,159,42,59672
"Philadelphia city, Pennsylvania",806458,736737,69721,1593208,42,60000
"Philipsburg borough, Pennsylvania",1473,1449,24,2782,42,60008
"Phoenixville borough, Pennsylvania",12137,11715,422,18723,42,60120
"Picture Rocks borough, Pennsylvania",340,316,24,578,42,60136
"Pikes Creek CDP, Pennsylvania",232,197,35,325,42,60224
"Pillow borough, Pennsylvania",147,145,2,306,42,60264
"Pinecroft CDP, Pennsylvania",319,319,0,490,42,60384
"Pine Glen CDP, Pennsylvania",116,111,5,217,42,60432
"Pine Grove borough, Pennsylvania",1039,1014,25,2153,42,60456
"Pine Grove Mills CDP, Pennsylvania",957,957,0,1508,42,60496
"Pine Ridge CDP, Pennsylvania",1576,1473,103,2995,42,60547
"Pitcairn borough, Pennsylvania",1307,1150,157,3084,42,60712
"Pittsburgh city, Pennsylvania",169716,160114,9602,303843,42,61000
"Pittston city, Pennsylvania",3723,3469,254,7601,42,61048
"Plainfield CDP, Pennsylvania",87,87,0,242,42,61080
"Plains CDP, Pennsylvania",2423,2271,152,4205,42,61112
"Platea borough, Pennsylvania",201,197,4,440,42,61168
"Pleasant Gap CDP, Pennsylvania",2205,2134,71,3542,42,61232
"Pleasant Hill CDP, Pennsylvania",1718,1379,339,3263,42,61312
"Pleasant Hills borough, Pennsylvania",4485,4279,206,8456,42,61328
"Pleasant View CDP, Pennsylvania",379,369,10,733,42,61432
"Pleasantville borough (Bedford County), Pennsylvania",47,46,1,102,42,61496
"Pleasantville borough (Venango County), Pennsylvania",384,369,15,777,42,61512
"Pleasureville CDP, Pennsylvania",1418,1382,36,2669,42,61520
"Plum borough, Pennsylvania",14655,14349,306,27032,42,61536
"Plumsteadville CDP, Pennsylvania",1846,1752,94,2689,42,61624
"Plumville borough, Pennsylvania",92,89,3,217,42,61632
"Plymouth borough, Pennsylvania",2853,2729,124,5771,42,61648
"Plymouth Meeting CDP, Pennsylvania",3660,3550,110,6756,42,61688
"Plymptonville CDP, Pennsylvania",473,457,16,863,42,61704
"Pocono Mountain Lake Estates CDP, Pennsylvania",361,361,0,973,42,61756
"Pocono Pines CDP, Pennsylvania",287,265,22,654,42,61768
"Pocono Ranch Lands CDP, Pennsylvania",550,422,128,1218,42,61773
"Pocono Springs CDP, Pennsylvania",296,258,38,852,42,61774
"Pocono Woodland Lakes CDP, Pennsylvania",1704,1640,64,3548,42,61788
"Point Marion borough, Pennsylvania",641,604,37,1276,42,61864
"Point View CDP, Pennsylvania",6,6,0,8,42,61888
"Polk borough, Pennsylvania",316,294,22,795,42,61936
"Pomeroy CDP, Pennsylvania",764,720,44,1121,42,61968
"Portage borough, Pennsylvania",1091,1047,44,2658,42,62048
"Port Allegany borough, Pennsylvania",980,890,90,2257,42,62088
"Port Carbon borough, Pennsylvania",814,766,48,1748,42,62128
"Port Clinton borough, Pennsylvania",173,148,25,354,42,62136
"Portersville borough, Pennsylvania",124,123,1,213,42,62224
"Portland borough, Pennsylvania",290,226,64,606,42,62264
"Port Matilda borough, Pennsylvania",294,294,0,559,42,62280
"Port Royal borough, Pennsylvania",427,421,6,729,42,62304
"Port Trevorton CDP, Pennsylvania",321,313,8,629,42,62312
"Port Vue borough, Pennsylvania",2005,1820,185,3673,42,62320
"Potlicker Flats CDP, Pennsylvania",112,107,5,141,42,62340
"Potters Mills CDP, Pennsylvania",78,78,0,170,42,62384
"Pottsgrove CDP, Pennsylvania",2099,2032,67,3409,42,62396
"Pottstown borough, Pennsylvania",12569,11816,753,23356,42,62416
"Pottsville city, Pennsylvania",6579,5951,628,13386,42,62432
"Pringle borough, Pennsylvania",502,483,19,877,42,62712
"Progress CDP, Pennsylvania",6539,6392,147,11364,42,62736
"Prompton borough, Pennsylvania",147,144,3,231,42,62744
"Prospect borough, Pennsylvania",498,478,20,946,42,62752
"Prospect Park CDP, Pennsylvania",160,160,0,406,42,62784
"Prospect Park borough, Pennsylvania",3979,3746,233,6411,42,62792
"Pughtown CDP, Pennsylvania",479,466,13,987,42,62872
"Punxsutawney borough, Pennsylvania",2562,2426,136,5730,42,62920
"Puzzletown CDP, Pennsylvania",58,58,0,79,42,62984
"Pymatuning Central CDP, Pennsylvania",851,816,35,2325,42,63009
"Pymatuning North CDP, Pennsylvania",80,69,11,236,42,63011
"Pymatuning South CDP, Pennsylvania",195,194,1,432,42,63013
"Quakertown borough, Pennsylvania",5390,5047,343,9309,42,63048
"Quarryville borough, Pennsylvania",1352,1305,47,2833,42,63064
"Queens Gate CDP, Pennsylvania",1009,922,87,1562,42,63116
"Quentin CDP, Pennsylvania",390,382,8,676,42,63160
"Railroad borough, Pennsylvania",200,197,3,321,42,63288
"Rainsburg borough, Pennsylvania",55,53,2,132,42,63312
"Ramblewood CDP, Pennsylvania",368,368,0,607,42,63349
"Ramey borough, Pennsylvania",193,187,6,383,42,63360
"Rankin borough, Pennsylvania",888,726,162,1837,42,63408
"Ranshaw CDP, Pennsylvania",180,172,8,328,42,63416
"Raubsville CDP, Pennsylvania",591,591,0,1349,42,63488
"Rauchtown CDP, Pennsylvania",296,281,15,649,42,63496
"Ravine CDP, Pennsylvania",325,280,45,715,42,63536
"Reading city, Pennsylvania",43815,38843,4972,94601,42,63624
"Reamstown CDP, Pennsylvania",1860,1828,32,3683,42,63664
"Rebersburg CDP, Pennsylvania",249,246,3,559,42,63688
"Red Hill CDP, Pennsylvania",90,90,0,187,42,63800
"Red Hill borough, Pennsylvania",1448,1370,78,2663,42,63808
"Red Lion borough, Pennsylvania",3517,3500,17,6499,42,63840
"Reedsville CDP, Pennsylvania",399,395,4,626,42,63976
"Reese CDP, Pennsylvania",38,38,0,38,42,64000
"Refton CDP, Pennsylvania",357,288,69,703,42,64032
"Rehrersburg CDP, Pennsylvania",140,127,13,298,42,64056
"Reiffton CDP, Pennsylvania",2103,1981,122,4079,42,64072
"Reightown CDP, Pennsylvania",31,31,0,78,42,64080
"Reinerton CDP, Pennsylvania",184,166,18,358,42,64104
"Reinholds CDP, Pennsylvania",1153,1153,0,2341,42,64112
"Rennerdale CDP, Pennsylvania",490,461,29,955,42,64184
"Renningers CDP, Pennsylvania",248,248,0,551,42,64188
"Renovo borough, Pennsylvania",408,347,61,1081,42,64200
"Republic CDP, Pennsylvania",602,515,87,1324,42,64224
"Reservoir CDP, Pennsylvania",0,0,0,69,42,64256
"Revloc CDP, Pennsylvania",322,303,19,683,42,64288
"Rew CDP, Pennsylvania",84,84,0,137,42,64296
"Reynolds Heights CDP, Pennsylvania",979,938,41,1977,42,64368
"Reynoldsville borough, Pennsylvania",1222,1103,119,2551,42,64376
"Rheems CDP, Pennsylvania",1232,1203,29,2361,42,64392
"Rices Landing borough, Pennsylvania",290,280,10,483,42,64432
"Riceville CDP, Pennsylvania",35,35,0,55,42,64440
"Richboro CDP, Pennsylvania",3554,3435,119,6983,42,64464
"Richfield CDP, Pennsylvania",180,180,0,377,42,64488
"Richland borough, Pennsylvania",991,956,35,1721,42,64560
"Richlandtown borough, Pennsylvania",648,615,33,1237,42,64584
"Ridgway borough, Pennsylvania",2005,1876,129,4014,42,64784
"Ridley Park borough, Pennsylvania",4104,3878,226,7152,42,64832
"Riegelsville borough, Pennsylvania",437,409,28,792,42,64856
"Rimersburg borough, Pennsylvania",411,411,0,1078,42,64904
"Ringtown borough, Pennsylvania",362,340,22,732,42,65000
"Riverside CDP, Pennsylvania",138,138,0,267,42,65088
"Riverside borough, Pennsylvania",1224,1190,34,2316,42,65112
"Riverview Park CDP, Pennsylvania",1996,1996,0,3675,42,65192
"Roaring Spring borough, Pennsylvania",1403,1323,80,2512,42,65256
"Robeson Extension CDP, Pennsylvania",68,68,0,153,42,65328
"Robesonia borough, Pennsylvania",1206,1176,30,2149,42,65336
"Robinson CDP, Pennsylvania",178,172,6,496,42,65360
"Rochester borough, Pennsylvania",1647,1550,97,3460,42,65392
"Rockhill borough, Pennsylvania",163,159,4,351,42,65496
"Rockledge borough, Pennsylvania",1506,1376,130,2624,42,65568
"Rockwood borough, Pennsylvania",376,351,25,816,42,65736
"Rogersville CDP, Pennsylvania",149,149,0,238,42,65848
"Rohrsburg CDP, Pennsylvania",72,69,3,169,42,65872
"Rome borough, Pennsylvania",203,191,12,445,42,65944
"Ronco CDP, Pennsylvania",18,8,10,39,42,65976
"Ronks CDP, Pennsylvania",107,107,0,227,42,65984
"Roots CDP, Pennsylvania",42,42,0,204,42,66004
"Roscoe borough, Pennsylvania",316,304,12,617,42,66016
"Rosemont CDP, Pennsylvania",1939,1914,25,3861,42,66144
"Roseto borough, Pennsylvania",1033,964,69,1950,42,66168
"Rose Valley borough, Pennsylvania",528,522,6,1187,42,66192
"Roseville borough, Pennsylvania",81,66,15,153,42,66232
"Roslyn CDP, Pennsylvania",5567,5109,458,10011,42,66256
"Rossiter CDP, Pennsylvania",373,341,32,661,42,66304
"Rosslyn Farms borough, Pennsylvania",211,209,2,515,42,66320
"Rote CDP, Pennsylvania",379,370,9,684,42,66384
"Rothsville CDP, Pennsylvania",1567,1552,15,2767,42,66392
"Roulette CDP, Pennsylvania",400,366,34,787,42,66408
"Rouseville borough, Pennsylvania",256,223,33,521,42,66440
"Rouzerville CDP, Pennsylvania",287,287,0,669,42,66448
"Rowes Run CDP, Pennsylvania",222,196,26,432,42,66472
"Royalton borough, Pennsylvania",504,500,4,979,42,66560
"Royer CDP, Pennsylvania",22,22,0,35,42,66568
"Royersford borough, Pennsylvania",3089,3005,84,4917,42,66576
"Runville CDP, Pennsylvania",195,174,21,427,42,66688
"Rupert CDP, Pennsylvania",109,101,8,220,42,66696
"Rural Valley borough, Pennsylvania",441,386,55,946,42,66720
"Russell CDP, Pennsylvania",720,687,33,1342,42,66808
"Russellton CDP, Pennsylvania",724,685,39,1224,42,66832
"Rutherford CDP, Pennsylvania",3588,3443,145,6571,42,66864
"Rutledge borough, Pennsylvania",575,554,21,1023,42,66928
"Sadsburyville CDP, Pennsylvania",470,445,25,800,42,67104
"Saegertown borough, Pennsylvania",433,429,4,967,42,67120
"St. Clair CDP, Pennsylvania",17,17,0,53,42,67220
"St. Clair borough, Pennsylvania",1511,1494,17,2765,42,67224
"St. Clairsville borough, Pennsylvania",40,39,1,88,42,67256
"St. Davids CDP, Pennsylvania",1943,1909,34,3640,42,67264
"St. Lawrence borough, Pennsylvania",919,876,43,1780,42,67304
"St. Marys city, Pennsylvania",6780,6160,620,12691,42,67344
"St. Michael CDP, Pennsylvania",118,118,0,358,42,67352
"St. Petersburg borough, Pennsylvania",129,117,12,272,42,67384
"St. Vincent College CDP, Pennsylvania",621,533,88,1435,42,67416
"Salisbury borough, Pennsylvania",352,310,42,619,42,67584
"Salix CDP, Pennsylvania",666,654,12,1294,42,67608
"Salladasburg borough, Pennsylvania",106,95,11,176,42,67616
"Salona CDP, Pennsylvania",139,130,9,317,42,67624
"Saltillo borough, Pennsylvania",229,228,1,459,42,67632
"Saltsburg borough, Pennsylvania",316,313,3,752,42,67648
"Salunga CDP, Pennsylvania",1501,1467,34,3114,42,67656
"Sanatoga CDP, Pennsylvania",4447,4214,233,8829,42,67712
"Sand Hill CDP, Pennsylvania",1496,1471,25,2526,42,67744
"Sandy CDP, Pennsylvania",404,404,0,1086,42,67784
"Sandy Lake borough, Pennsylvania",496,456,40,775,42,67848
"Sandy Ridge CDP, Pennsylvania",106,106,0,258,42,67872
"Sankertown borough, Pennsylvania",320,298,22,599,42,67920
"Saw Creek CDP, Pennsylvania",2207,1934,273,4071,42,68036
"Saxonburg borough, Pennsylvania",628,614,14,1333,42,68056
"Saxton borough, Pennsylvania",252,224,28,655,42,68072
"Saylorsburg CDP, Pennsylvania",580,580,0,1077,42,68088
"Sayre borough, Pennsylvania",2888,2651,237,5463,42,68096
"Scalp Level borough, Pennsylvania",326,316,10,678,42,68104
"Schaefferstown CDP, Pennsylvania",443,443,0,747,42,68144
"Schellsburg borough, Pennsylvania",134,134,0,299,42,68152
"Schlusser CDP, Pennsylvania",3327,3179,148,5725,42,68188
"Schnecksville CDP, Pennsylvania",2017,1904,113,3893,42,68192
"Schoeneck CDP, Pennsylvania",550,521,29,1080,42,68200
"Schubert CDP, Pennsylvania",92,81,11,110,42,68248
"Schuylkill Haven borough, Pennsylvania",2829,2637,192,5242,42,68312
"Schwenksville borough, Pennsylvania",758,727,31,1366,42,68328
"Scotland CDP, Pennsylvania",391,377,14,1179,42,68376
"Scottdale borough, Pennsylvania",2193,1999,194,4398,42,68432
"Scranton city, Pennsylvania",36355,34311,2044,76119,42,69000
"Selinsgrove borough, Pennsylvania",2972,2928,44,5710,42,69216
"Sellersville borough, Pennsylvania",2822,2730,92,4537,42,69248
"Seltzer CDP, Pennsylvania",150,136,14,396,42,69256
"Seneca CDP, Pennsylvania",374,358,16,911,42,69272
"Seven Fields borough, Pennsylvania",1692,1594,98,2903,42,69309
"Seven Springs borough, Pennsylvania",32,32,0,38,42,69336
"Seven Valleys borough, Pennsylvania",379,360,19,545,42,69360
"Seward borough, Pennsylvania",163,158,5,379,42,69368
"Sewickley borough, Pennsylvania",2055,1902,153,3873,42,69376
"Sewickley Heights borough, Pennsylvania",352,343,9,762,42,69400
"Sewickley Hills borough, Pennsylvania",284,271,13,697,42,69416
"Shade Gap borough, Pennsylvania",43,38,5,93,42,69456
"Shamokin city, Pennsylvania",3044,2779,265,6915,42,69600
"Shamokin Dam borough, Pennsylvania",970,938,32,1829,42,69616
"Shanksville borough, Pennsylvania",88,86,2,166,42,69680
"Shanor-Northvue CDP, Pennsylvania",2383,2348,35,5147,42,69715
"Sharon city, Pennsylvania",6071,5620,451,13143,42,69720
"Sharon Hill borough, Pennsylvania",2780,2269,511,5976,42,69752
"Sharpsburg borough, Pennsylvania",1557,1389,168,3189,42,69776
"Sharpsville borough, Pennsylvania",2052,1920,132,4249,42,69800
"Shartlesville CDP, Pennsylvania",202,166,36,345,42,69816
"Shavertown CDP, Pennsylvania",1180,1056,124,1814,42,69832
"Sheakleyville borough, Pennsylvania",78,73,5,129,42,69936
"Sheatown CDP, Pennsylvania",253,217,36,684,42,69952
"Sheffield CDP, Pennsylvania",338,338,0,757,42,69984
"Shelltown CDP, Pennsylvania",44,44,0,84,42,70020
"Shellytown CDP, Pennsylvania",51,51,0,89,42,70032
"Shelocta borough, Pennsylvania",21,21,0,70,42,70040
"Shenandoah borough, Pennsylvania",1543,1361,182,4288,42,70056
"Shenandoah Heights CDP, Pennsylvania",918,826,92,1383,42,70064
"Sheppton CDP, Pennsylvania",126,117,9,477,42,70128
"Shickshinny borough, Pennsylvania",299,277,22,598,42,70224
"Shillington borough, Pennsylvania",3184,2922,262,5458,42,70248
"Shiloh CDP, Pennsylvania",6226,6143,83,11290,42,70256
"Shinglehouse borough, Pennsylvania",390,382,8,880,42,70304
"Shippensburg borough, Pennsylvania",2938,2833,105,5688,42,70352
"Shippensburg University CDP, Pennsylvania",1256,1049,207,1924,42,70362
"Shippenville borough, Pennsylvania",282,267,15,627,42,70368
"Shippingport borough, Pennsylvania",134,123,11,223,42,70376
"Shiremanstown borough, Pennsylvania",944,845,99,1751,42,70384
"Shirleysburg borough, Pennsylvania",63,57,6,153,42,70408
"Shoemakersville borough, Pennsylvania",888,846,42,1427,42,70464
"Shrewsbury borough, Pennsylvania",1988,1877,111,3849,42,70568
"Sickles Corner CDP, Pennsylvania",77,77,0,204,42,70608
"Sidman CDP, Pennsylvania",99,99,0,252,42,70640
"Sierra View CDP, Pennsylvania",2863,2605,258,5826,42,70652
"Siglerville CDP, Pennsylvania",88,88,0,197,42,70664
"Silkworth CDP, Pennsylvania",218,203,15,496,42,70704
"Silverdale borough, Pennsylvania",561,550,11,1023,42,70744
"Simpson CDP, Pennsylvania",582,571,11,1147,42,70840
"Sinking Spring borough, Pennsylvania",2552,2486,66,4261,42,70880
"Skelp CDP, Pennsylvania",79,79,0,148,42,70984
"Ski Gap CDP, Pennsylvania",0,0,0,38,42,70996
"Skippack CDP, Pennsylvania",2242,2214,28,3854,42,71008
"Skyline View CDP, Pennsylvania",2474,2453,21,4848,42,71032
"Slabtown CDP, Pennsylvania",97,97,0,128,42,71056
"Slatedale CDP, Pennsylvania",308,308,0,550,42,71080
"Slatington borough, Pennsylvania",1852,1763,89,4283,42,71144
"Slickville CDP, Pennsylvania",105,105,0,297,42,71160
"Sligo borough, Pennsylvania",334,308,26,745,42,71176
"Slippery Rock borough, Pennsylvania",1602,1523,79,3367,42,71184
"Slippery Rock University CDP, Pennsylvania",1242,1108,134,2682,42,71210
"Slovan CDP, Pennsylvania",189,189,0,516,42,71232
"Smethport borough, Pennsylvania",605,571,34,1556,42,71248
"Smicksburg borough, Pennsylvania",19,19,0,55,42,71256
"Smith Corner CDP, Pennsylvania",0,0,0,0,42,71298
"Smithfield borough, Pennsylvania",584,533,51,1128,42,71320
"Smithton borough, Pennsylvania",160,142,18,405,42,71424
"Smock CDP, Pennsylvania",230,207,23,540,42,71456
"Smoketown CDP, Pennsylvania",145,145,0,392,42,71504
"Snow Shoe borough, Pennsylvania",345,341,4,714,42,71600
"S.N.P.J. borough, Pennsylvania",8,8,0,18,42,71620
"Snydertown CDP, Pennsylvania",313,313,0,464,42,71672
"Snydertown borough, Pennsylvania",181,170,11,338,42,71688
"Somerset borough, Pennsylvania",3048,2924,124,6030,42,71776
"Soudersburg CDP, Pennsylvania",230,230,0,453,42,71848
"Souderton borough, Pennsylvania",4231,4043,188,7169,42,71856
"South Bethlehem borough, Pennsylvania",187,184,3,379,42,71976
"South Coatesville borough, Pennsylvania",964,880,84,1751,42,72072
"South Connellsville borough, Pennsylvania",824,794,30,1884,42,72080
"South Fork borough, Pennsylvania",387,375,12,864,42,72168
"South Greensburg borough, Pennsylvania",1158,1126,32,2282,42,72192
"South Heights borough, Pennsylvania",205,205,0,333,42,72216
"Southmont borough, Pennsylvania",1082,980,102,2196,42,72344
"South New Castle borough, Pennsylvania",458,434,24,872,42,72376
"South Philipsburg CDP, Pennsylvania",162,162,0,545,42,72416
"South Pottstown CDP, Pennsylvania",1395,1304,91,2381,42,72432
"South Renovo borough, Pennsylvania",183,166,17,467,42,72448
"South Temple CDP, Pennsylvania",777,768,9,1874,42,72520
"South Uniontown CDP, Pennsylvania",576,569,7,1216,42,72552
"Southview CDP, Pennsylvania",199,173,26,364,42,72576
"South Waverly borough, Pennsylvania",593,577,16,1162,42,72592
"Southwest Greensburg borough, Pennsylvania",1122,1068,54,2012,42,72616
"South Williamsport borough, Pennsylvania",3194,2991,203,6246,42,72648
"Spartansburg borough, Pennsylvania",117,110,7,263,42,72704
"Speers borough, Pennsylvania",444,435,9,1022,42,72736
"Spinnerstown CDP, Pennsylvania",1095,1051,44,1966,42,72768
"Springboro borough, Pennsylvania",241,227,14,437,42,72872
"Spring City borough, Pennsylvania",2281,2195,86,3486,42,72920
"Springdale borough, Pennsylvania",1877,1741,136,3373,42,72960
"Spring Drive Mobile Home Park CDP, Pennsylvania",104,81,23,195,42,72988
"Spring Grove borough, Pennsylvania",1175,1144,31,2141,42,73192
"Spring Hill CDP, Pennsylvania",380,348,32,970,42,73224
"Spring House CDP, Pennsylvania",2035,1965,70,4840,42,73264
"Spring Mills CDP, Pennsylvania",233,213,20,424,42,73288
"Springmont CDP, Pennsylvania",832,832,0,1424,42,73296
"Spring Mount CDP, Pennsylvania",1366,1236,130,2566,42,73312
"Spring Ridge CDP, Pennsylvania",331,317,14,898,42,73318
"Sproul CDP, Pennsylvania",149,142,7,206,42,73456
"Spry CDP, Pennsylvania",2767,2643,124,4760,42,73528
"Starbrick CDP, Pennsylvania",271,271,0,677,42,73704
"Star Junction CDP, Pennsylvania",174,168,6,311,42,73720
"Starrucca borough, Pennsylvania",106,91,15,164,42,73784
"State College borough, Pennsylvania",16959,16296,663,40902,42,73808
"State Line CDP, Pennsylvania",1831,1813,18,3395,42,73848
"Steelton borough, Pennsylvania",2936,2761,175,6243,42,73888
"Stevens CDP, Pennsylvania",217,207,10,536,42,74040
"Stewartstown borough, Pennsylvania",1013,975,38,1984,42,74104
"Stiles CDP, Pennsylvania",754,585,169,1097,42,74160
"Stillwater borough, Pennsylvania",108,107,1,221,42,74184
"Stockdale borough, Pennsylvania",151,139,12,253,42,74224
"Stockertown borough, Pennsylvania",510,497,13,911,42,74232
"Stoneboro borough, Pennsylvania",382,372,10,774,42,74288
"Stonerstown CDP, Pennsylvania",194,177,17,390,42,74360
"Stonybrook CDP, Pennsylvania",1579,1579,0,3577,42,74416
"Stony Creek Mills CDP, Pennsylvania",419,350,69,865,42,74448
"Stormstown CDP, Pennsylvania",1367,1304,63,2464,42,74544
"Stouchsburg CDP, Pennsylvania",190,183,7,350,42,74568
"Stowe CDP, Pennsylvania",2282,2180,102,3620,42,74660
"Stoystown borough, Pennsylvania",224,209,15,410,42,74672
"Strasburg borough, Pennsylvania",1594,1530,64,3097,42,74712
"Strattanville borough, Pennsylvania",336,332,4,605,42,74728
"Strausstown CDP, Pennsylvania",151,144,7,302,42,74744
"Strodes Mills CDP, Pennsylvania",664,664,0,1431,42,74848
"Strong CDP, Pennsylvania",0,0,0,0,42,74864
"Stroudsburg borough, Pennsylvania",3119,3031,88,5897,42,74888
"Sturgeon CDP, Pennsylvania",674,626,48,1407,42,74944
"Sugarcreek borough, Pennsylvania",1926,1827,99,4785,42,75000
"Sugar Grove borough, Pennsylvania",263,262,1,581,42,75024
"Sugar Notch borough, Pennsylvania",461,441,20,917,42,75072
"Summerhill borough, Pennsylvania",280,268,12,526,42,75136
"Summerville borough, Pennsylvania",210,193,17,497,42,75168
"Summit Hill borough, Pennsylvania",1541,1506,35,3117,42,75248
"Summit Station CDP, Pennsylvania",53,53,0,219,42,75272
"Sunbrook CDP, Pennsylvania",57,57,0,192,42,75296
"Sunbury city, Pennsylvania",4440,4196,244,9680,42,75304
"Sunrise Lake CDP, Pennsylvania",712,637,75,1214,42,75381
"Sun Valley CDP, Pennsylvania",1197,1147,50,2206,42,75432
"Susquehanna Depot borough, Pennsylvania",626,566,60,1395,42,75568
"Susquehanna Trails CDP, Pennsylvania",1288,1249,39,2097,42,75574
"Sutersville borough, Pennsylvania",226,218,8,444,42,75584
"Swarthmore borough, Pennsylvania",3123,2777,346,6507,42,75648
"Swartzville CDP, Pennsylvania",1227,1205,22,2111,42,75664
"Swedeland CDP, Pennsylvania",1159,1064,95,1739,42,75712
"Sweden Valley CDP, Pennsylvania",110,96,14,204,42,75728
"Swissvale borough, Pennsylvania",5403,5048,355,8588,42,75816
"Swoyersville borough, Pennsylvania",2722,2623,99,5021,42,75832
"Sykesville borough, Pennsylvania",470,445,25,944,42,75888
"Sylvan Hills CDP, Pennsylvania",164,164,0,456,42,75936
"Sylvania borough, Pennsylvania",89,87,2,246,42,75944
"Table Rock CDP, Pennsylvania",49,49,0,100,42,75968
"Tamaqua borough, Pennsylvania",3539,3353,186,6911,42,76032
"Tarentum borough, Pennsylvania",2050,1923,127,4328,42,76104
"Tatamy borough, Pennsylvania",611,607,4,1067,42,76144
"Taylor borough, Pennsylvania",2914,2637,277,6274,42,76184
"Taylorstown CDP, Pennsylvania",129,121,8,262,42,76232
"Telford borough, Pennsylvania",2540,2407,133,4807,42,76304
"Temple CDP, Pennsylvania",1162,1072,90,2251,42,76320
"Templeton CDP, Pennsylvania",129,119,10,292,42,76336
"Terre Hill borough, Pennsylvania",507,492,15,1030,42,76400
"Tharptown (Uniontown) CDP, Pennsylvania",163,135,28,269,42,76432
"The Hideout CDP, Pennsylvania",604,563,41,2069,42,76440
"Thompson borough, Pennsylvania",143,127,16,291,42,76496
"Thompsontown borough, Pennsylvania",289,282,7,625,42,76536
"Thompsonville CDP, Pennsylvania",1732,1708,24,3859,42,76552
"Thornburg borough, Pennsylvania",246,243,3,454,42,76560
"Thorndale CDP, Pennsylvania",2083,2060,23,4007,42,76584
"Three Springs borough, Pennsylvania",152,150,2,403,42,76632
"Throop borough, Pennsylvania",1997,1943,54,4062,42,76648
"Tidioute borough, Pennsylvania",345,325,20,802,42,76696
"Timber Hills CDP, Pennsylvania",93,93,0,482,42,76724
"Timblin borough, Pennsylvania",64,63,1,155,42,76744
"Tioga borough, Pennsylvania",275,256,19,631,42,76808
"Tionesta borough, Pennsylvania",127,126,1,358,42,76848
"Tipton CDP, Pennsylvania",310,310,0,519,42,76880
"Titusville city, Pennsylvania",2075,1915,160,5262,42,76904
"Toftrees CDP, Pennsylvania",1259,1094,165,2275,42,77016
"Topton borough, Pennsylvania",1349,1304,45,2277,42,77104
"Toughkenamon CDP, Pennsylvania",501,496,5,939,42,77144
"Towamensing Trails CDP, Pennsylvania",641,627,14,1712,42,77163
"Towanda borough, Pennsylvania",1206,1166,40,2811,42,77168
"Tower City borough, Pennsylvania",660,628,32,1329,42,77184
"Townville borough, Pennsylvania",164,156,8,302,42,77232
"Trafford borough, Pennsylvania",1537,1468,69,3237,42,77272
"Trainer borough, Pennsylvania",860,822,38,1637,42,77288
"Trappe borough, Pennsylvania",2536,2496,40,3976,42,77304
"Treasure Lake CDP, Pennsylvania",2505,2388,117,4890,42,77335
"Tremont borough, Pennsylvania",778,754,24,1679,42,77392
"Tresckow CDP, Pennsylvania",467,400,67,865,42,77424
"Trevorton CDP, Pennsylvania",873,848,25,1695,42,77448
"Trevose CDP, Pennsylvania",2389,2306,83,3957,42,77456
"Trexlertown CDP, Pennsylvania",1229,1229,0,1885,42,77488
"Trooper CDP, Pennsylvania",3116,2969,147,5185,42,77520
"Troutville borough, Pennsylvania",73,73,0,218,42,77568
"Troxelville CDP, Pennsylvania",185,182,3,424,42,77576
"Troy borough, Pennsylvania",647,640,7,1431,42,77584
"Trucksville CDP, Pennsylvania",1173,1118,55,2388,42,77656
"Trumbauersville borough, Pennsylvania",587,573,14,924,42,77704
"Tullytown borough, Pennsylvania",1244,1203,41,2321,42,77744
"Tunkhannock borough, Pennsylvania",736,703,33,1635,42,77784
"Tunnelhill borough, Pennsylvania",128,116,12,250,42,77808
"Turbotville borough, Pennsylvania",323,292,31,818,42,77832
"Turtle Creek borough, Pennsylvania",2391,2045,346,5087,42,77912
"Tuscarora CDP, Pennsylvania",171,171,0,404,42,77968
"Twilight borough, Pennsylvania",115,111,4,265,42,78008
"Tyler Run CDP, Pennsylvania",886,842,44,1943,42,78115
"Tylersburg CDP, Pennsylvania",67,62,5,97,42,78120
"Tylersville CDP, Pennsylvania",71,66,5,180,42,78144
"Tyrone borough, Pennsylvania",3044,2888,156,5447,42,78168
"Tyrone Forge CDP, Pennsylvania",0,0,0,0,42,78186
"Ulysses borough, Pennsylvania",270,254,16,636,42,78240
"Union City borough, Pennsylvania",1221,1129,92,2937,42,78448
"Union Dale borough, Pennsylvania",78,75,3,160,42,78456
"Union Deposit CDP, Pennsylvania",255,255,0,440,42,78472
"Uniontown city, Pennsylvania",4442,3880,562,9913,42,78528
"Unionville CDP (Butler County), Pennsylvania",341,323,18,718,42,78608
"Unionville borough, Pennsylvania",147,146,1,256,42,78616
"Unionville CDP (Chester County), Pennsylvania",315,315,0,722,42,78624
"University of Pittsburgh Bradford CDP, Pennsylvania",402,389,13,812,42,78698
"University of Pittsburgh Johnstown CDP, Pennsylvania",329,309,20,1428,42,78700
"Upland borough, Pennsylvania",1691,1556,135,3078,42,78712
"Upper Exeter CDP, Pennsylvania",533,523,10,971,42,79016
"Ursina borough, Pennsylvania",117,99,18,214,42,79424
"Utica borough, Pennsylvania",62,60,2,123,42,79472
"Vail CDP, Pennsylvania",8,0,8,8,42,79496
"Valencia borough, Pennsylvania",145,145,0,502,42,79504
"Valley Green CDP, Pennsylvania",1721,1687,34,2867,42,79640
"Valley-Hi borough, Pennsylvania",0,0,0,3,42,79644
"Valley View CDP (Schuylkill County), Pennsylvania",707,692,15,1425,42,79680
"Valley View CDP (York County), Pennsylvania",1643,1492,151,3165,42,79682
"Vanderbilt borough, Pennsylvania",152,152,0,314,42,79768
"Vandergrift borough, Pennsylvania",2521,2265,256,5051,42,79776
"Vandling borough, Pennsylvania",389,377,12,794,42,79792
"Van Voorhis CDP, Pennsylvania",52,52,0,468,42,79872
"Venango borough, Pennsylvania",125,113,12,221,42,79912
"Verona borough, Pennsylvania",1520,1402,118,2629,42,80032
"Versailles borough, Pennsylvania",832,784,48,1620,42,80040
"Vicksburg CDP (Blair County), Pennsylvania",31,31,0,74,42,80136
"Vicksburg CDP (Union County), Pennsylvania",83,83,0,161,42,80144
"Village Green-Green Ridge CDP, Pennsylvania",4675,4357,318,8652,42,80218
"Village Shires CDP, Pennsylvania",1603,1578,25,3201,42,80229
"Villanova CDP, Pennsylvania",3210,3033,177,8081,42,80248
"Vinco CDP, Pennsylvania",829,797,32,1540,42,80264
"Vintondale borough, Pennsylvania",188,163,25,455,42,80288
"Virginville CDP, Pennsylvania",195,195,0,238,42,80336
"Volant borough, Pennsylvania",51,45,6,84,42,80368
"Vowinckel CDP, Pennsylvania",98,98,0,141,42,80384
"Wagner CDP, Pennsylvania",40,40,0,90,42,80432
"Wakefield CDP, Pennsylvania",247,247,0,579,42,80480
"Wall borough, Pennsylvania",252,213,39,526,42,80600
"Wallaceton borough, Pennsylvania",132,118,14,246,42,80640
"Wallenpaupack Lake Estates CDP, Pennsylvania",459,422,37,1075,42,80652
"Waller CDP, Pennsylvania",17,17,0,69,42,80656
"Walnutport borough, Pennsylvania",1140,1119,21,1918,42,80800
"Walnuttown CDP, Pennsylvania",249,236,13,464,42,80808
"Wampum borough, Pennsylvania",308,287,21,562,42,80880
"Wanamie CDP, Pennsylvania",240,213,27,635,42,80896
"Warminster Heights CDP, Pennsylvania",2359,2324,35,3884,42,80962
"Warren city, Pennsylvania",4672,4524,148,9353,42,81000
"Warrior Run borough, Pennsylvania",264,234,30,523,42,81080
"Washington city, Pennsylvania",7222,6611,611,13358,42,81328
"Washington Boro CDP, Pennsylvania",403,390,13,693,42,81360
"Washingtonville borough, Pennsylvania",107,106,1,221,42,81424
"Waterford borough, Pennsylvania",617,560,57,1244,42,81456
"Watsontown borough, Pennsylvania",923,891,32,1792,42,81616
"Wattsburg borough, Pennsylvania",230,220,10,458,42,81648
"Waverly CDP, Pennsylvania",289,289,0,518,42,81664
"Waymart borough, Pennsylvania",452,425,27,1226,42,81712
"Wayne CDP, Pennsylvania",3878,3653,225,7088,42,81752
"Wayne Heights CDP, Pennsylvania",1714,1674,40,3147,42,81808
"Waynesboro borough, Pennsylvania",5453,5267,186,11009,42,81824
"Waynesburg borough, Pennsylvania",1834,1720,114,3954,42,81832
"Weatherly borough, Pennsylvania",1158,1068,90,2544,42,81856
"Webster CDP, Pennsylvania",88,88,0,112,42,81936
"Weedville CDP, Pennsylvania",263,227,36,652,42,81960
"Weigelstown CDP, Pennsylvania",7630,7519,111,14960,42,82008
"Weissport borough, Pennsylvania",262,241,21,434,42,82080
"Weissport East CDP, Pennsylvania",918,713,205,1551,42,82088
"Wellersburg borough, Pennsylvania",70,69,1,148,42,82128
"Wellsboro borough, Pennsylvania",1669,1590,79,3459,42,82160
"Wellsville borough, Pennsylvania",128,126,2,215,42,82200
"Wernersville borough, Pennsylvania",1258,1200,58,2768,42,82296
"Wescosville CDP, Pennsylvania",3974,3854,120,6799,42,82320
"Wesleyville borough, Pennsylvania",1635,1508,127,3209,42,82344
"West Alexander CDP, Pennsylvania",250,250,0,420,42,82376
"West Brownsville borough, Pennsylvania",593,563,30,1091,42,82616
"West Chester borough, Pennsylvania",11848,10986,862,19016,42,82704
"West Conshohocken borough, Pennsylvania",967,946,21,1516,42,82736
"West Decatur CDP, Pennsylvania",270,247,23,585,42,82792
"West Easton borough, Pennsylvania",589,576,13,1146,42,82832
"West Elizabeth borough, Pennsylvania",263,239,24,456,42,82848
"West Fairview CDP, Pennsylvania",764,737,27,1250,42,82920
"West Falls CDP, Pennsylvania",147,134,13,308,42,82952
"Westfield borough, Pennsylvania",511,480,31,1258,42,82968
"West Grove borough, Pennsylvania",1601,1536,65,2784,42,83104
"West Hamburg CDP, Pennsylvania",1073,1073,0,1913,42,83120
"West Hazleton borough, Pennsylvania",2389,2256,133,5130,42,83136
"West Hills CDP, Pennsylvania",703,652,51,1424,42,83172
"West Homestead borough, Pennsylvania",1002,931,71,1747,42,83200
"West Kittanning borough, Pennsylvania",681,646,35,1243,42,83248
"Westland CDP, Pennsylvania",27,27,0,39,42,83272
"West Lawn CDP, Pennsylvania",868,799,69,1481,42,83280
"West Leechburg borough, Pennsylvania",666,638,28,1260,42,83328
"West Liberty borough, Pennsylvania",141,128,13,297,42,83376
"West Mayfield borough, Pennsylvania",688,627,61,1270,42,83472
"West Middlesex borough, Pennsylvania",607,564,43,1097,42,83496
"West Middletown borough, Pennsylvania",38,38,0,75,42,83504
"West Mifflin borough, Pennsylvania",10255,9347,908,19506,42,83512
"West Milton CDP, Pennsylvania",164,164,0,657,42,83520
"Westmont borough, Pennsylvania",2371,2137,234,4964,42,83584
"West Nanticoke CDP, Pennsylvania",254,252,2,528,42,83656
"West Newton borough, Pennsylvania",1137,1053,84,2652,42,83680
"Weston CDP, Pennsylvania",240,240,0,484,42,83720
"Westover borough, Pennsylvania",162,134,28,362,42,83736
"West Pittsburg CDP, Pennsylvania",332,311,21,844,42,83848
"West Pittston borough, Pennsylvania",2640,2588,52,4664,42,83856
"West Reading borough, Pennsylvania",2138,2104,34,4533,42,83928
"West Sunbury borough, Pennsylvania",114,114,0,220,42,84064
"West View borough, Pennsylvania",4258,4067,191,6660,42,84144
"West Waynesburg CDP, Pennsylvania",293,293,0,453,42,84176
"Westwood CDP (Cambria County), Pennsylvania",711,672,39,1480,42,84240
"Westwood CDP (Chester County), Pennsylvania",1078,1041,37,1559,42,84248
"West Wyoming borough, Pennsylvania",1316,1241,75,2640,42,84272
"West Wyomissing CDP, Pennsylvania",1696,1675,21,3267,42,84280
"West York borough, Pennsylvania",2721,2565,156,5069,42,84288
"Wheatland borough, Pennsylvania",289,277,12,506,42,84376
"Whitaker borough, Pennsylvania",709,628,81,1232,42,84440
"Whitehall borough, Pennsylvania",7561,7185,376,14909,42,84512
"White Haven borough, Pennsylvania",466,453,13,1068,42,84552
"White Mills CDP, Pennsylvania",409,382,27,746,42,84696
"White Oak borough, Pennsylvania",3630,3378,252,7585,42,84704
"Whitfield CDP, Pennsylvania",2976,2916,60,5269,42,84856
"Wickerham Manor-Fisher CDP, Pennsylvania",694,694,0,1398,42,84931
"Wiconsico CDP, Pennsylvania",343,315,28,784,42,84968
"Wilburton Number One CDP, Pennsylvania",176,158,18,379,42,85076
"Wilburton Number Two CDP, Pennsylvania",21,21,0,57,42,85078
"Wilcox CDP, Pennsylvania",197,183,14,404,42,85088
"Wilkes-Barre city, Pennsylvania",20153,18456,1697,44123,42,85152
"Wilkinsburg borough, Pennsylvania",7409,6778,631,14340,42,85188
"Williamsburg borough, Pennsylvania",532,509,23,1202,42,85272
"Williamsport city, Pennsylvania",13461,12585,876,27755,42,85312
"Williamstown borough, Pennsylvania",521,494,27,1162,42,85320
"Willow Grove CDP, Pennsylvania",7697,7498,199,13759,42,85408
"Willow Street CDP, Pennsylvania",4230,4150,80,9640,42,85464
"Wilmerding borough, Pennsylvania",953,827,126,1834,42,85496
"Wilmore borough, Pennsylvania",152,150,2,390,42,85528
"Wilson borough, Pennsylvania",4429,4275,154,8208,42,85592
"Windber borough, Pennsylvania",2012,1960,52,3930,42,85632
"Wind Gap borough, Pennsylvania",1745,1611,134,3042,42,85664
"Wind Ridge CDP, Pennsylvania",74,67,7,194,42,85712
"Windsor borough, Pennsylvania",601,552,49,1330,42,85728
"Winfield CDP, Pennsylvania",377,373,4,849,42,85792
"Winterstown borough, Pennsylvania",269,254,15,505,42,85872
"Witmer CDP, Pennsylvania",148,148,0,247,42,85968
"Wolfdale CDP, Pennsylvania",1544,1452,92,3054,42,86000
"Womelsdorf borough, Pennsylvania",1538,1472,66,2883,42,86056
"Woodbourne CDP, Pennsylvania",2027,1938,89,3348,42,86112
"Woodbury borough, Pennsylvania",170,152,18,391,42,86128
"Woodcock borough, Pennsylvania",67,64,3,132,42,86160
"Woodland Heights CDP, Pennsylvania",468,362,106,1326,42,86224
"Woodlyn CDP, Pennsylvania",5412,5136,276,10347,42,86288
"Woodside CDP, Pennsylvania",1397,1185,212,2653,42,86352
"Woodward CDP, Pennsylvania",44,37,7,80,42,86432
"Woolrich CDP, Pennsylvania",347,325,22,582,42,86472
"Wopsononock CDP, Pennsylvania",107,107,0,161,42,86480
"Wormleysburg borough, Pennsylvania",1890,1725,165,3060,42,86528
"Worthington borough, Pennsylvania",320,312,8,517,42,86560
"Worthville borough, Pennsylvania",40,40,0,59,42,86568
"Woxall CDP, Pennsylvania",814,814,0,1392,42,86576
"Wrightsville borough, Pennsylvania",1182,1147,35,2204,42,86640
"Wyalusing borough, Pennsylvania",262,260,2,666,42,86656
"Wyano CDP, Pennsylvania",286,244,42,442,42,86672
"Wylandville CDP, Pennsylvania",291,291,0,529,42,86712
"Wyncote CDP, Pennsylvania",1569,1553,16,3420,42,86744
"Wyndmoor CDP, Pennsylvania",2715,2575,140,5698,42,86776
"Wyoming borough, Pennsylvania",1806,1745,61,3107,42,86856
"Wyomissing borough, Pennsylvania",5677,5475,202,11067,42,86880
"Yardley borough, Pennsylvania",1587,1469,118,2591,42,86920
"Yarnell CDP, Pennsylvania",97,97,0,126,42,86936
"Yatesville borough, Pennsylvania",406,392,14,739,42,86952
"Yeadon borough, Pennsylvania",6580,6105,475,12017,42,86968
"Yeagertown CDP, Pennsylvania",710,676,34,1220,42,86976
"Yellow Springs CDP, Pennsylvania",52,46,6,124,42,87006
"Yoe borough, Pennsylvania",664,651,13,1096,42,87040
"York city, Pennsylvania",22724,20006,2718,44782,42,87048
"Yorkana borough, Pennsylvania",118,109,9,221,42,87064
"York Haven borough, Pennsylvania",420,397,23,762,42,87080
"Yorklyn CDP, Pennsylvania",875,875,0,1637,42,87088
"York Springs borough, Pennsylvania",423,401,22,922,42,87136
"Youngstown borough, Pennsylvania",149,133,16,251,42,87208
"Youngsville borough, Pennsylvania",720,655,65,1521,42,87224
"Youngwood borough, Pennsylvania",1748,1748,0,2955,42,87232
"Yukon CDP, Pennsylvania",221,221,0,610,42,87240
"Zelienople borough, Pennsylvania",2098,2098,0,3870,42,87272
"Zion CDP, Pennsylvania",1530,1383,147,2273,42,87320
"Ashaway CDP, Rhode Island",1031,1031,0,1662,44,03520
"Bradford CDP, Rhode Island",668,567,101,1189,44,08020
"Carolina CDP, Rhode Island",586,550,36,1165,44,12340
"Central Falls city, Rhode Island",10537,9666,871,22359,44,14140
"Charlestown CDP, Rhode Island",847,769,78,1702,44,14320
"Chepachet CDP, Rhode Island",1022,1022,0,1755,44,14860
"Clayville CDP, Rhode Island",35,35,0,102,44,15940
"Cranston city, Rhode Island",44135,41681,2454,82691,44,19180
"Cumberland Hill CDP, Rhode Island",5346,5214,132,8866,44,20260
"East Providence city, Rhode Island",25793,24351,1442,47012,44,22960
"Foster Center CDP, Rhode Island",121,121,0,343,44,27640
"Greene CDP, Rhode Island",469,456,13,1070,44,31240
"Greenville CDP, Rhode Island",4265,4120,145,8777,44,31600
"Harmony CDP, Rhode Island",851,821,30,1442,44,33040
"Harrisville CDP, Rhode Island",791,746,45,1515,44,33400
"Hope Valley CDP, Rhode Island",1152,1055,97,2209,44,34660
"Hopkinton CDP, Rhode Island",160,143,17,421,44,35200
"Kingston CDP, Rhode Island",2450,2180,270,6560,44,38980
"Melville CDP, Rhode Island",670,656,14,1918,44,45010
"Misquamicut CDP, Rhode Island",140,140,0,379,44,46000
"Narragansett Pier CDP, Rhode Island",1519,1343,176,2805,44,48700
"Newport city, Rhode Island",12731,11452,1279,25087,44,49960
"Newport East CDP, Rhode Island",6326,5960,366,11644,44,50140
"Pascoag CDP, Rhode Island",2348,2167,181,4527,44,54460
"Pawtucket city, Rhode Island",43130,40235,2895,75176,44,54640
"Providence city, Rhode Island",97689,90680,7009,189715,44,59000
"Quonochontaug CDP, Rhode Island",220,192,28,452,44,60260
"Tiverton CDP, Rhode Island",4647,4490,157,8101,44,70700
"Valley Falls CDP, Rhode Island",7240,7035,205,12072,44,72500
"Wakefield-Peace Dale CDP, Rhode Island",5751,5297,454,9966,44,73132
"Warwick city, Rhode Island",45253,42928,2325,82783,44,74300
"Watch Hill CDP, Rhode Island",145,91,54,311,44,75200
"Weekapaug CDP, Rhode Island",263,263,0,522,44,75920
"Westerly CDP, Rhode Island",10208,9545,663,18272,44,76820
"Woonsocket city, Rhode Island",21366,19457,1909,43029,44,80780
"Wyoming CDP, Rhode Island",112,112,0,318,44,80960
"Abbeville city, South Carolina",1974,1881,93,4892,45,00100
"Abney Crossroads CDP, South Carolina",21,21,0,21,45,00165
"Adams Run CDP, South Carolina",224,224,0,447,45,00370
"Aiken city, South Carolina",14773,14197,576,32014,45,00550
"Alcolu CDP, South Carolina",106,106,0,385,45,00775
"Allendale town, South Carolina",845,767,78,2702,45,00955
"Anderson city, South Carolina",13775,12823,952,29345,45,01360
"Andrews town, South Carolina",1730,1720,10,3617,45,01450
"Antreville CDP, South Carolina",76,76,0,286,45,01810
"Arcadia CDP, South Carolina",1477,1300,177,2846,45,02080
"Arcadia Lakes town, South Carolina",455,451,4,871,45,02125
"Arial CDP, South Carolina",789,779,10,1750,45,02440
"Arkwright CDP, South Carolina",1162,1022,140,2589,45,02530
"Arthurtown CDP, South Carolina",1406,1271,135,3007,45,02665
"Ashwood CDP, South Carolina",40,30,10,63,45,03115
"Atlantic Beach town, South Carolina",187,172,15,332,45,03205
"Awendaw town, South Carolina",748,654,94,1548,45,03385
"Aynor town, South Carolina",507,496,11,989,45,03430
"Bamberg town, South Carolina",1163,1034,129,3074,45,03790
"Barnwell city, South Carolina",1917,1680,237,4643,45,04060
"Batesburg-Leesville town, South Carolina",2271,2195,76,5004,45,04300
"Baxter Village CDP, South Carolina",2092,2028,64,4419,45,04528
"Beaufort city, South Carolina",5917,5678,239,13582,45,04690
"Beech Island CDP, South Carolina",599,575,24,1361,45,04915
"Belton city, South Carolina",2171,2062,109,4357,45,05365
"Belvedere CDP, South Carolina",2825,2645,180,5786,45,05410
"Ben Avon CDP, South Carolina",1205,1150,55,2161,45,05545
"Bennettsville city, South Carolina",2727,2551,176,6975,45,05680
"Berea CDP, South Carolina",7909,7366,543,16184,45,05770
"Bethune town, South Carolina",160,148,12,454,45,06040
"Bishopville city, South Carolina",1169,1122,47,2986,45,06310
"Blacksburg town, South Carolina",855,753,102,2115,45,06400
"Blackville town, South Carolina",968,934,34,2034,45,06490
"Blenheim town, South Carolina",29,29,0,63,45,06850
"Bluffton town, South Carolina",14017,13815,202,29375,45,07210
"Blythewood town, South Carolina",2571,2472,99,4890,45,07255
"Boiling Springs CDP, South Carolina",5477,5262,215,11191,45,07345
"Bonneau town, South Carolina",220,188,32,582,45,07525
"Bonneau Beach CDP, South Carolina",488,488,0,1500,45,07535
"Bowman town, South Carolina",201,196,5,652,45,07840
"Boykin CDP, South Carolina",102,102,0,109,45,08110
"Bradley CDP, South Carolina",32,32,0,163,45,08155
"Branchville town, South Carolina",598,533,65,1301,45,08245
"Briarcliffe Acres town, South Carolina",235,233,2,568,45,08830
"Brookdale CDP, South Carolina",1719,1499,220,4069,45,09527
"Browntown CDP, South Carolina",15,15,0,90,45,09782
"Brunson town, South Carolina",243,228,15,525,45,09865
"Bucksport CDP, South Carolina",421,385,36,744,45,10000
"Buffalo CDP, South Carolina",438,391,47,1159,45,10090
"Buford CDP, South Carolina",273,258,15,523,45,10135
"Burnettown town, South Carolina",1091,1022,69,3052,45,10270
"Burton CDP, South Carolina",3621,3571,50,7603,45,10360
"Caesars Head CDP, South Carolina",13,13,0,42,45,10585
"Calhoun Falls town, South Carolina",799,775,24,1939,45,10720
"Camden city, South Carolina",3648,3537,111,7834,45,10855
"Cameron town, South Carolina",226,211,15,486,45,10900
"Camp Croft CDP, South Carolina",776,623,153,1693,45,11035
"Campobello town, South Carolina",449,435,14,866,45,11125
"Cane Savannah CDP, South Carolina",988,880,108,1534,45,11350
"Capitol View CDP, South Carolina",2007,1646,361,3491,45,11620
"Carlisle town, South Carolina",365,332,33,526,45,11755
"Carolina Forest CDP, South Carolina",12376,11200,1176,24823,45,11833
"Cash CDP, South Carolina",138,133,5,417,45,12205
"Catawba CDP, South Carolina",788,689,99,1439,45,12430
"Cateechee CDP, South Carolina",373,299,74,973,45,12520
"Cayce city, South Carolina",7575,7168,407,13755,45,12655
"Centenary CDP, South Carolina",208,180,28,585,45,12925
"Centerville CDP, South Carolina",4204,4138,66,7217,45,12965
"Central town, South Carolina",2442,2331,111,5272,45,13015
"Central Pacolet town, South Carolina",65,65,0,194,45,13060
"Chapin town, South Carolina",832,755,77,1543,45,13150
"Charleston city, South Carolina",84769,81674,3095,149960,45,13330
"Cheraw town, South Carolina",2276,1874,402,5056,45,13600
"Cherokee Falls CDP, South Carolina",14,14,0,30,45,13735
"Cherryvale CDP, South Carolina",1528,1121,407,2843,45,14018
"Chesnee city, South Carolina",349,329,20,597,45,14050
"Chester city, South Carolina",2341,2102,239,5260,45,14095
"Chesterfield town, South Carolina",578,524,54,1424,45,14140
"Chickasaw Point CDP, South Carolina",210,185,25,603,45,14230
"City View CDP, South Carolina",543,507,36,1696,45,14455
"Clarks Hill CDP, South Carolina",20,20,0,78,45,14590
"Clearwater CDP, South Carolina",1918,1665,253,3403,45,14860
"Clemson city, South Carolina",8903,8520,383,17557,45,14950
"Clemson University CDP, South Carolina",1660,1381,279,6217,45,15040
"Clifton CDP, South Carolina",370,325,45,962,45,15220
"Clinton city, South Carolina",3211,2961,250,7624,45,15295
"Clio town, South Carolina",273,271,2,679,45,15310
"Clover town, South Carolina",3316,3021,295,6800,45,15355
"Cokesbury CDP, South Carolina",155,155,0,376,45,15625
"Columbia city, South Carolina",67915,62557,5358,136754,45,16000
"Conestee CDP, South Carolina",562,480,82,1212,45,16180
"Converse CDP, South Carolina",144,144,0,241,45,16360
"Conway city, South Carolina",10428,9506,922,25121,45,16405
"Coosawhatchie CDP, South Carolina",0,0,0,10,45,16675
"Cope town, South Carolina",13,11,2,28,45,16720
"Cordova town, South Carolina",87,84,3,214,45,16855
"Coronaca CDP, South Carolina",32,32,0,32,45,16945
"Cottageville town, South Carolina",567,551,16,1144,45,16990
"Coward town, South Carolina",249,239,10,568,45,17215
"Cowpens town, South Carolina",897,871,26,1862,45,17260
"Cross Anchor CDP, South Carolina",0,0,0,25,45,17845
"Cross Hill town, South Carolina",217,217,0,522,45,17890
"Dacusville CDP, South Carolina",70,70,0,218,45,18250
"Dale CDP, South Carolina",453,453,0,957,45,18340
"Dalzell CDP, South Carolina",1496,1357,139,3417,45,18430
"Danwood CDP, South Carolina",241,241,0,470,45,18475
"Darlington city, South Carolina",2362,2151,211,6172,45,18565
"Daufuskie Island CDP, South Carolina",340,340,0,569,45,18610
"Daviston CDP, South Carolina",95,93,2,246,45,18706
"DeBordieu Colony CDP, South Carolina",223,212,11,696,45,18810
"Denmark city, South Carolina",1087,910,177,3156,45,19105
"Dentsville CDP, South Carolina",8419,7784,635,16399,45,19285
"Dillon city, South Carolina",2675,2572,103,6454,45,19420
"Donalds town, South Carolina",143,137,6,374,45,19870
"Dovesville CDP, South Carolina",257,244,13,948,45,20365
"Drayton CDP, South Carolina",435,435,0,1011,45,20590
"Due West town, South Carolina",490,394,96,1148,45,21040
"Dunbar CDP, South Carolina",326,326,0,1059,45,21130
"Duncan town, South Carolina",2026,1963,63,4053,45,21265
"Dunean CDP, South Carolina",2032,1857,175,3427,45,21310
"Easley city, South Carolina",11633,11193,440,23135,45,21985
"East Camden CDP, South Carolina",1322,1322,0,3584,45,22050
"East Gaffney CDP, South Carolina",1167,1125,42,2972,45,22075
"Eastover town, South Carolina",239,209,30,616,45,22390
"East Sumter CDP, South Carolina",356,356,0,789,45,22547
"Edgefield town, South Carolina",1199,996,203,2504,45,22795
"Edisto CDP, South Carolina",931,870,61,1904,45,22997
"Edisto Beach town, South Carolina",349,333,16,884,45,23020
"Edmund CDP, South Carolina",570,514,56,1149,45,23110
"Ehrhardt town, South Carolina",83,83,0,462,45,23200
"Elgin town, South Carolina",1101,1030,71,2065,45,23245
"Elgin CDP, South Carolina",1498,1462,36,2882,45,23290
"Elko town, South Carolina",120,48,72,213,45,23335
"Elliott CDP, South Carolina",147,139,8,558,45,23425
"Elloree town, South Carolina",255,215,40,993,45,23470
"Enoree CDP, South Carolina",227,199,28,441,45,23605
"Estill town, South Carolina",1055,923,132,2230,45,23830
"Eureka Mill CDP, South Carolina",929,840,89,1889,45,24020
"Eutawville town, South Carolina",190,176,14,396,45,24100
"Fairfax town, South Carolina",912,776,136,2035,45,24370
"Fairforest CDP, South Carolina",807,740,67,1626,45,24505
"Fair Play CDP, South Carolina",296,284,12,574,45,24730
"Fairview Crossroads CDP, South Carolina",229,163,66,588,45,24865
"Fingerville CDP, South Carolina",0,0,0,99,45,25360
"Finklea CDP, South Carolina",227,156,71,519,45,25405
"Five Forks CDP, South Carolina",8962,8644,318,18592,45,25540
"Florence city, South Carolina",18726,17825,901,39931,45,25810
"Floydale CDP, South Carolina",125,88,37,139,45,25945
"Folly Beach city, South Carolina",490,490,0,1020,45,26035
"Forest Acres city, South Carolina",5004,4792,212,10514,45,26305
"Forestbrook CDP, South Carolina",3724,3503,221,7414,45,26372
"Foreston CDP, South Carolina",80,60,20,133,45,26485
"Fort Lawn town, South Carolina",531,483,48,1149,45,26845
"Fort Mill town, South Carolina",13343,13033,310,26022,45,26890
"Fountain Inn city, South Carolina",5336,4826,510,10675,45,27070
"Fripp Island CDP, South Carolina",284,284,0,767,45,27565
"Furman town, South Carolina",256,217,39,559,45,27835
"Gadsden CDP, South Carolina",516,414,102,1373,45,27970
"Gaffney city, South Carolina",5469,4954,515,12651,45,28060
"Gantt CDP, South Carolina",6804,6221,583,14276,45,28375
"Garden City CDP, South Carolina",4498,4386,112,10885,45,28455
"Gaston town, South Carolina",1049,1029,20,1991,45,28780
"Gayle Mill CDP, South Carolina",553,547,6,1082,45,28825
"Georgetown city, South Carolina",4098,3722,376,8465,45,28870
"Gifford town, South Carolina",89,86,3,201,45,29005
"Gilbert town, South Carolina",295,279,16,563,45,29050
"Gillisonville CDP, South Carolina",133,133,0,319,45,29140
"Glendale CDP, South Carolina",180,163,17,254,45,29275
"Glenn Springs CDP, South Carolina",63,63,0,187,45,29320
"Gloverville CDP, South Carolina",1327,1218,109,3099,45,29410
"Golden Grove CDP, South Carolina",1874,1857,17,3282,45,29635
"Goose Creek city, South Carolina",21894,21142,752,45858,45,29815
"Govan town, South Carolina",32,30,2,56,45,29950
"Gramling CDP, South Carolina",63,63,0,79,45,30220
"Graniteville CDP, South Carolina",904,842,62,2465,45,30265
"Gray Court town, South Carolina",381,339,42,778,45,30355
"Great Falls town, South Carolina",576,529,47,1669,45,30490
"Greeleyville town, South Carolina",148,145,3,418,45,30535
"Green Sea CDP, South Carolina",0,0,0,63,45,30760
"Greenville city, South Carolina",40753,39199,1554,70838,45,30850
"Greenwood city, South Carolina",9621,8916,705,22528,45,30895
"Greer city, South Carolina",19238,18566,672,37010,45,30985
"Grover CDP, South Carolina",176,142,34,419,45,31210
"Hamer CDP, South Carolina",417,340,77,760,45,31660
"Hampton town, South Carolina",1177,1036,141,2725,45,31885
"Hanahan city, South Carolina",10367,10152,215,20731,45,32065
"Harbor Island CDP, South Carolina",68,64,4,277,45,32172
"Hardeeville city, South Carolina",3553,3235,318,8048,45,32245
"Harleyville town, South Carolina",427,399,28,879,45,32335
"Hartsville city, South Carolina",3120,2832,288,7450,45,32560
"Heath Springs town, South Carolina",357,326,31,800,45,32965
"Helena CDP, South Carolina",274,251,23,484,45,33100
"Hemingway town, South Carolina",160,154,6,421,45,33145
"Hickory Grove town, South Carolina",242,236,6,541,45,33640
"Hilda town, South Carolina",161,149,12,430,45,33820
"Hilltop CDP, South Carolina",1285,1227,58,3253,45,33977
"Hilton Head Island town, South Carolina",16339,15878,461,37708,45,34045
"Hodges town, South Carolina",65,59,6,173,45,34225
"Holly Hill town, South Carolina",356,333,23,1384,45,34360
"Hollywood town, South Carolina",2542,2421,121,5397,45,34495
"Homeland Park CDP, South Carolina",3543,3076,467,7451,45,34720
"Homewood CDP, South Carolina",523,523,0,1290,45,34765
"Honea Path town, South Carolina",1369,1269,100,3662,45,34810
"Hopkins CDP, South Carolina",938,826,112,1738,45,34990
"India Hook CDP, South Carolina",2622,2484,138,4385,45,35635
"Inman city, South Carolina",1413,1358,55,2987,45,35755
"Inman Mills CDP, South Carolina",355,355,0,956,45,35800
"Irmo town, South Carolina",6419,6124,295,11685,45,35890
"Irwin CDP, South Carolina",854,755,99,1868,45,35980
"Islandton CDP, South Carolina",15,15,0,40,45,36070
"Isle of Palms city, South Carolina",1916,1902,14,4347,45,36115
"Iva town, South Carolina",383,318,65,1030,45,36160
"Jackson town, South Carolina",782,754,28,1882,45,36205
"Jacksonboro CDP, South Carolina",135,135,0,270,45,36250
"James Island town, South Carolina",6543,6432,111,11689,45,36430
"Jamestown town, South Carolina",47,47,0,78,45,36475
"Jefferson town, South Carolina",401,362,39,830,45,36610
"Jenkinsville town, South Carolina",21,21,0,54,45,36655
"Joanna CDP, South Carolina",627,627,0,1406,45,36790
"Johnsonville city, South Carolina",420,406,14,1108,45,37105
"Johnston town, South Carolina",1021,954,67,2375,45,37150
"Jonesville town, South Carolina",454,426,28,925,45,37330
"Judson CDP, South Carolina",744,581,163,1879,45,37465
"Keowee Key CDP, South Carolina",768,768,0,3059,45,38058
"Kershaw town, South Carolina",997,969,28,2311,45,38095
"Ketchuptown CDP, South Carolina",5,5,0,5,45,38110
"Kiawah Island town, South Carolina",688,662,26,2130,45,38162
"Kingstree town, South Carolina",1096,1031,65,3202,45,38590
"Kline town, South Carolina",74,70,4,195,45,38950
"Ladson CDP, South Carolina",6958,6535,423,15298,45,39220
"La France CDP, South Carolina",553,553,0,991,45,39265
"Lake City city, South Carolina",2940,2686,254,6080,45,39310
"Lake Murray of Richland CDP, South Carolina",3418,3268,150,6914,45,39475
"Lake Secession CDP, South Carolina",479,446,33,1246,45,39512
"Lake View town, South Carolina",253,244,9,702,45,39715
"Lakewood CDP, South Carolina",1826,1669,157,3135,45,39772
"Lake Wylie CDP, South Carolina",7522,7109,413,14382,45,39785
"Lamar town, South Carolina",557,547,10,1217,45,39805
"Lancaster city, South Carolina",3890,3374,516,8592,45,39895
"Landrum city, South Carolina",1082,1037,45,2504,45,40075
"Lane town, South Carolina",179,169,10,539,45,40210
"Langley CDP, South Carolina",732,647,85,1776,45,40390
"Latta town, South Carolina",699,607,92,1519,45,40480
"Laurel Bay CDP, South Carolina",1853,1810,43,5513,45,40525
"Laurens city, South Carolina",3943,3806,137,9276,45,40615
"Lesslie CDP, South Carolina",1579,1488,91,3114,45,41065
"Lexington town, South Carolina",11551,11135,416,23665,45,41335
"Liberty city, South Carolina",1543,1386,157,3329,45,41380
"Lincolnville town, South Carolina",247,222,25,641,45,41740
"Litchfield Beach CDP, South Carolina",3109,3089,20,8908,45,41830
"Little Mountain town, South Carolina",218,216,2,456,45,41965
"Little River CDP, South Carolina",3861,3692,169,9815,45,42010
"Little Rock CDP, South Carolina",201,192,9,525,45,42055
"Live Oak CDP, South Carolina",0,0,0,9,45,42095
"Livingston town, South Carolina",52,51,1,149,45,42100
"Lobeco CDP, South Carolina",132,113,19,196,45,42145
"Lockhart town, South Carolina",160,141,19,459,45,42190
"Lodge town, South Carolina",37,35,2,170,45,42280
"Longcreek CDP, South Carolina",0,0,0,29,45,42460
"Loris city, South Carolina",946,867,79,2513,45,42730
"Lowndesville town, South Carolina",59,59,0,184,45,42820
"Lowrys town, South Carolina",112,108,4,297,45,42865
"Lugoff CDP, South Carolina",4137,3983,154,9423,45,43000
"Luray town, South Carolina",115,104,11,176,45,43090
"Lydia CDP, South Carolina",68,25,43,227,45,43135
"Lyman town, South Carolina",3063,2946,117,6099,45,43315
"Lynchburg town, South Carolina",55,38,17,247,45,43360
"McBee town, South Carolina",326,309,17,1046,45,43495
"McClellanville town, South Carolina",290,287,3,770,45,43585
"McColl town, South Carolina",762,708,54,2304,45,43630
"McConnells town, South Carolina",166,159,7,323,45,43675
"McCormick town, South Carolina",618,596,22,2760,45,43720
"Manning city, South Carolina",1360,1238,122,3862,45,44350
"Manville CDP, South Carolina",210,210,0,658,45,44395
"Marion city, South Carolina",2406,2271,135,6402,45,44575
"Mauldin city, South Carolina",14427,13708,719,25267,45,45115
"Mayesville town, South Carolina",307,304,3,670,45,45295
"Mayo CDP, South Carolina",1116,1079,37,1925,45,45430
"Meggett town, South Carolina",704,698,6,1348,45,45790
"Modoc CDP, South Carolina",248,248,0,602,45,47050
"Monarch Mill CDP, South Carolina",683,634,49,1766,45,47200
"Moncks Corner town, South Carolina",6993,6826,167,13456,45,47275
"Monetta town, South Carolina",92,88,4,184,45,47320
"Mount Carmel CDP, South Carolina",187,159,28,379,45,48310
"Mount Croghan town, South Carolina",66,66,0,177,45,48355
"Mount Pleasant town, South Carolina",48849,47265,1584,90945,45,48535
"Mountville CDP, South Carolina",97,97,0,135,45,48670
"Mulberry CDP, South Carolina",86,84,2,184,45,48737
"Mullins city, South Carolina",1630,1476,154,4014,45,48805
"Murphys Estates CDP, South Carolina",681,656,25,1477,45,48900
"Murrells Inlet CDP, South Carolina",4592,4451,141,10297,45,48985
"Myrtle Beach city, South Carolina",18517,17733,784,36064,45,49075
"Neeses town, South Carolina",141,140,1,370,45,49390
"Newberry city, South Carolina",4540,4194,346,10682,45,49570
"New Ellenton town, South Carolina",1320,1264,56,2508,45,49705
"Newport CDP, South Carolina",2398,2389,9,4226,45,49885
"Newry CDP, South Carolina",32,32,0,341,45,49975
"Newtown CDP, South Carolina",309,237,72,769,45,50020
"Nichols town, South Carolina",73,70,3,160,45,50110
"Ninety Six town, South Carolina",1124,1043,81,2579,45,50290
"Norris town, South Carolina",317,299,18,737,45,50515
"North town, South Carolina",366,338,28,916,45,50560
"North Augusta city, South Carolina",13050,12560,490,24425,45,50695
"North Charleston city, South Carolina",60125,57564,2561,115755,45,50875
"North Hartsville CDP, South Carolina",1679,1664,15,3261,45,51145
"Northlake CDP, South Carolina",1842,1739,103,3989,45,51180
"North Myrtle Beach city, South Carolina",8429,7889,540,18850,45,51280
"North Santee CDP, South Carolina",147,147,0,470,45,51367
"Norway town, South Carolina",158,131,27,325,45,51550
"Oak Grove CDP, South Carolina",6185,5820,365,11385,45,51720
"Oakland CDP, South Carolina",323,296,27,958,45,51887
"Olanta town, South Carolina",255,231,24,588,45,52540
"Olar town, South Carolina",58,54,4,179,45,52585
"Olympia CDP, South Carolina",562,530,32,1226,45,52900
"Orangeburg city, South Carolina",5713,5000,713,13220,45,53080
"Oswego CDP, South Carolina",101,101,0,352,45,53485
"Pacolet town, South Carolina",923,858,65,1970,45,53845
"Pageland town, South Carolina",1140,1058,82,2726,45,54025
"Pamplico town, South Carolina",480,449,31,1073,45,54340
"Parker CDP, South Carolina",6077,5786,291,12466,45,54535
"Parksville town, South Carolina",41,39,2,104,45,54700
"Patrick town, South Carolina",185,158,27,500,45,54925
"Pauline CDP, South Carolina",123,123,0,229,45,54970
"Pawleys Island town, South Carolina",28,28,0,104,45,55015
"Paxville town, South Carolina",182,170,12,342,45,55060
"Peak town, South Carolina",17,17,0,79,45,55150
"Pelion town, South Carolina",488,478,10,1056,45,55420
"Pelzer town, South Carolina",507,444,63,1480,45,55465
"Pendleton town, South Carolina",1874,1820,54,3498,45,55645
"Perry town, South Carolina",114,113,1,288,45,55960
"Pickens city, South Carolina",1429,1407,22,3374,45,56140
"Piedmont CDP, South Carolina",2277,2034,243,5510,45,56365
"Pimlico CDP, South Carolina",1422,1422,0,2232,45,56545
"Pine Ridge CDP, South Carolina",282,282,0,640,45,56905
"Pine Ridge town, South Carolina",1276,1188,88,2687,45,56950
"Pinewood town, South Carolina",238,223,15,790,45,57085
"Pinopolis CDP, South Carolina",375,375,0,933,45,57175
"Plum Branch town, South Carolina",47,45,2,76,45,57670
"Pomaria town, South Carolina",43,43,0,91,45,57850
"Port Royal town, South Carolina",5458,5371,87,14573,45,58030
"Powdersville CDP, South Carolina",5767,5574,193,10678,45,58170
"Princeton CDP, South Carolina",72,72,0,78,45,58435
"Privateer CDP, South Carolina",878,780,98,2191,45,58570
"Promised Land CDP, South Carolina",282,282,0,334,45,58615
"Prosperity town, South Carolina",561,546,15,1139,45,58705
"Quinby town, South Carolina",385,371,14,897,45,58795
"Rains CDP, South Carolina",85,85,0,98,45,58930
"Ravenel town, South Carolina",1272,1251,21,2572,45,59020
"Red Bank CDP, South Carolina",5514,5201,313,10544,45,59110
"Red Hill CDP, South Carolina",6977,6540,437,15585,45,59190
"Reevesville town, South Carolina",119,116,3,272,45,59380
"Reidville town, South Carolina",974,930,44,1734,45,59425
"Rembert CDP, South Carolina",101,101,0,255,45,59470
"Richburg town, South Carolina",162,137,25,354,45,59920
"Ridgeland town, South Carolina",1607,1575,32,3737,45,60280
"Ridge Spring town, South Carolina",335,330,5,720,45,60325
"Ridgeville town, South Carolina",186,171,15,1548,45,60370
"Ridgeway town, South Carolina",131,129,2,251,45,60415
"Riverview CDP, South Carolina",1359,1138,221,2010,45,61112
"Rock Hill city, South Carolina",39751,37636,2115,74170,45,61405
"Rockville town, South Carolina",41,41,0,113,45,61495
"Roebuck CDP, South Carolina",2298,2255,43,3837,45,61720
"Rowesville town, South Carolina",152,148,4,388,45,62035
"Ruby town, South Carolina",135,134,1,359,45,62080
"Russellville CDP, South Carolina",62,62,0,280,45,62305
"St. Andrews CDP, South Carolina",11835,10810,1025,21909,45,62395
"St. Charles CDP, South Carolina",18,18,0,75,45,62485
"St. George town, South Carolina",636,631,5,1901,45,62530
"St. Matthews town, South Carolina",782,647,135,1932,45,62620
"St. Stephen town, South Carolina",405,371,34,1386,45,62755
"Salem town, South Carolina",51,51,0,145,45,62980
"Salley town, South Carolina",83,74,9,297,45,63115
"Saluda town, South Carolina",1190,1135,55,3124,45,63250
"Sandy Springs CDP, South Carolina",525,525,0,873,45,63655
"Sangaree CDP, South Carolina",4964,4829,135,8680,45,63665
"Sans Souci CDP, South Carolina",4468,4265,203,8042,45,63700
"Santee town, South Carolina",601,595,6,1189,45,63790
"Saxon CDP, South Carolina",1779,1573,206,4171,45,64240
"Scotia town, South Carolina",54,44,10,111,45,64465
"Scranton town, South Carolina",345,341,4,897,45,64600
"Seabrook CDP, South Carolina",462,429,33,1087,45,64690
"Seabrook Island town, South Carolina",667,662,5,2062,45,64712
"Sellers town, South Carolina",36,36,0,133,45,65005
"Seneca city, South Carolina",4362,3882,480,8834,45,65095
"Seven Oaks CDP, South Carolina",8722,8257,465,15826,45,65207
"Sharon town, South Carolina",195,192,3,411,45,65410
"Sheldon CDP, South Carolina",115,115,0,439,45,65590
"Shell Point CDP, South Carolina",962,877,85,2026,45,65680
"Shiloh CDP, South Carolina",129,126,3,195,45,65950
"Silverstreet town, South Carolina",62,59,3,147,45,66400
"Simpsonville city, South Carolina",13169,12797,372,24133,45,66580
"Six Mile town, South Carolina",510,478,32,1086,45,66760
"Slater-Marietta CDP, South Carolina",990,936,54,2199,45,66917
"Smoaks town, South Carolina",55,54,1,125,45,67165
"Smyrna town, South Carolina",10,10,0,28,45,67210
"Snelling town, South Carolina",135,133,2,262,45,67255
"Socastee CDP, South Carolina",11921,11267,654,24464,45,67390
"Society Hill town, South Carolina",236,236,0,415,45,67435
"South Congaree town, South Carolina",1263,1230,33,2256,45,67705
"Southern Shops CDP, South Carolina",1865,1748,117,3856,45,67750
"South Sumter CDP, South Carolina",718,661,57,1564,45,68177
"South Union CDP, South Carolina",134,133,1,383,45,68210
"Spartanburg city, South Carolina",17840,16498,1342,38301,45,68290
"Springdale CDP, South Carolina",1504,1435,69,2580,45,68380
"Springdale town, South Carolina",1389,1333,56,2711,45,68425
"Springfield town, South Carolina",151,135,16,482,45,68470
"Starr town, South Carolina",79,71,8,194,45,68875
"Startex CDP, South Carolina",289,229,60,553,45,68920
"Stateburg CDP, South Carolina",557,530,27,1739,45,69010
"Stuckey town, South Carolina",129,115,14,243,45,70045
"Sullivan's Island town, South Carolina",1213,1194,19,2317,45,70090
"Summerton town, South Carolina",293,229,64,714,45,70225
"Summerville town, South Carolina",27039,25463,1576,50839,45,70270
"Summit town, South Carolina",315,310,5,539,45,70315
"Sumter city, South Carolina",17287,15930,1357,43046,45,70405
"Surfside Beach town, South Carolina",1819,1668,151,4179,45,70585
"Swansea town, South Carolina",372,349,23,739,45,70675
"Sycamore town, South Carolina",46,46,0,94,45,70900
"Tamassee CDP, South Carolina",0,0,0,82,45,71170
"Tatum town, South Carolina",22,14,8,72,45,71305
"Taylors CDP, South Carolina",12551,11945,606,23005,45,71395
"Tega Cay city, South Carolina",6287,6207,80,12816,45,71417
"The Cliffs Valley CDP, South Carolina",256,256,0,842,45,71658
"Tigerville CDP, South Carolina",927,854,73,2122,45,71890
"Timmonsville town, South Carolina",933,860,73,2119,45,71980
"Tradesville CDP, South Carolina",48,48,0,67,45,72295
"Travelers Rest city, South Carolina",3490,3268,222,7929,45,72430
"Trenton town, South Carolina",182,168,14,309,45,72520
"Troy town, South Carolina",65,63,2,165,45,72655
"Turbeville town, South Carolina",248,225,23,710,45,72745
"Ulmer town, South Carolina",63,57,6,92,45,72880
"Union city, South Carolina",3724,3155,569,8099,45,73105
"Unity CDP, South Carolina",209,209,0,633,45,73240
"Utica CDP, South Carolina",805,788,17,1654,45,73330
"Valley Falls CDP, South Carolina",4387,4190,197,7104,45,73465
"Vance town, South Carolina",59,51,8,92,45,73510
"Van Wyck town, South Carolina",316,289,27,873,45,73555
"Varnville town, South Carolina",932,794,138,2173,45,73600
"Wade Hampton CDP, South Carolina",10810,10472,338,21029,45,73870
"Wagener town, South Carolina",543,492,51,1030,45,74050
"Walhalla city, South Carolina",1627,1475,152,4102,45,74095
"Wallace CDP, South Carolina",228,228,0,662,45,74140
"Walterboro city, South Carolina",2478,2401,77,5515,45,74275
"Ward town, South Carolina",112,110,2,252,45,74590
"Ware Place CDP, South Carolina",49,49,0,96,45,74635
"Ware Shoals town, South Carolina",640,590,50,1934,45,74680
"Warrenville CDP, South Carolina",305,282,23,786,45,74725
"Waterloo town, South Carolina",82,80,2,244,45,74995
"Watts Mills CDP, South Carolina",888,773,115,2013,45,75220
"Wedgefield CDP, South Carolina",1123,1090,33,2050,45,75445
"Welcome CDP, South Carolina",4177,3937,240,7153,45,75535
"Wellford city, South Carolina",1221,1192,29,3330,45,75580
"West Columbia city, South Carolina",9386,9117,269,17459,45,75850
"Westminster city, South Carolina",797,726,71,2215,45,76165
"West Pelzer town, South Carolina",523,507,16,1155,45,76345
"West Union town, South Carolina",167,163,4,422,45,76435
"White Knoll CDP, South Carolina",3606,3438,168,7185,45,77042
"Whitmire town, South Carolina",540,508,32,1255,45,77380
"Whitney CDP, South Carolina",2225,2211,14,3734,45,77425
"Wilkinson Heights CDP, South Carolina",776,678,98,1919,45,77672
"Williams town, South Carolina",69,54,15,203,45,77785
"Williamston town, South Carolina",2210,2009,201,4072,45,77875
"Willington CDP, South Carolina",53,0,53,80,45,77920
"Williston town, South Carolina",1558,1500,58,2877,45,77965
"Windsor town, South Carolina",154,114,40,294,45,78190
"Winnsboro town, South Carolina",1201,1074,127,3239,45,78460
"Winnsboro Mills CDP, South Carolina",772,647,125,1682,45,78505
"Wisacky CDP, South Carolina",119,119,0,205,45,78640
"Woodfield CDP, South Carolina",4512,4320,192,9466,45,78820
"Woodford town, South Carolina",67,67,0,163,45,78910
"Woodruff city, South Carolina",2302,2157,145,4262,45,79090
"Wyboo CDP, South Carolina",1276,1154,122,3786,45,79341
"Yemassee town, South Carolina",442,419,23,974,45,79450
"York city, South Carolina",4339,3982,357,8534,45,79630
"Zion CDP, South Carolina",29,29,0,102,45,79720
"Aberdeen city, South Dakota",16160,15479,681,28388,46,00100
"Agar town, South Dakota",52,52,0,97,46,00460
"Agency Village CDP, South Dakota",394,369,25,972,46,00520
"Akaska town, South Dakota",7,7,0,68,46,00540
"Albee town, South Dakota",2,2,0,4,46,00620
"Alcester city, South Dakota",382,380,2,973,46,00700
"Alexandria city, South Dakota",463,463,0,839,46,00820
"Allen CDP, South Dakota",135,117,18,926,46,00900
"Alpena town, South Dakota",188,188,0,407,46,01020
"Altamont town, South Dakota",16,14,2,39,46,01140
"Anderson CDP, South Dakota",260,260,0,418,46,01450
"Andover town, South Dakota",21,21,0,44,46,01500
"Angostura CDP, South Dakota",66,66,0,118,46,01560
"Antelope CDP, South Dakota",142,112,30,701,46,01740
"Ardmore CDP, South Dakota",0,0,0,0,46,01980
"Arlington city, South Dakota",430,426,4,846,46,02180
"Armour city, South Dakota",304,300,4,642,46,02260
"Artas town, South Dakota",15,15,0,41,46,02340
"Artesian town, South Dakota",104,104,0,190,46,02380
"Ashland Heights CDP, South Dakota",576,410,166,1215,46,02530
"Ashton city, South Dakota",89,89,0,163,46,02540
"Astoria town, South Dakota",90,90,0,171,46,02580
"Aurora town, South Dakota",902,899,3,1429,46,02780
"Aurora Center CDP, South Dakota",15,15,0,34,46,02860
"Avon city, South Dakota",279,273,6,707,46,02900
"Badger town, South Dakota",87,78,9,168,46,03060
"Baltic city, South Dakota",782,773,9,1440,46,03380
"Bancroft town, South Dakota",18,18,0,34,46,03420
"Batesland town, South Dakota",25,20,5,89,46,03860
"Bath CDP, South Dakota",47,47,0,56,46,03900
"Bath Corner CDP, South Dakota",45,45,0,69,46,03960
"Belle Fourche city, South Dakota",2972,2699,273,5670,46,04380
"Belvidere town, South Dakota",17,17,0,97,46,04620
"Beresford city, South Dakota",1313,1249,64,2419,46,04980
"Big Stone City city, South Dakota",349,349,0,769,46,05540
"Bijou Hills CDP, South Dakota",0,0,0,0,46,05580
"Bison town, South Dakota",223,223,0,417,46,05620
"Blackhawk CDP, South Dakota",1705,1596,109,2930,46,05780
"Blucksberg Mountain CDP, South Dakota",344,344,0,619,46,06120
"Blumengard Colony CDP, South Dakota",0,0,0,0,46,06140
"Blunt city, South Dakota",117,117,0,218,46,06180
"Bonesteel city, South Dakota",92,89,3,336,46,06220
"Bon Homme Colony CDP, South Dakota",0,0,0,0,46,06300
"Boulder Canyon CDP, South Dakota",345,345,0,565,46,06440
"Bowdle city, South Dakota",198,198,0,364,46,06540
"Box Elder city, South Dakota",5977,5677,300,11905,46,06620
"Bradley town, South Dakota",49,45,4,94,46,06660
"Brandon city, South Dakota",6391,6316,75,10919,46,06840
"Brandt town, South Dakota",62,60,2,125,46,06940
"Brant Lake city, South Dakota",49,49,0,76,46,07040
"Brant Lake South CDP, South Dakota",158,158,0,223,46,07044
"Brentford town, South Dakota",41,41,0,66,46,07060
"Brentwood Colony CDP, South Dakota",33,33,0,66,46,07068
"Bridger CDP, South Dakota",11,6,5,75,46,07140
"Bridgewater city, South Dakota",194,186,8,402,46,07180
"Bristol city, South Dakota",143,135,8,240,46,07300
"Britton city, South Dakota",582,576,6,1108,46,07380
"Broadland town, South Dakota",7,7,0,9,46,07420
"Brookings city, South Dakota",13853,13148,705,23530,46,07580
"Bruce city, South Dakota",129,127,2,254,46,07740
"Bryant city, South Dakota",263,258,5,749,46,08060
"Buffalo town, South Dakota",212,204,8,328,46,08140
"Buffalo Chip town, South Dakota",0,0,0,0,46,08330
"Buffalo Gap town, South Dakota",54,51,3,123,46,08340
"Bullhead CDP, South Dakota",88,43,45,250,46,08460
"Burbank CDP, South Dakota",32,32,0,78,46,08500
"Burke city, South Dakota",284,271,13,685,46,08700
"Bushnell town, South Dakota",30,30,0,50,46,08820
"Butler town, South Dakota",4,4,0,8,46,08860
"Cameron Colony CDP, South Dakota",45,45,0,45,46,09204
"Camp Crook town, South Dakota",20,20,0,38,46,09260
"Camrose Colony CDP, South Dakota",0,0,0,0,46,09278
"Canistota city, South Dakota",361,349,12,670,46,09300
"Canova town, South Dakota",56,56,0,145,46,09420
"Canton city, South Dakota",1684,1589,95,3060,46,09500
"Caputa CDP, South Dakota",0,0,0,29,46,09780
"Carthage city, South Dakota",84,79,5,153,46,10220
"Castlewood city, South Dakota",372,365,7,690,46,10500
"Cavour town, South Dakota",109,108,1,186,46,10620
"Cedar Grove Colony CDP, South Dakota",0,0,0,0,46,10835
"Centerville city, South Dakota",398,386,12,846,46,11060
"Central City city, South Dakota",75,60,15,125,46,11140
"Chamberlain city, South Dakota",1339,1292,47,2538,46,11220
"Chancellor town, South Dakota",153,145,8,354,46,11380
"Chelsea town, South Dakota",37,37,0,56,46,11500
"Cherry Creek CDP, South Dakota",112,45,67,233,46,11540
"Chester CDP, South Dakota",133,126,7,237,46,11660
"Claire City town, South Dakota",54,51,3,80,46,12020
"Claremont town, South Dakota",53,51,2,80,46,12100
"Claremont Colony CDP, South Dakota",0,0,0,0,46,12148
"Clark city, South Dakota",576,551,25,1206,46,12180
"Clark Colony CDP, South Dakota",9,9,0,62,46,12340
"Clearfield Colony CDP, South Dakota",0,0,0,40,46,12508
"Clear Lake city, South Dakota",590,586,4,1310,46,12540
"Clear Lake CDP, South Dakota",24,24,0,100,46,12640
"Cloverleaf Colony CDP, South Dakota",7,7,0,14,46,13010
"Collins Colony CDP, South Dakota",0,0,0,0,46,13188
"Colman city, South Dakota",421,407,14,838,46,13220
"Colome city, South Dakota",176,167,9,399,46,13300
"Colonial Pine Hills CDP, South Dakota",1278,1181,97,2346,46,13355
"Colton city, South Dakota",428,406,22,769,46,13380
"Columbia city, South Dakota",97,97,0,173,46,13420
"Conde city, South Dakota",53,50,3,129,46,13700
"Corn Creek CDP, South Dakota",17,10,7,183,46,13840
"Corona town, South Dakota",48,48,0,79,46,13940
"Corsica city, South Dakota",354,354,0,691,46,13980
"Cottonwood town, South Dakota",12,12,0,81,46,14220
"Cow Creek CDP, South Dakota",56,56,0,74,46,14320
"Cresbard town, South Dakota",43,43,0,124,46,14580
"Crocker CDP, South Dakota",0,0,0,21,46,14660
"Crook City CDP, South Dakota",53,53,0,127,46,14680
"Crooks city, South Dakota",973,954,19,1463,46,14740
"Custer city, South Dakota",945,906,39,2043,46,15140
"Dakota Dunes CDP, South Dakota",1979,1963,16,3997,46,15256
"Dallas town, South Dakota",61,61,0,103,46,15300
"Dante town, South Dakota",65,65,0,102,46,15420
"Davis town, South Dakota",54,43,11,119,46,15540
"Deadwood city, South Dakota",769,734,35,1423,46,15700
"Deerfield Colony CDP, South Dakota",0,0,0,0,46,15774
"Dell Rapids city, South Dakota",2055,2028,27,3953,46,15980
"Delmont city, South Dakota",89,88,1,211,46,16060
"De Smet city, South Dakota",513,513,0,990,46,16260
"Dimock town, South Dakota",38,38,0,78,46,16620
"Doland city, South Dakota",150,150,0,282,46,16820
"Dolton town, South Dakota",30,30,0,44,46,16860
"Draper town, South Dakota",12,12,0,15,46,17020
"Dudley CDP, South Dakota",0,0,0,7,46,17215
"Dupree city, South Dakota",238,191,47,470,46,17420
"Eagle Butte city, South Dakota",689,430,259,1396,46,17620
"Eden town, South Dakota",123,123,0,173,46,18180
"Edgemont city, South Dakota",231,209,22,827,46,18300
"Egan city, South Dakota",107,101,6,232,46,18460
"Elk Point city, South Dakota",1093,1067,26,2177,46,18620
"Elkton city, South Dakota",415,390,25,815,46,18700
"Emery city, South Dakota",281,275,6,492,46,19420
"Enemy Swim CDP, South Dakota",78,49,29,304,46,19556
"Erwin town, South Dakota",20,20,0,39,46,19860
"Estelline city, South Dakota",489,477,12,952,46,19980
"Ethan town, South Dakota",164,164,0,269,46,20060
"Eureka city, South Dakota",356,356,0,910,46,20180
"Evergreen Colony CDP, South Dakota",0,0,0,74,46,20208
"Fairburn town, South Dakota",23,17,6,37,46,20340
"Fairfax town, South Dakota",66,66,0,135,46,20380
"Fairview town, South Dakota",56,56,0,88,46,20780
"Faith city, South Dakota",157,155,2,304,46,20980
"Farmer town, South Dakota",9,9,0,62,46,21060
"Faulkton city, South Dakota",357,323,34,672,46,21260
"Fedora CDP, South Dakota",11,11,0,19,46,21340
"Ferney CDP, South Dakota",0,0,0,22,46,21380
"Flandreau city, South Dakota",1058,1035,23,2246,46,21540
"Florence town, South Dakota",151,149,2,299,46,21820
"Fordham Colony CDP, South Dakota",0,0,0,0,46,22070
"Forestburg CDP, South Dakota",27,27,0,42,46,22100
"Fort Pierre city, South Dakota",1491,1488,3,2522,46,22260
"Fort Thompson CDP, South Dakota",416,337,79,1157,46,22340
"Frankfort city, South Dakota",58,57,1,130,46,22580
"Frederick town, South Dakota",115,106,9,217,46,22860
"Freeman city, South Dakota",694,676,18,1580,46,23020
"Fruitdale town, South Dakota",45,41,4,127,46,23140
"Fulton town, South Dakota",43,40,3,80,46,23220
"Gann Valley CDP, South Dakota",12,12,0,12,46,23421
"Garden City town, South Dakota",44,44,0,96,46,23460
"Garretson city, South Dakota",665,621,44,1259,46,23820
"Gary city, South Dakota",102,93,9,249,46,23860
"Gayville town, South Dakota",257,257,0,420,46,23900
"Geddes city, South Dakota",71,71,0,138,46,23980
"Gettysburg city, South Dakota",760,740,20,1440,46,24260
"Glendale Colony CDP, South Dakota",80,80,0,203,46,24540
"Glenham town, South Dakota",67,67,0,111,46,24620
"Golden View Colony CDP, South Dakota",52,52,0,107,46,24760
"Goodwin town, South Dakota",40,40,0,92,46,24820
"Graceville Colony CDP, South Dakota",0,0,0,0,46,25020
"Grassland Colony CDP, South Dakota",18,18,0,18,46,25741
"Grass Ranch Colony CDP, South Dakota",0,0,0,0,46,25743
"Green Grass CDP, South Dakota",0,0,0,0,46,25900
"Green Valley CDP, South Dakota",713,713,0,1353,46,26035
"Greenwood Colony CDP, South Dakota",0,0,0,0,46,26150
"Gregory city, South Dakota",743,720,23,1393,46,26180
"Grenville town, South Dakota",43,43,0,68,46,26220
"Groton city, South Dakota",902,895,7,1688,46,26340
"Hamill CDP, South Dakota",0,0,0,0,46,26660
"Harrisburg city, South Dakota",4318,4282,36,7157,46,27260
"Harrison CDP, South Dakota",0,0,0,7,46,27300
"Harrold town, South Dakota",53,53,0,102,46,27420
"Hartford city, South Dakota",1947,1890,57,3340,46,27540
"Hayti town, South Dakota",235,231,4,369,46,27820
"Hazel town, South Dakota",62,62,0,135,46,27940
"Hecla city, South Dakota",138,138,0,257,46,27980
"Henry town, South Dakota",96,96,0,238,46,28140
"Hermosa town, South Dakota",188,188,0,360,46,28300
"Herreid city, South Dakota",254,239,15,568,46,28340
"Herrick town, South Dakota",27,27,0,67,46,28420
"Hetland town, South Dakota",16,16,0,16,46,28460
"Highmore city, South Dakota",404,399,5,764,46,28980
"Hill City city, South Dakota",373,373,0,630,46,29100
"Hillcrest Colony CDP, South Dakota",0,0,0,0,46,29116
"Hillside Colony CDP, South Dakota",0,0,0,0,46,29300
"Hillsview town, South Dakota",0,0,0,0,46,29340
"Hitchcock town, South Dakota",37,37,0,102,46,29500
"Horse Creek CDP, South Dakota",43,28,15,207,46,30056
"Hosmer city, South Dakota",95,93,2,273,46,30140
"Hot Springs city, South Dakota",1551,1503,48,3465,46,30220
"Hoven town, South Dakota",149,148,1,317,46,30300
"Howard city, South Dakota",428,428,0,930,46,30460
"Hudson town, South Dakota",240,234,6,461,46,30740
"Humboldt town, South Dakota",354,350,4,619,46,30900
"Hurley city, South Dakota",173,168,5,393,46,30980
"Huron city, South Dakota",7024,6831,193,14179,46,31060
"Huron Colony CDP, South Dakota",0,0,0,0,46,31140
"Hutterville Colony CDP, South Dakota",0,0,0,0,46,31196
"Ideal CDP, South Dakota",11,11,0,51,46,31220
"Interior town, South Dakota",24,24,0,52,46,31620
"Ipswich city, South Dakota",582,574,8,1170,46,31860
"Irene city, South Dakota",268,268,0,513,46,31940
"Iroquois city, South Dakota",219,212,7,423,46,32020
"Isabel town, South Dakota",98,92,6,188,46,32140
"Jamesville Colony CDP, South Dakota",0,0,0,39,46,32388
"Java town, South Dakota",92,84,8,147,46,32460
"Jefferson city, South Dakota",351,306,45,631,46,32700
"Johnson Siding CDP, South Dakota",320,320,0,658,46,32820
"Kadoka city, South Dakota",156,146,10,441,46,33180
"Kaylor CDP, South Dakota",0,0,0,15,46,33380
"Kenel CDP, South Dakota",89,62,27,176,46,33540
"Kennebec town, South Dakota",163,158,5,369,46,33580
"Keystone town, South Dakota",234,215,19,385,46,33820
"Kidder CDP, South Dakota",11,11,0,11,46,33900
"Kimball city, South Dakota",342,307,35,565,46,33980
"Kranzburg town, South Dakota",124,124,0,211,46,34340
"Kyle CDP, South Dakota",509,466,43,1504,46,34460
"La Bolt town, South Dakota",44,42,2,82,46,34540
"Lake Andes city, South Dakota",325,300,25,945,46,35100
"Lake City town, South Dakota",34,33,1,53,46,35220
"Lake Madison CDP, South Dakota",454,434,20,850,46,35430
"Lake Norden city, South Dakota",340,332,8,740,46,35460
"Lake Poinsett CDP, South Dakota",176,176,0,438,46,35480
"Lake Preston city, South Dakota",254,253,1,548,46,35500
"Lakeview Colony CDP, South Dakota",0,0,0,0,46,35671
"Lane town, South Dakota",15,15,0,21,46,35780
"Langford town, South Dakota",281,281,0,496,46,35820
"Lantry CDP, South Dakota",21,21,0,39,46,35900
"La Plant CDP, South Dakota",97,44,53,300,46,35940
"Lead city, South Dakota",1666,1666,0,2993,46,36220
"Lebanon town, South Dakota",47,47,0,78,46,36260
"Lemmon city, South Dakota",594,560,34,1118,46,36340
"Lennox city, South Dakota",1271,1271,0,2603,46,36380
"Leola city, South Dakota",204,201,3,359,46,36460
"Lesterville town, South Dakota",77,77,0,109,46,36540
"Letcher town, South Dakota",90,86,4,147,46,36620
"Little Eagle CDP, South Dakota",78,24,54,343,46,37900
"Long Hollow CDP, South Dakota",93,84,9,364,46,38760
"Long Lake town, South Dakota",9,9,0,26,46,38860
"Long Lake Colony CDP, South Dakota",0,0,0,0,46,38900
"Loomis CDP, South Dakota",0,0,0,0,46,39020
"Lower Brule CDP, South Dakota",270,246,24,892,46,39180
"Lowry town, South Dakota",0,0,0,2,46,39260
"Lyons CDP, South Dakota",42,42,0,84,46,39740
"McIntosh city, South Dakota",46,46,0,87,46,39940
"McLaughlin city, South Dakota",293,246,47,614,46,40020
"Madison city, South Dakota",3260,3205,55,6271,46,40220
"Manderson-White Horse Creek CDP, South Dakota",60,55,5,641,46,40550
"Mansfield CDP, South Dakota",41,41,0,43,46,40580
"Marion city, South Dakota",468,464,4,954,46,40860
"Martin city, South Dakota",425,409,16,998,46,41100
"Marty CDP, South Dakota",64,29,35,197,46,41180
"Marvin town, South Dakota",5,5,0,16,46,41220
"Maverick Junction CDP, South Dakota",0,0,0,0,46,41398
"Maxwell Colony CDP, South Dakota",0,0,0,0,46,41420
"Mayfield Colony CDP, South Dakota",0,0,0,53,46,41548
"Meadow View Addition CDP, South Dakota",267,267,0,634,46,41680
"Meckling CDP, South Dakota",12,12,0,37,46,41700
"Mellette city, South Dakota",79,79,0,176,46,41860
"Menno city, South Dakota",413,404,9,878,46,41980
"Midland town, South Dakota",71,71,0,138,46,42140
"Milbank city, South Dakota",1740,1671,69,3506,46,42260
"Millbrook Colony CDP, South Dakota",0,0,0,12,46,42440
"Miller city, South Dakota",647,647,0,1293,46,42460
"Millerdale Colony CDP, South Dakota",56,56,0,86,46,42579
"Milltown CDP, South Dakota",5,5,0,25,46,42620
"Mina CDP, South Dakota",396,378,18,817,46,42700
"Mission city, South Dakota",426,352,74,1256,46,42940
"Mission Hill town, South Dakota",151,151,0,212,46,42980
"Mitchell city, South Dakota",8376,8230,146,15656,46,43100
"Mobridge city, South Dakota",1667,1644,23,3130,46,43180
"Monroe town, South Dakota",123,110,13,211,46,43380
"Montrose city, South Dakota",334,329,5,543,46,43500
"Morningside CDP, South Dakota",64,64,0,94,46,43780
"Morristown town, South Dakota",37,37,0,65,46,43860
"Mound City town, South Dakota",38,38,0,90,46,44020
"Mountain Plains CDP, South Dakota",389,343,46,481,46,44032
"Mount Vernon city, South Dakota",299,292,7,483,46,44100
"Murdo city, South Dakota",325,317,8,638,46,44260
"Naples town, South Dakota",26,26,0,76,46,44620
"Newdale Colony CDP, South Dakota",0,0,0,0,46,44800
"New Effington town, South Dakota",90,85,5,209,46,44820
"Newell city, South Dakota",282,273,9,489,46,44860
"New Elm Spring Colony CDP, South Dakota",0,0,0,43,46,44900
"New Holland CDP, South Dakota",0,0,0,4,46,44940
"Newport Colony CDP, South Dakota",0,0,0,0,46,45024
"New Underwood city, South Dakota",227,212,15,574,46,45060
"New Witten town, South Dakota",33,33,0,73,46,45100
"Nisland town, South Dakota",84,84,0,239,46,45180
"Norfeld Colony CDP, South Dakota",0,0,0,0,46,45390
"Norris CDP, South Dakota",46,17,29,155,46,45420
"North Eagle Butte CDP, South Dakota",634,490,144,1666,46,45548
"North Sioux City city, South Dakota",1647,1562,85,2984,46,45700
"North Spearfish CDP, South Dakota",1114,1102,12,1791,46,45715
"Northville town, South Dakota",79,79,0,159,46,45740
"Nunda town, South Dakota",21,21,0,45,46,46060
"Oacoma town, South Dakota",220,207,13,406,46,46180
"Oahe Acres CDP, South Dakota",147,147,0,395,46,46240
"Oak Lane Colony CDP, South Dakota",0,0,0,0,46,46388
"Oelrichs town, South Dakota",110,102,8,213,46,46500
"Oglala CDP, South Dakota",639,505,134,1440,46,46540
"Okaton CDP, South Dakota",15,15,0,43,46,46620
"Okreek CDP, South Dakota",25,25,0,110,46,46660
"Ola CDP, South Dakota",0,0,0,0,46,46700
"Old Elm Spring Colony CDP, South Dakota",0,0,0,39,46,46770
"Oldham city, South Dakota",59,59,0,110,46,46780
"Olivet town, South Dakota",35,35,0,60,46,46900
"Onaka town, South Dakota",8,8,0,22,46,46980
"Onida city, South Dakota",327,327,0,586,46,47180
"Oral CDP, South Dakota",8,8,0,44,46,47340
"Orient town, South Dakota",22,22,0,40,46,47460
"Orland Colony CDP, South Dakota",9,9,0,39,46,47588
"Ortley town, South Dakota",19,17,2,54,46,47660
"Parker city, South Dakota",613,585,28,1111,46,48380
"Parkston city, South Dakota",1034,1013,21,2003,46,48460
"Parmelee CDP, South Dakota",80,68,12,434,46,48500
"Pearl Creek Colony CDP, South Dakota",0,0,0,0,46,48820
"Peever town, South Dakota",56,50,6,146,46,48940
"Peever Flats CDP, South Dakota",31,31,0,107,46,48948
"Pembrook Colony CDP, South Dakota",0,0,0,0,46,49028
"Philip city, South Dakota",229,229,0,503,46,49300
"Pickstown town, South Dakota",135,135,0,274,46,49460
"Piedmont city, South Dakota",562,559,3,1198,46,49500
"Pierpont town, South Dakota",72,72,0,127,46,49540
"Pierre city, South Dakota",7346,7308,38,14105,46,49600
"Pine Lakes Addition CDP, South Dakota",174,174,0,285,46,49640
"Pine Ridge CDP, South Dakota",840,774,66,2921,46,49660
"Plainview Colony CDP, South Dakota",0,0,0,0,46,49980
"Plankinton city, South Dakota",363,363,0,606,46,50020
"Platte city, South Dakota",700,695,5,1299,46,50260
"Platte Colony CDP, South Dakota",0,0,0,0,46,50310
"Pleasant Valley Colony CDP, South Dakota",0,0,0,0,46,50988
"Poinsett Colony CDP, South Dakota",0,0,0,0,46,51220
"Pollock town, South Dakota",149,142,7,234,46,51260
"Porcupine CDP, South Dakota",114,74,40,1021,46,51340
"Prairie City CDP, South Dakota",0,0,0,22,46,51660
"Prairiewood Village CDP, South Dakota",206,206,0,411,46,51724
"Presho city, South Dakota",240,235,5,338,46,51820
"Pringle town, South Dakota",134,124,10,221,46,51940
"Provo CDP, South Dakota",0,0,0,0,46,52140
"Pukwana town, South Dakota",185,182,3,293,46,52220
"Quinn town, South Dakota",62,62,0,80,46,52500
"Ramona town, South Dakota",197,194,3,284,46,52860
"Rapid City city, South Dakota",38474,37155,1319,75632,46,52980
"Rapid Valley CDP, South Dakota",4245,4114,131,7324,46,53007
"Ravinia town, South Dakota",16,11,5,59,46,53220
"Raymond town, South Dakota",13,10,3,48,46,53260
"Redfield city, South Dakota",1122,1091,31,2253,46,53460
"Ree Heights town, South Dakota",27,27,0,38,46,53940
"Reliance town, South Dakota",39,39,0,112,46,54020
"Renner Corner CDP, South Dakota",206,206,0,258,46,54145
"Revillo town, South Dakota",84,83,1,110,46,54220
"Richland CDP, South Dakota",58,48,10,168,46,54750
"Riverside Colony CDP, South Dakota",0,0,0,0,46,55220
"Rockham town, South Dakota",9,9,0,26,46,55540
"Rockport Colony CDP, South Dakota",27,27,0,27,46,55620
"Rolland Colony CDP, South Dakota",0,0,0,0,46,55684
"Roscoe city, South Dakota",206,206,0,329,46,55820
"Rosebud CDP, South Dakota",683,548,135,2155,46,55940
"Rosedale Colony CDP, South Dakota",0,0,0,0,46,56140
"Rosholt town, South Dakota",173,166,7,353,46,56340
"Roslyn town, South Dakota",72,72,0,183,46,56380
"Roswell CDP, South Dakota",0,0,0,0,46,56420
"Rowena CDP, South Dakota",56,56,0,105,46,56580
"Running Water CDP, South Dakota",25,25,0,76,46,56820
"Rustic Acres Colony CDP, South Dakota",0,0,0,0,46,56964
"St. Charles CDP, South Dakota",0,0,0,7,46,57060
"St. Francis town, South Dakota",216,199,17,626,46,57140
"St. Lawrence town, South Dakota",114,114,0,173,46,57180
"St. Onge CDP, South Dakota",0,0,0,14,46,57260
"Salem city, South Dakota",568,568,0,1163,46,57340
"Scotland city, South Dakota",333,333,0,780,46,57940
"Selby city, South Dakota",272,241,31,695,46,58140
"Seneca town, South Dakota",14,14,0,42,46,58180
"Shamrock Colony CDP, South Dakota",0,0,0,51,46,58310
"Shannon Colony CDP, South Dakota",7,7,0,27,46,58332
"Sherman town, South Dakota",28,28,0,51,46,58580
"Shindler CDP, South Dakota",330,329,1,585,46,58590
"Sicangu Village CDP, South Dakota",34,34,0,232,46,58680
"Silver Lake Colony CDP, South Dakota",0,0,0,0,46,58868
"Sinai town, South Dakota",83,83,0,174,46,58900
"Sioux Falls city, South Dakota",111556,108968,2588,193401,46,59020
"Sisseton city, South Dakota",1118,1038,80,2564,46,59260
"Smithwick CDP, South Dakota",7,7,0,19,46,59620
"Soldier Creek CDP, South Dakota",32,15,17,286,46,59700
"South Shore town, South Dakota",135,135,0,226,46,59940
"Spearfish city, South Dakota",6606,6451,155,12268,46,60020
"Spencer city, South Dakota",39,39,0,112,46,60060
"Spink Colony CDP, South Dakota",23,23,0,47,46,60180
"Spring Creek CDP, South Dakota",34,34,0,159,46,60500
"Spring Creek Colony CDP, South Dakota",76,76,0,125,46,60540
"Springfield city, South Dakota",379,362,17,2216,46,60660
"Spring Lake Colony CDP, South Dakota",21,21,0,41,46,60958
"Spring Valley Colony CDP, South Dakota",0,0,0,0,46,61180
"Stephan CDP, South Dakota",35,35,0,43,46,61580
"Stickney town, South Dakota",108,107,1,245,46,61700
"Stockholm town, South Dakota",72,70,2,124,46,61740
"Storla CDP, South Dakota",5,5,0,5,46,61940
"Strandburg town, South Dakota",35,35,0,65,46,61980
"Stratford town, South Dakota",37,37,0,57,46,62020
"Sturgis city, South Dakota",3801,3709,92,7121,46,62100
"Summerset city, South Dakota",1588,1558,30,2950,46,62155
"Summit town, South Dakota",173,162,11,341,46,62220
"Sunset Colony CDP, South Dakota",28,28,0,54,46,62434
"Swift Bird CDP, South Dakota",28,10,18,179,46,62716
"Tabor town, South Dakota",209,209,0,405,46,62820
"Tea city, South Dakota",3447,3406,41,5922,46,63100
"Thunderbird Colony CDP, South Dakota",0,0,0,0,46,63452
"Timber Lake city, South Dakota",306,287,19,627,46,63620
"Tolstoy town, South Dakota",29,29,0,48,46,63700
"Toronto town, South Dakota",154,139,15,320,46,63740
"Trent town, South Dakota",169,166,3,332,46,63940
"Tripp city, South Dakota",201,198,3,533,46,64020
"Tschetter Colony CDP, South Dakota",0,0,0,57,46,64260
"Tulare town, South Dakota",82,82,0,193,46,64300
"Turton town, South Dakota",22,22,0,58,46,64540
"Twin Brooks town, South Dakota",19,19,0,38,46,64700
"Two Strike CDP, South Dakota",88,52,36,327,46,64840
"Tyndall city, South Dakota",449,435,14,1047,46,64860
"Upland Colony CDP, South Dakota",0,0,0,0,46,65628
"Utica town, South Dakota",35,31,4,70,46,65780
"Vale CDP, South Dakota",47,47,0,93,46,65900
"Valley Springs city, South Dakota",643,620,23,963,46,66260
"Veblen city, South Dakota",182,171,11,472,46,66540
"Verdon town, South Dakota",4,4,0,4,46,66660
"Vermillion city, South Dakota",6821,6139,682,11667,46,66700
"Viborg city, South Dakota",369,367,2,770,46,67020
"Vienna town, South Dakota",10,7,3,107,46,67220
"Vilas town, South Dakota",10,8,2,16,46,67340
"Virgil town, South Dakota",8,8,0,24,46,67500
"Vivian CDP, South Dakota",29,29,0,50,46,67620
"Volga city, South Dakota",1172,1159,13,2043,46,67700
"Volin town, South Dakota",103,101,2,153,46,67780
"Wagner city, South Dakota",679,624,55,1621,46,68020
"Wakonda town, South Dakota",123,123,0,387,46,68100
"Wakpala CDP, South Dakota",66,35,31,237,46,68140
"Wall town, South Dakota",301,299,2,650,46,68380
"Wallace town, South Dakota",28,28,0,68,46,68420
"Wanblee CDP, South Dakota",129,100,29,661,46,68580
"Ward town, South Dakota",20,20,0,31,46,68660
"Warner town, South Dakota",267,267,0,457,46,68740
"Wasta town, South Dakota",31,31,0,63,46,69140
"Watertown city, South Dakota",12421,12233,188,22718,46,69300
"Waubay city, South Dakota",159,143,16,411,46,69340
"Waverly CDP, South Dakota",16,16,0,21,46,69420
"Webster city, South Dakota",900,888,12,1805,46,69780
"Wentworth village, South Dakota",124,124,0,175,46,70020
"Wessington city, South Dakota",109,109,0,203,46,70140
"Wessington Springs city, South Dakota",312,312,0,659,46,70220
"West Brule CDP, South Dakota",126,114,12,531,46,70284
"Westport town, South Dakota",34,34,0,83,46,70540
"Westwood Colony CDP, South Dakota",0,0,0,0,46,70646
"Wetonka town, South Dakota",7,7,0,14,46,70740
"White city, South Dakota",302,295,7,478,46,70940
"Whitehorse CDP, South Dakota",89,62,27,147,46,71140
"White Horse CDP, South Dakota",28,26,2,146,46,71150
"White Lake city, South Dakota",177,177,0,404,46,71180
"White River city, South Dakota",279,273,6,681,46,71340
"White Rock town, South Dakota",0,0,0,6,46,71380
"White Rock Colony CDP, South Dakota",0,0,0,0,46,71440
"Whitewood city, South Dakota",562,525,37,875,46,71580
"Willow Lake city, South Dakota",114,114,0,360,46,71940
"Wilmot city, South Dakota",181,181,0,416,46,71980
"Winfred CDP, South Dakota",46,46,0,46,46,72100
"Winner city, South Dakota",1421,1297,124,2905,46,72180
"Wolf Creek Colony CDP, South Dakota",0,0,0,0,46,72500
"Wolsey town, South Dakota",354,349,5,745,46,72540
"Wonderland Homes CDP, South Dakota",460,423,37,781,46,72590
"Wood town, South Dakota",21,21,0,57,46,72620
"Woonsocket city, South Dakota",337,331,6,710,46,72700
"Worthing city, South Dakota",516,509,7,976,46,72820
"Wounded Knee CDP, South Dakota",47,0,47,378,46,72900
"Yale town, South Dakota",125,125,0,214,46,73020
"Yankton city, South Dakota",7856,7768,88,15421,46,73060
"Adams city, Tennessee",396,373,23,674,47,00200
"Adamsville town, Tennessee",871,818,53,2334,47,00240
"Alamo town, Tennessee",1114,1081,33,2405,47,00440
"Alcoa city, Tennessee",5945,5709,236,11095,47,00540
"Alexandria town, Tennessee",571,512,59,1160,47,00620
"Algood city, Tennessee",1954,1936,18,3944,47,00640
"Allardt city, Tennessee",470,415,55,1191,47,00660
"Altamont town, Tennessee",281,271,10,904,47,00940
"Andersonville CDP, Tennessee",187,187,0,274,47,01220
"Apison CDP, Tennessee",2128,2104,24,4199,47,01480
"Ardmore city, Tennessee",577,535,42,1354,47,01640
"Arlington town, Tennessee",7437,7208,229,14342,47,01740
"Ashland City town, Tennessee",2755,2621,134,5213,47,02180
"Athens city, Tennessee",6665,6287,378,14091,47,02320
"Atoka town, Tennessee",4913,4587,326,10070,47,02340
"Atwood town, Tennessee",527,460,67,1229,47,02380
"Auburntown town, Tennessee",182,178,4,355,47,02400
"Baileyton town, Tennessee",217,203,14,499,47,02780
"Baneberry city, Tennessee",297,276,21,620,47,03078
"Banner Hill CDP, Tennessee",746,687,59,1571,47,03120
"Bartlett city, Tennessee",28455,27373,1082,57481,47,03440
"Baxter town, Tennessee",648,640,8,1477,47,03680
"Bean Station city, Tennessee",1396,1350,46,2963,47,03760
"Beech Bluff CDP, Tennessee",215,197,18,463,47,04000
"Beersheba Springs town, Tennessee",266,262,4,538,47,04240
"Bell Buckle town, Tennessee",394,383,11,621,47,04460
"Belle Meade city, Tennessee",1353,1339,14,2933,47,04620
"Bells city, Tennessee",1308,1251,57,2675,47,04720
"Belvidere CDP, Tennessee",72,72,0,72,47,04920
"Benton town, Tennessee",583,539,44,1584,47,05040
"Berry Hill city, Tennessee",1541,1513,28,1863,47,05140
"Bethel Springs town, Tennessee",382,381,1,901,47,05380
"Bethpage CDP, Tennessee",49,49,0,276,47,05500
"Big Rock CDP, Tennessee",99,99,0,250,47,05840
"Big Sandy town, Tennessee",254,247,7,593,47,05860
"Biltmore CDP, Tennessee",895,822,73,1917,47,06020
"Blaine city, Tennessee",1190,1091,99,2496,47,06340
"Blanche CDP, Tennessee",109,109,0,287,47,06440
"Bloomingdale CDP, Tennessee",4052,3865,187,8946,47,06640
"Blountville CDP, Tennessee",1375,1286,89,3265,47,06740
"Bluff City city, Tennessee",1171,1143,28,2261,47,06960
"Bogota CDP, Tennessee",59,59,0,74,47,07120
"Bolivar city, Tennessee",2795,2182,613,5197,47,07180
"Bon Air CDP, Tennessee",148,137,11,437,47,07240
"Bon Aqua Junction CDP, Tennessee",604,595,9,1677,47,07280
"Bowman CDP, Tennessee",232,232,0,411,47,07620
"Braden town, Tennessee",176,167,9,293,47,07840
"Bradford town, Tennessee",486,457,29,1132,47,07860
"Bransford CDP, Tennessee",43,43,0,131,47,08080
"Brentwood city, Tennessee",22168,21685,483,44830,47,08280
"Briceville CDP, Tennessee",116,103,13,329,47,08400
"Brighton town, Tennessee",1445,1375,70,2878,47,08500
"Bristol city, Tennessee",12737,11621,1116,27307,47,08540
"Brownsville city, Tennessee",4416,3908,508,9739,47,08920
"Bruceton town, Tennessee",452,439,13,1311,47,08960
"Buchanan CDP, Tennessee",13,13,0,74,47,09200
"Bulls Gap town, Tennessee",287,264,23,875,47,09560
"Burlison town, Tennessee",140,120,20,321,47,09860
"Burns town, Tennessee",923,904,19,1702,47,09880
"Butler CDP, Tennessee",101,101,0,251,47,10080
"Byrdstown town, Tennessee",392,375,17,1275,47,10180
"Calhoun town, Tennessee",267,266,1,545,47,10440
"Camden city, Tennessee",1467,1389,78,3670,47,10560
"Carthage town, Tennessee",1262,1244,18,2454,47,11280
"Caryville town, Tennessee",1000,893,107,2181,47,11360
"Castalian Springs CDP, Tennessee",346,346,0,620,47,11440
"Cedar Hill city, Tennessee",207,193,14,357,47,11980
"Celina city, Tennessee",452,389,63,1767,47,12100
"Centertown town, Tennessee",139,134,5,277,47,12380
"Centerville town, Tennessee",1302,1237,65,3515,47,12420
"Central CDP, Tennessee",872,832,40,1942,47,12460
"Chapel Hill town, Tennessee",907,873,34,1626,47,12880
"Charleston city, Tennessee",308,301,7,641,47,13020
"Charlotte town, Tennessee",711,675,36,1997,47,13080
"Chattanooga city, Tennessee",94991,90166,4825,181288,47,14000
"Chesterfield CDP, Tennessee",392,348,44,834,47,14220
"Chewalla CDP, Tennessee",49,49,0,117,47,14520
"Childers Hill CDP, Tennessee",0,0,0,20,47,14620
"Christiana CDP, Tennessee",2892,2829,63,4759,47,14860
"Church Hill city, Tennessee",3147,2728,419,7016,47,14980
"Clarkrange CDP, Tennessee",271,271,0,664,47,15120
"Clarksburg town, Tennessee",510,420,90,975,47,15140
"Clarksville city, Tennessee",74784,69936,4848,167882,47,15160
"Cleveland city, Tennessee",23358,22358,1000,47725,47,15400
"Clifton city, Tennessee",377,365,12,2622,47,15480
"Clinton city, Tennessee",4765,4616,149,10060,47,15580
"Coalfield CDP, Tennessee",1211,1163,48,2905,47,15880
"Coalmont city, Tennessee",336,320,16,921,47,15920
"Coker Creek CDP, Tennessee",24,24,0,45,47,16060
"Collegedale city, Tennessee",6551,6375,176,11001,47,16300
"Collierville town, Tennessee",26280,25606,674,51170,47,16420
"Collinwood city, Tennessee",594,561,33,1224,47,16480
"Colonial Heights CDP, Tennessee",1666,1594,72,2667,47,16500
"Columbia city, Tennessee",21279,20565,714,42474,47,16540
"Conasauga CDP, Tennessee",79,79,0,167,47,16740
"Cookeville city, Tennessee",17414,16346,1068,34967,47,16920
"Coopertown town, Tennessee",2555,2529,26,4536,47,16980
"Copperhill city, Tennessee",140,140,0,401,47,17000
"Cornersville town, Tennessee",780,725,55,1756,47,17180
"Cosby CDP, Tennessee",366,366,0,632,47,17300
"Cottage Grove town, Tennessee",19,16,3,57,47,17340
"Cottontown CDP, Tennessee",180,158,22,345,47,17420
"Counce CDP, Tennessee",180,168,12,396,47,17520
"Covington city, Tennessee",3648,3447,201,8644,47,17680
"Cowan city, Tennessee",687,601,86,1827,47,17700
"Crab Orchard city, Tennessee",365,362,3,868,47,17840
"Cross Plains city, Tennessee",1004,977,27,1824,47,18420
"Crossville city, Tennessee",5314,4753,561,12099,47,18540
"Crump city, Tennessee",812,806,6,1946,47,18620
"Cumberland City town, Tennessee",108,104,4,363,47,18820
"Cumberland Gap town, Tennessee",142,140,2,376,47,18880
"Dancyville CDP, Tennessee",0,0,0,32,47,19360
"Dandridge town, Tennessee",1369,1273,96,3351,47,19380
"Darden CDP, Tennessee",180,150,30,416,47,19500
"Dayton city, Tennessee",3104,2919,185,7139,47,19700
"Decatur town, Tennessee",764,589,175,1840,47,19880
"Decaturville town, Tennessee",231,212,19,916,47,19900
"Decherd city, Tennessee",1247,1155,92,2667,47,19920
"Delano CDP, Tennessee",264,233,31,741,47,20080
"Dellrose CDP, Tennessee",37,37,0,90,47,20120
"Dickson city, Tennessee",8239,7656,583,16051,47,20620
"Dodson Branch CDP, Tennessee",334,334,0,812,47,20930
"Dover city, Tennessee",856,803,53,1985,47,21400
"Dowelltown town, Tennessee",159,144,15,355,47,21420
"Doyle town, Tennessee",203,199,4,579,47,21500
"Dresden town, Tennessee",1511,1475,36,2983,47,21540
"Ducktown city, Tennessee",157,130,27,511,47,21740
"Dukedom CDP, Tennessee",7,7,0,110,47,21860
"Dunlap city, Tennessee",2023,1936,87,5443,47,22000
"Dyer city, Tennessee",908,867,41,2498,47,22180
"Dyersburg city, Tennessee",6920,6472,448,16170,47,22200
"Eagleton Village CDP, Tennessee",2561,2435,126,5328,47,22340
"Eagleville city, Tennessee",496,490,6,982,47,22360
"East Cleveland CDP, Tennessee",825,674,151,2146,47,22500
"East Ridge city, Tennessee",12225,11431,794,22040,47,22720
"Eastview town, Tennessee",387,360,27,835,47,22920
"Elgin CDP, Tennessee",42,10,32,157,47,23440
"Elizabethton city, Tennessee",5936,5527,409,14375,47,23500
"Elkton city, Tennessee",247,216,31,496,47,23660
"Embreeville CDP, Tennessee",370,370,0,998,47,23880
"Englewood town, Tennessee",683,584,99,1645,47,24040
"Enville town, Tennessee",38,36,2,157,47,24240
"Erin city, Tennessee",467,442,25,1460,47,24320
"Erwin town, Tennessee",2724,2590,134,6026,47,24360
"Essary Springs CDP, Tennessee",40,40,0,73,47,24400
"Estill Springs town, Tennessee",876,805,71,2022,47,24440
"Ethridge town, Tennessee",232,227,5,572,47,24460
"Etowah city, Tennessee",1521,1245,276,3614,47,24480
"Eva CDP, Tennessee",0,0,0,97,47,24640
"Fairfield CDP, Tennessee",186,146,40,266,47,24960
"Fairfield Glade CDP, Tennessee",1661,1609,52,9257,47,24980
"Fairgarden CDP, Tennessee",276,276,0,501,47,24990
"Fairmount CDP, Tennessee",732,708,24,1747,47,25080
"Fairview city, Tennessee",5049,4926,123,9519,47,25440
"Fall Branch CDP, Tennessee",344,344,0,984,47,25540
"Falling Water CDP, Tennessee",1093,1055,38,2022,47,25560
"Farner CDP, Tennessee",40,40,0,114,47,25740
"Farragut town, Tennessee",12043,11761,282,23795,47,25760
"Fayetteville city, Tennessee",3078,2927,151,7026,47,25920
"Fincastle CDP, Tennessee",510,467,43,1170,47,26120
"Finger city, Tennessee",163,151,12,385,47,26160
"Finley CDP, Tennessee",355,321,34,595,47,26180
"Flat Top Mountain CDP, Tennessee",233,233,0,891,47,26490
"Flintville CDP, Tennessee",176,176,0,430,47,26580
"Forest Hills city, Tennessee",2261,2233,28,4922,47,27020
"Fowlkes CDP, Tennessee",388,388,0,897,47,27640
"Frankewing CDP, Tennessee",15,15,0,64,47,27700
"Franklin city, Tennessee",45909,44726,1183,83630,47,27740
"Friendship city, Tennessee",294,283,11,672,47,27960
"Friendsville city, Tennessee",574,553,21,1097,47,28060
"Gadsden town, Tennessee",152,145,7,359,47,28380
"Gainesboro town, Tennessee",371,339,32,1086,47,28420
"Gallatin city, Tennessee",22511,21788,723,44947,47,28540
"Gallaway city, Tennessee",216,164,52,664,47,28560
"Garland town, Tennessee",154,151,3,284,47,28680
"Gates town, Tennessee",276,223,53,693,47,28740
"Gatlinburg city, Tennessee",1763,1675,88,3636,47,28800
"Germantown city, Tennessee",19504,18949,555,41094,47,28960
"Gibson town, Tennessee",238,226,12,553,47,29020
"Gilt Edge city, Tennessee",273,264,9,513,47,29160
"Gladeville CDP, Tennessee",1399,1332,67,2034,47,29260
"Gleason town, Tennessee",636,631,5,1196,47,29300
"Goodlettsville city, Tennessee",9390,8845,545,17500,47,29920
"Gordonsville town, Tennessee",779,762,17,1469,47,30120
"Graball CDP, Tennessee",85,71,14,142,47,30220
"Grand Junction city, Tennessee",246,215,31,430,47,30280
"Gray CDP, Tennessee",345,345,0,1276,47,30700
"Graysville town, Tennessee",715,614,101,1548,47,30760
"Greenback city, Tennessee",648,635,13,1472,47,30880
"Greenbrier town, Tennessee",3787,3763,24,6954,47,30960
"Greeneville town, Tennessee",6530,5930,600,15458,47,30980
"Greenfield city, Tennessee",898,844,54,2297,47,31000
"Green Hill CDP, Tennessee",3402,3178,224,6773,47,31100
"Greenvale CDP, Tennessee",70,70,0,120,47,31220
"Griffith Creek CDP, Tennessee",67,67,0,464,47,31400
"Grimsley CDP, Tennessee",480,381,99,795,47,31420
"Gruetli-Laager city, Tennessee",669,613,56,1585,47,31490
"Guys town, Tennessee",188,164,24,385,47,31680
"Halls CDP, Tennessee",4656,4618,38,9955,47,31810
"Halls town, Tennessee",795,777,18,1919,47,31820
"Hampton CDP, Tennessee",654,601,53,1419,47,32040
"Harriman city, Tennessee",2736,2642,94,6000,47,32520
"Harrison CDP, Tennessee",4801,4715,86,8313,47,32600
"Harrogate city, Tennessee",1941,1884,57,4371,47,32640
"Hartsville/Trousdale County, Tennessee",5162,5122,40,11596,47,32742
"Helenwood CDP, Tennessee",74,0,74,140,47,33120
"Henderson city, Tennessee",2266,2182,84,6326,47,33260
"Hendersonville city, Tennessee",34002,32570,1432,61589,47,33280
"Henning town, Tennessee",556,432,124,1320,47,33360
"Henry town, Tennessee",286,253,33,575,47,33400
"Hickman CDP, Tennessee",157,157,0,357,47,33680
"Hickory Valley town, Tennessee",88,74,14,139,47,33920
"Hilham CDP, Tennessee",160,160,0,302,47,34580
"Hillsboro CDP, Tennessee",85,53,32,311,47,34700
"Hohenwald city, Tennessee",1566,1350,216,3734,47,35160
"Holladay CDP, Tennessee",31,31,0,99,47,35220
"Hollow Rock town, Tennessee",358,324,34,777,47,35280
"Hopewell CDP, Tennessee",1335,1293,42,2619,47,35880
"Hornbeak town, Tennessee",238,224,14,502,47,36000
"Hornsby town, Tennessee",132,122,10,313,47,36080
"Humboldt city, Tennessee",3783,3515,268,7851,47,36460
"Hunter CDP, Tennessee",1070,1061,9,2121,47,36500
"Huntingdon town, Tennessee",1778,1778,0,4384,47,36580
"Huntland town, Tennessee",492,485,7,1218,47,36600
"Huntsville town, Tennessee",686,601,85,1889,47,36640
"Huron CDP, Tennessee",132,132,0,132,47,36700
"Iron City CDP, Tennessee",86,66,20,187,47,37360
"Jacksboro town, Tennessee",1199,1121,78,2775,47,37600
"Jacks Creek CDP, Tennessee",0,0,0,0,47,37620
"Jackson city, Tennessee",32717,29760,2957,67993,47,37640
"Jamestown city, Tennessee",781,724,57,2126,47,37780
"Jasper town, Tennessee",1609,1566,43,3592,47,37820
"Jefferson City city, Tennessee",4114,3836,278,8391,47,37960
"Jellico city, Tennessee",629,527,102,1808,47,38020
"John Sevier CDP, Tennessee",443,433,10,833,47,38300
"Johnson City city, Tennessee",36539,34309,2230,70720,47,38320
"Jonesborough town, Tennessee",2825,2816,9,5891,47,38540
"Kahite CDP, Tennessee",74,74,0,529,47,38765
"Karns CDP, Tennessee",2098,1880,218,3985,47,38800
"Kenton town, Tennessee",493,485,8,1413,47,39140
"Kimball town, Tennessee",750,721,29,1438,47,39400
"Kingsport city, Tennessee",24595,23289,1306,55415,47,39560
"Kingston city, Tennessee",2766,2563,203,5987,47,39620
"Kingston Springs town, Tennessee",1437,1382,55,2798,47,39660
"Knoxville city, Tennessee",102109,97188,4921,191857,47,40000
"Lafayette city, Tennessee",2383,2349,34,5555,47,40160
"La Follette city, Tennessee",3047,2666,381,7349,47,40180
"La Grange town, Tennessee",35,35,0,68,47,40200
"Lakeland city, Tennessee",6497,6297,200,13811,47,40350
"Lakesite city, Tennessee",1035,1016,19,2056,47,40540
"Lake Tansi CDP, Tennessee",1772,1709,63,4551,47,40560
"Lakewood Park CDP, Tennessee",419,394,25,1070,47,40732
"La Vergne city, Tennessee",21289,20431,858,38553,47,41200
"Lavinia CDP, Tennessee",11,11,0,56,47,41240
"Lawrenceburg city, Tennessee",4741,4301,440,11592,47,41340
"Lebanon city, Tennessee",19901,19300,601,39562,47,41520
"Lenoir City city, Tennessee",4701,4515,186,10291,47,41760
"Lenox CDP, Tennessee",204,204,0,515,47,41780
"Leoma CDP, Tennessee",60,55,5,240,47,41800
"Lewisburg city, Tennessee",5667,5221,446,12376,47,41860
"Lexington city, Tennessee",3218,2920,298,7927,47,41980
"Liberty town, Tennessee",203,185,18,380,47,42040
"Linden town, Tennessee",477,436,41,1469,47,42720
"Livingston town, Tennessee",1852,1818,34,3921,47,43140
"Lobelville city, Tennessee",398,356,42,949,47,43160
"Lone Oak CDP, Tennessee",625,625,0,1584,47,43420
"Lookout Mountain town, Tennessee",882,875,7,2128,47,43640
"Loretto city, Tennessee",782,766,16,1811,47,43700
"Loudon city, Tennessee",2539,2422,117,6069,47,43780
"Louisville city, Tennessee",2298,2195,103,4359,47,43820
"Luray CDP, Tennessee",131,131,0,142,47,44200
"Luttrell town, Tennessee",282,270,12,917,47,44300
"Lyles CDP, Tennessee",368,368,0,1060,47,44360
"Lynchburg, Moore County metropolitan government, Tennessee",3096,2967,129,6558,47,44382
"Lynnville town, Tennessee",177,150,27,382,47,44420
"McDonald CDP, Tennessee",405,364,41,638,47,44700
"McEwen city, Tennessee",866,691,175,1820,47,44840
"McKenzie city, Tennessee",2462,2339,123,5608,47,44940
"McLemoresville town, Tennessee",153,145,8,301,47,45000
"McMinnville city, Tennessee",5669,5366,303,13756,47,45100
"Madisonville city, Tennessee",2242,2075,167,5120,47,45320
"Manchester city, Tennessee",5864,5722,142,12325,47,45500
"Martin city, Tennessee",4844,4529,315,10823,47,46240
"Maryville city, Tennessee",15473,15045,428,31876,47,46380
"Mascot CDP, Tennessee",1358,1301,57,2715,47,46400
"Mason town, Tennessee",404,355,49,1221,47,46420
"Maury City town, Tennessee",393,371,22,844,47,46540
"Mayland CDP, Tennessee",149,139,10,285,47,46680
"Maynardville city, Tennessee",1076,986,90,2455,47,46700
"Medina city, Tennessee",2638,2560,78,5121,47,47000
"Medon city, Tennessee",113,102,11,248,47,47020
"Memphis city, Tennessee",311449,284621,26828,630027,47,48000
"Mercer CDP, Tennessee",11,11,0,51,47,48120
"Michie town, Tennessee",234,220,14,530,47,48180
"Middleton city, Tennessee",346,314,32,772,47,48340
"Middle Valley CDP, Tennessee",6295,6111,184,11619,47,48360
"Midtown CDP, Tennessee",412,380,32,1260,47,48460
"Milan city, Tennessee",3463,3293,170,8165,47,48660
"Milledgeville town, Tennessee",110,104,6,252,47,48920
"Millersville city, Tennessee",3392,3313,79,5818,47,48980
"Millington city, Tennessee",4295,3949,346,10558,47,49060
"Minor Hill city, Tennessee",309,298,11,707,47,49360
"Miston CDP, Tennessee",21,21,0,61,47,49420
"Mitchellville city, Tennessee",54,52,2,148,47,49460
"Monteagle town, Tennessee",647,561,86,1915,47,49740
"Monterey town, Tennessee",1111,1081,30,2751,47,49760
"Mooresburg CDP, Tennessee",427,388,39,903,47,49940
"Morris Chapel CDP, Tennessee",95,95,0,209,47,50200
"Morrison town, Tennessee",300,283,17,717,47,50220
"Morristown city, Tennessee",13051,11988,1063,30574,47,50280
"Moscow city, Tennessee",422,381,41,832,47,50300
"Mosheim town, Tennessee",930,924,6,2492,47,50320
"Mountain City town, Tennessee",835,759,76,2396,47,50400
"Mount Carmel town, Tennessee",2484,2341,143,5486,47,50580
"Mount Juliet city, Tennessee",20963,20172,791,39525,47,50780
"Mount Pleasant city, Tennessee",2149,2062,87,4781,47,51080
"Mowbray Mountain CDP, Tennessee",884,861,23,1902,47,51402
"Munford city, Tennessee",3358,3084,274,6357,47,51540
"Murfreesboro city, Tennessee",88337,84504,3833,153487,47,51560
"Nashville-Davidson metropolitan government (balance), Tennessee",401214,382791,18423,684103,47,52006
"Newbern town, Tennessee",1377,1340,37,3321,47,52400
"New Deal CDP, Tennessee",108,108,0,263,47,52520
"New Hope city, Tennessee",418,377,41,839,47,52780
"New Johnsonville city, Tennessee",881,861,20,1844,47,52820
"New Market town, Tennessee",958,934,24,1786,47,52940
"Newport city, Tennessee",2816,2644,172,6850,47,53000
"New Tazewell town, Tennessee",1345,1309,36,2780,47,53140
"New Union CDP, Tennessee",780,764,16,1728,47,53240
"Niota city, Tennessee",391,355,36,705,47,53380
"Nixon CDP, Tennessee",37,37,0,286,47,53400
"Nolensville town, Tennessee",7925,7866,59,14444,47,53460
"Norene CDP, Tennessee",212,162,50,266,47,53520
"Normandy town, Tennessee",58,58,0,121,47,53580
"Norris city, Tennessee",648,644,4,1592,47,53600
"Oakdale town, Tennessee",93,88,5,230,47,54280
"Oak Grove CDP (Sumner County), Tennessee",80,74,6,162,47,54640
"Oak Grove CDP (Washington County), Tennessee",2162,1947,215,4422,47,54700
"Oak Hill city, Tennessee",2577,2532,45,4764,47,54780
"Oakland town, Tennessee",4881,4725,156,9139,47,54920
"Oak Ridge city, Tennessee",14111,13325,786,31535,47,55120
"Obion town, Tennessee",475,463,12,1066,47,55240
"Ocoee CDP, Tennessee",180,130,50,214,47,55280
"Oliver Springs town, Tennessee",1220,1145,75,3727,47,55800
"Olivet CDP, Tennessee",609,609,0,1314,47,55820
"Oneida town, Tennessee",1388,1311,77,3799,47,55860
"Ooltewah CDP, Tennessee",176,176,0,462,47,55900
"Orebank CDP, Tennessee",444,391,53,842,47,55980
"Orlinda city, Tennessee",596,570,26,1056,47,56020
"Orme town, Tennessee",8,8,0,43,47,56040
"Palmer town, Tennessee",360,324,36,882,47,56560
"Palmersville CDP, Tennessee",50,50,0,142,47,56580
"Paris city, Tennessee",4223,4102,121,10311,47,56720
"Park City CDP, Tennessee",2027,1951,76,3471,47,56800
"Parker's Crossroads city, Tennessee",187,187,0,598,47,56870
"Parrottsville town, Tennessee",151,146,5,351,47,57040
"Parsons city, Tennessee",1045,970,75,2452,47,57080
"Pegram town, Tennessee",1197,1164,33,2167,47,57480
"Pelham CDP, Tennessee",224,224,0,419,47,57500
"Petersburg town, Tennessee",245,233,12,556,47,57740
"Petros CDP, Tennessee",63,63,0,502,47,57780
"Philadelphia city, Tennessee",475,391,84,916,47,57900
"Pigeon Forge city, Tennessee",2908,2858,50,6345,47,58080
"Pikeville city, Tennessee",1030,961,69,2541,47,58120
"Pine Crest CDP, Tennessee",1159,1051,108,2082,47,58240
"Pinson CDP, Tennessee",156,156,0,419,47,58780
"Piperton city, Tennessee",1305,1239,66,2350,47,58840
"Pittman Center town, Tennessee",271,269,2,520,47,58940
"Plainview city, Tennessee",1182,1145,37,2357,47,59020
"Pleasant Hill town, Tennessee",217,190,27,589,47,59240
"Pleasant View city, Tennessee",2715,2612,103,4945,47,59560
"Pocahontas CDP, Tennessee",52,52,0,233,47,59640
"Portland city, Tennessee",7373,7094,279,13177,47,60280
"Powell CDP, Tennessee",7365,7069,296,13991,47,60480
"Powells Crossroads town, Tennessee",814,772,42,1686,47,60500
"Prospect CDP, Tennessee",24,24,0,93,47,60800
"Pulaski city, Tennessee",3261,3020,241,8301,47,61040
"Puryear city, Tennessee",323,303,20,820,47,61160
"Ramer city, Tennessee",142,135,7,386,47,61520
"Randolph CDP, Tennessee",56,52,4,188,47,61560
"Rarity Bay CDP, Tennessee",177,177,0,787,47,61635
"Red Bank city, Tennessee",7377,7125,252,11919,47,61960
"Red Boiling Springs city, Tennessee",369,332,37,1347,47,62000
"Riceville CDP, Tennessee",411,411,0,964,47,62580
"Ridgely town, Tennessee",551,505,46,1798,47,63060
"Ridgeside city, Tennessee",428,425,3,919,47,63080
"Ridgetop city, Tennessee",1076,1014,62,2376,47,63140
"Ripley city, Tennessee",3071,2776,295,7794,47,63340
"Rives town, Tennessee",91,85,6,204,47,63800
"Roan Mountain CDP, Tennessee",432,414,18,984,47,63840
"Robbins CDP, Tennessee",16,16,0,109,47,63920
"Rockford city, Tennessee",424,410,14,849,47,64160
"Rockvale CDP, Tennessee",595,584,11,1631,47,64400
"Rockwood city, Tennessee",2180,2015,165,5468,47,64440
"Rocky Top city, Tennessee",809,688,121,1845,47,64668
"Rogersville town, Tennessee",1841,1646,195,4630,47,64820
"Rossville town, Tennessee",712,648,64,1185,47,65240
"Rural Hill CDP, Tennessee",972,904,68,2016,47,65642
"Russellville CDP, Tennessee",410,410,0,850,47,65740
"Rutherford town, Tennessee",511,490,21,1221,47,65760
"Rutledge town, Tennessee",616,592,24,1550,47,65820
"St. Joseph city, Tennessee",363,351,12,785,47,66160
"Sale Creek CDP, Tennessee",1162,1115,47,3065,47,66220
"Saltillo town, Tennessee",322,300,22,730,47,66340
"Samburg town, Tennessee",89,84,5,219,47,66360
"Sardis town, Tennessee",152,132,20,434,47,66660
"Saulsbury town, Tennessee",92,60,32,239,47,66680
"Savannah city, Tennessee",2551,2509,42,7206,47,66720
"Scotts Hill town, Tennessee",388,373,15,1200,47,66880
"Selmer town, Tennessee",1672,1595,77,4444,47,66940
"Sequatchie CDP, Tennessee",135,66,69,493,47,66960
"Sevierville city, Tennessee",8424,8229,195,17986,47,67120
"Sewanee CDP, Tennessee",1450,1440,10,2922,47,67140
"Seymour CDP, Tennessee",8123,7638,485,16081,47,67200
"Shackle Island CDP, Tennessee",2688,2523,165,4375,47,67230
"Sharon town, Tennessee",466,448,18,1168,47,67540
"Shelbyville city, Tennessee",11717,11245,472,23676,47,67760
"Sherwood CDP, Tennessee",0,0,0,9,47,67920
"Shiloh CDP, Tennessee",106,106,0,150,47,68040
"Signal Mountain town, Tennessee",3640,3578,62,8833,47,68540
"Silerton town, Tennessee",41,41,0,85,47,68560
"Slayden town, Tennessee",78,74,4,157,47,69080
"Smithville city, Tennessee",1541,1454,87,5059,47,69320
"Smyrna town, Tennessee",30717,29050,1667,53760,47,69420
"Sneedville town, Tennessee",501,433,68,1590,47,69460
"Soddy-Daisy city, Tennessee",6156,5945,211,13091,47,69560
"Somerville town, Tennessee",1287,1233,54,3385,47,69620
"South Carthage town, Tennessee",762,751,11,1698,47,69680
"South Cleveland CDP, Tennessee",3485,3120,365,7188,47,69740
"South Fulton city, Tennessee",987,947,40,2285,47,69900
"South Pittsburg city, Tennessee",1244,1178,66,3068,47,70060
"Sparta city, Tennessee",2181,1943,238,4950,47,70180
"Spencer town, Tennessee",534,533,1,1469,47,70240
"Spring City town, Tennessee",886,792,94,2294,47,70400
"Springfield city, Tennessee",8574,8087,487,18775,47,70500
"Spring Hill city, Tennessee",27318,27005,313,51319,47,70580
"Spurgeon CDP, Tennessee",1949,1933,16,4006,47,70680
"Stanton town, Tennessee",341,319,22,586,47,70820
"Stantonville town, Tennessee",152,151,1,400,47,70840
"Statesville CDP, Tennessee",180,180,0,272,47,70900
"Strawberry Plains CDP, Tennessee",1349,1277,72,2960,47,71500
"Sullivan Gardens CDP, Tennessee",684,684,0,1439,47,71800
"Summertown CDP, Tennessee",364,364,0,581,47,72040
"Sunbright city, Tennessee",291,254,37,880,47,72140
"Surgoinsville town, Tennessee",922,888,34,2316,47,72380
"Sweetwater city, Tennessee",2628,2381,247,6310,47,72540
"Taft CDP, Tennessee",79,75,4,201,47,72780
"Tazewell town, Tennessee",690,640,50,2207,47,73120
"Telford CDP, Tennessee",440,412,28,992,47,73220
"Tellico Plains town, Tennessee",463,433,30,1275,47,73260
"Tellico Village CDP, Tennessee",999,979,20,6224,47,73270
"Tennessee Ridge town, Tennessee",516,481,35,1400,47,73460
"Thompson's Station town, Tennessee",4045,3840,205,7426,47,73900
"Three Way city, Tennessee",956,917,39,1755,47,74100
"Tiptonville town, Tennessee",693,611,82,3832,47,74540
"Toone town, Tennessee",141,139,2,373,47,74640
"Townsend city, Tennessee",184,175,9,583,47,74860
"Tracy City town, Tennessee",759,734,25,2008,47,74880
"Trenton city, Tennessee",1570,1320,250,4202,47,75000
"Trezevant town, Tennessee",541,482,59,1142,47,75100
"Trimble town, Tennessee",292,288,4,610,47,75160
"Troy town, Tennessee",920,886,34,1941,47,75240
"Tuckers Crossroads CDP, Tennessee",36,36,0,67,47,75300
"Tullahoma city, Tennessee",10004,9593,411,21107,47,75320
"Tusculum city, Tennessee",1339,1288,51,3261,47,75560
"Unicoi town, Tennessee",1528,1407,121,3802,47,75820
"Union City city, Tennessee",5140,4688,452,11068,47,75940
"Unionville CDP, Tennessee",937,937,0,1943,47,76180
"Valley Forge CDP, Tennessee",936,901,35,2042,47,76660
"Vanleer town, Tennessee",329,312,17,605,47,76860
"Viola town, Tennessee",29,27,2,105,47,77400
"Vonore town, Tennessee",782,755,27,1730,47,77480
"Walden town, Tennessee",863,818,45,1802,47,77540
"Walland CDP, Tennessee",217,179,38,422,47,77700
"Walnut Grove CDP (Hardin County), Tennessee",95,95,0,249,47,77760
"Walnut Grove CDP (Sumner County), Tennessee",320,320,0,660,47,77820
"Walnut Hill CDP, Tennessee",1040,978,62,2648,47,77900
"Walterhill CDP, Tennessee",103,103,0,171,47,77980
"Wartburg city, Tennessee",399,364,35,1330,47,78100
"Wartrace town, Tennessee",275,248,27,656,47,78120
"Watauga city, Tennessee",303,235,68,714,47,78240
"Watertown city, Tennessee",757,740,17,1637,47,78320
"Waverly city, Tennessee",2223,1761,462,4284,47,78560
"Waynesboro city, Tennessee",803,740,63,2379,47,78600
"Westmoreland town, Tennessee",1268,1192,76,2711,47,79420
"Westpoint CDP, Tennessee",94,88,6,246,47,79500
"White Bluff town, Tennessee",2165,2139,26,3879,47,79980
"White House city, Tennessee",7661,7467,194,13305,47,80200
"White Pine town, Tennessee",1335,1254,81,2527,47,80360
"Whiteside CDP, Tennessee",30,30,0,174,47,80500
"Whiteville town, Tennessee",549,485,64,4734,47,80540
"Whitlock CDP, Tennessee",18,18,0,18,47,80580
"Whitwell city, Tennessee",943,892,51,1652,47,80620
"Wildersville CDP, Tennessee",89,69,20,165,47,80720
"Wildwood CDP, Tennessee",542,532,10,1064,47,80740
"Wildwood Lake CDP, Tennessee",1651,1558,93,3758,47,80760
"Williston city, Tennessee",264,233,31,530,47,81020
"Winchester city, Tennessee",4370,4232,138,9450,47,81080
"Winfield town, Tennessee",555,529,26,1306,47,81280
"Woodbury town, Tennessee",1259,1216,43,2704,47,81560
"Woodland Mills city, Tennessee",292,288,4,569,47,81700
"Wrigley CDP, Tennessee",159,159,0,475,47,82120
"Wynnburg CDP, Tennessee",8,8,0,15,47,82200
"Yorkville city, Tennessee",164,164,0,311,47,82360
"Yuma CDP, Tennessee",44,44,0,114,47,82440
"Abbott city, Texas",154,152,2,288,48,00100
"Abernathy city, Texas",1505,1481,24,3266,48,00160
"Abilene city, Texas",57670,56072,1598,126356,48,01000
"Abram CDP, Texas",564,492,72,1952,48,01060
"Acala CDP, Texas",0,0,0,31,48,01084
"Ackerly city, Texas",198,192,6,387,48,01108
"Addison town, Texas",12279,11879,400,17026,48,01240
"Adrian city, Texas",94,94,0,171,48,01324
"Agua Dulce CDP, Texas",1099,1043,56,2681,48,01390
"Agua Dulce city, Texas",184,160,24,436,48,01396
"Aguilares CDP, Texas",17,17,0,21,48,01420
"Airport Heights CDP, Texas",117,117,0,142,48,01500
"Airport Road Addition CDP, Texas",82,82,0,151,48,01514
"Alamo city, Texas",7509,6805,704,19811,48,01576
"Alamo Beach CDP, Texas",69,69,0,175,48,01594
"Alamo Heights city, Texas",4096,4050,46,7417,48,01600
"Alanreed CDP, Texas",31,31,0,33,48,01612
"Alba town, Texas",182,178,4,538,48,01636
"Albany city, Texas",848,749,99,1644,48,01648
"Aldine CDP, Texas",6405,5896,509,15511,48,01696
"Aledo city, Texas",2595,2544,51,5053,48,01744
"Alfred CDP, Texas",72,72,0,298,48,01816
"Alice city, Texas",7166,6927,239,17916,48,01852
"Alice Acres CDP, Texas",239,194,45,975,48,01858
"Allen city, Texas",57290,54832,2458,105444,48,01924
"Allison CDP, Texas",43,43,0,84,48,02032
"Alma town, Texas",250,242,8,469,48,02044
"Alpine city, Texas",3399,3281,118,5997,48,02104
"Alto town, Texas",431,389,42,1101,48,02188
"Alto Bonito Heights CDP, Texas",215,215,0,726,48,02194
"Alton city, Texas",7881,7150,731,18493,48,02212
"Alvarado city, Texas",2398,2366,32,5107,48,02260
"Alvin city, Texas",13709,13304,405,27325,48,02272
"Alvord town, Texas",512,472,40,1124,48,02284
"Amada Acres CDP, Texas",0,0,0,0,48,02286
"Amargosa CDP, Texas",142,142,0,364,48,02290
"Amarillo city, Texas",100365,96902,3463,200360,48,03000
"Amaya CDP, Texas",0,0,0,0,48,03008
"Ames city, Texas",284,247,37,987,48,03072
"Amherst city, Texas",370,365,5,1015,48,03084
"Amistad CDP, Texas",37,37,0,78,48,03096
"Anacua CDP, Texas",0,0,0,0,48,03126
"Anahuac city, Texas",1073,995,78,2420,48,03144
"Anderson city, Texas",128,127,1,289,48,03192
"Andrews city, Texas",7096,6907,189,13342,48,03216
"Angleton city, Texas",9555,9329,226,19452,48,03264
"Angus city, Texas",194,186,8,414,48,03288
"Anna city, Texas",10045,9699,346,18585,48,03300
"Annetta town, Texas",1579,1478,101,3077,48,03336
"Annetta North town, Texas",277,268,9,566,48,03340
"Annetta South town, Texas",390,378,12,780,48,03342
"Annona town, Texas",76,76,0,244,48,03360
"Anson city, Texas",868,846,22,2000,48,03372
"Anthony town, Texas",1726,1628,98,3811,48,03432
"Anton city, Texas",461,434,27,1094,48,03540
"Appleby city, Texas",284,268,16,490,48,03564
"Aquilla city, Texas",44,44,0,95,48,03588
"Aransas Pass city, Texas",3736,3559,177,8720,48,03600
"Archer City city, Texas",624,624,0,1549,48,03696
"Arcola city, Texas",1216,1117,99,2604,48,03708
"Argyle city, Texas",2692,2605,87,4638,48,03768
"Arlington city, Texas",213809,201941,11868,393469,48,04000
"Arp city, Texas",587,566,21,1367,48,04156
"Arroyo Colorado Estates CDP, Texas",185,185,0,764,48,04174
"Arroyo Gardens CDP, Texas",174,166,8,316,48,04176
"Asherton city, Texas",226,190,36,645,48,04300
"Aspermont town, Texas",533,521,12,1057,48,04408
"Atascocita CDP, Texas",47070,44731,2339,89121,48,04462
"Athens city, Texas",5930,5786,144,12878,48,04504
"Atlanta city, Texas",2549,2355,194,5453,48,04516
"Aubrey city, Texas",3192,3117,75,5932,48,04600
"Aurora city, Texas",747,696,51,1552,48,04672
"Austin city, Texas",596799,570555,26244,958202,48,05000
"Austwell city, Texas",59,57,2,115,48,05036
"Avery town, Texas",475,472,3,1024,48,05072
"Avinger town, Texas",168,146,22,470,48,05084
"Azle city, Texas",6586,6332,254,13409,48,05168
"Bacliff CDP, Texas",5032,4671,361,10313,48,05180
"Bailey city, Texas",121,106,15,249,48,05264
"Bailey's Prairie village, Texas",322,320,2,763,48,05288
"Baird city, Texas",859,800,59,1735,48,05336
"Balch Springs city, Texas",13569,12398,1171,27322,48,05372
"Balcones Heights city, Texas",1490,1419,71,2729,48,05384
"Ballinger city, Texas",1568,1473,95,3587,48,05456
"Balmorhea city, Texas",298,298,0,462,48,05468
"B and E CDP, Texas",0,0,0,83,48,05520
"Bandera city, Texas",304,272,32,565,48,05528
"Bangs city, Texas",789,782,7,1697,48,05552
"Banquete CDP, Texas",209,173,36,455,48,05576
"Bardwell city, Texas",323,287,36,668,48,05612
"Barksdale CDP, Texas",29,29,0,29,48,05648
"Barrera CDP, Texas",68,57,11,331,48,05690
"Barrett CDP, Texas",1837,1699,138,3488,48,05696
"Barry city, Texas",160,159,1,369,48,05708
"Barstow city, Texas",112,112,0,313,48,05720
"Bartlett city, Texas",729,717,12,1495,48,05732
"Barton Creek CDP, Texas",1414,1384,30,3234,48,05750
"Bartonville town, Texas",898,876,22,1957,48,05768
"Bastrop city, Texas",5504,5250,254,9955,48,05864
"Batesville CDP, Texas",418,403,15,1124,48,05924
"Bay City city, Texas",7751,6890,861,17869,48,05984
"Bayou Vista city, Texas",989,953,36,2006,48,06060
"Bayside town, Texas",201,197,4,379,48,06104
"Baytown city, Texas",40824,37088,3736,84449,48,06128
"Bayview town, Texas",530,456,74,784,48,06140
"Beach City city, Texas",1943,1865,78,3126,48,06200
"Bear Creek village, Texas",246,231,15,485,48,06242
"Bear Creek Ranch CDP, Texas",1525,1462,63,2189,48,06244
"Beasley city, Texas",418,334,84,984,48,06272
"Beaumont city, Texas",52791,49983,2808,114573,48,07000
"Beauxart Gardens CDP, Texas",517,492,25,863,48,07036
"Beaver Creek CDP, Texas",460,426,34,853,48,07042
"Beckville city, Texas",359,343,16,811,48,07108
"Bedford city, Texas",28039,26806,1233,49455,48,07132
"Bedias city, Texas",113,103,10,280,48,07144
"Bee Cave city, Texas",4508,4455,53,8771,48,07156
"Beeville city, Texas",6298,5799,499,13637,48,07192
"Bellaire city, Texas",8389,8181,208,17163,48,07300
"Bellevue city, Texas",192,184,8,426,48,07396
"Bellmead city, Texas",4160,4062,98,10480,48,07408
"Bells town, Texas",1039,919,120,2067,48,07420
"Bellville city, Texas",1891,1891,0,4200,48,07432
"Belterra CDP, Texas",3121,2961,160,6678,48,07486
"Belton city, Texas",10298,9929,369,23137,48,07492
"Ben Arnold CDP, Texas",44,44,0,93,48,07516
"Benavides city, Texas",456,456,0,1409,48,07528
"Ben Bolt CDP, Texas",1151,1040,111,2424,48,07540
"Benbrook city, Texas",12710,12160,550,24366,48,07552
"Benjamin city, Texas",87,87,0,214,48,07636
"Benjamin Perez CDP, Texas",87,87,0,110,48,07642
"Ben Wheeler CDP, Texas",882,882,0,1958,48,07708
"Berryville town, Texas",399,378,21,1169,48,07852
"Bertram city, Texas",862,816,46,1832,48,07864
"Beverly Hills city, Texas",968,925,43,1905,48,08104
"Bevil Oaks city, Texas",484,448,36,1181,48,08128
"Bigfoot CDP, Texas",735,735,0,1012,48,08164
"Big Lake city, Texas",1452,1337,115,2977,48,08212
"Big Sandy town, Texas",645,582,63,1458,48,08224
"Big Spring city, Texas",10528,9813,715,25949,48,08236
"Big Thicket Lake Estates CDP, Texas",254,236,18,595,48,08240
"Big Wells city, Texas",145,122,23,432,48,08260
"Bishop city, Texas",1286,1179,107,3162,48,08392
"Bishop Hills town, Texas",88,87,1,242,48,08398
"Bivins CDP, Texas",22,22,0,183,48,08404
"Bixby CDP, Texas",133,133,0,427,48,08410
"Blackwell city, Texas",102,102,0,199,48,08488
"Blanco city, Texas",1107,1077,30,2147,48,08536
"Blanket town, Texas",197,196,1,388,48,08596
"Bledsoe CDP, Texas",24,24,0,104,48,08644
"Blessing CDP, Texas",130,130,0,337,48,08668
"Bloomburg town, Texas",136,136,0,288,48,08752
"Blooming Grove town, Texas",360,345,15,764,48,08788
"Bloomington CDP, Texas",301,263,38,1189,48,08800
"Blossom city, Texas",623,608,15,1261,48,08812
"Blue Berry Hill CDP, Texas",480,474,6,705,48,08830
"Blue Mound city, Texas",1336,1282,54,2622,48,08860
"Blue Ridge city, Texas",524,508,16,982,48,08872
"Bluetown CDP, Texas",143,140,3,619,48,08908
"Bluff Dale CDP, Texas",48,48,0,111,48,08932
"Blum town, Texas",239,239,0,402,48,09004
"Boerne city, Texas",8979,8752,227,18475,48,09160
"Bogata city, Texas",340,323,17,1068,48,09172
"Boling CDP, Texas",549,469,80,1044,48,09232
"Bolivar Peninsula CDP, Texas",915,915,0,2626,48,09250
"Bonanza Hills CDP, Texas",0,0,0,0,48,09310
"Bonham city, Texas",3612,3386,226,10485,48,09328
"Bonney village, Texas",134,109,25,197,48,09388
"Booker town, Texas",716,670,46,1398,48,09448
"Borger city, Texas",6065,5874,191,12505,48,09556
"Botines CDP, Texas",13,13,0,13,48,09598
"Bovina city, Texas",610,597,13,1338,48,09628
"Bowie city, Texas",2237,2184,53,5483,48,09640
"Box Canyon CDP, Texas",19,19,0,80,48,09656
"Boyd town, Texas",724,708,16,1522,48,09748
"Boys Ranch CDP, Texas",39,39,0,126,48,09796
"Brackettville city, Texas",617,591,26,1408,48,09868
"Brady city, Texas",2423,2169,254,5129,48,09916
"Brazoria city, Texas",1284,1248,36,2875,48,10072
"Brazos CDP, Texas",21,21,0,74,48,10084
"Brazos Country city, Texas",377,359,18,581,48,10090
"Breckenridge city, Texas",2522,2191,331,5230,48,10132
"Bremond city, Texas",408,383,25,893,48,10144
"Brenham city, Texas",7654,7356,298,17655,48,10156
"Briar CDP, Texas",3141,3042,99,6227,48,10192
"Briarcliff village, Texas",1139,1116,23,2273,48,10197
"Briaroaks city, Texas",327,322,5,714,48,10216
"Bridge City city, Texas",4780,4693,87,9461,48,10252
"Bridgeport city, Texas",2942,2857,85,6044,48,10264
"Briggs CDP, Texas",21,21,0,55,48,10276
"Bristol CDP, Texas",335,335,0,591,48,10336
"Broaddus town, Texas",128,114,14,246,48,10384
"Bronte town, Texas",404,404,0,989,48,10528
"Brookshire city, Texas",2375,2188,187,5187,48,10636
"Brookside Village city, Texas",695,656,39,1357,48,10648
"Brookston CDP, Texas",39,39,0,39,48,10660
"Browndell city, Texas",29,27,2,88,48,10708
"Brownfield city, Texas",3965,3735,230,8912,48,10720
"Brownsboro city, Texas",754,735,19,1490,48,10756
"Brownsville city, Texas",80893,75831,5062,186999,48,10768
"Brownwood city, Texas",9232,8934,298,18820,48,10780
"Bruceville-Eddy city, Texas",769,731,38,1639,48,10828
"Brundage CDP, Texas",0,0,0,0,48,10852
"Bruni CDP, Texas",234,234,0,447,48,10876
"Brushy Creek CDP, Texas",12363,11947,416,22282,48,10897
"Bryan city, Texas",41712,39662,2050,84820,48,10912
"Bryson city, Texas",326,307,19,759,48,10960
"Buchanan Dam CDP, Texas",492,491,1,1274,48,10984
"Buchanan Lake Village CDP, Texas",143,124,19,532,48,10990
"Buckholts town, Texas",132,114,18,463,48,11020
"Buda city, Texas",7840,7558,282,14997,48,11080
"Buena Vista CDP, Texas",0,0,0,0,48,11102
"Buffalo city, Texas",808,720,88,1838,48,11116
"Buffalo Gap town, Texas",243,243,0,579,48,11128
"Buffalo Springs village, Texas",320,320,0,530,48,11155
"Bullard town, Texas",1674,1643,31,3573,48,11212
"Bulverde city, Texas",2651,2637,14,5827,48,11224
"Buna CDP, Texas",615,505,110,1908,48,11236
"Bunker Hill Village city, Texas",1472,1419,53,3820,48,11300
"Burkburnett city, Texas",5309,5041,268,10979,48,11368
"Burke city, Texas",274,230,44,505,48,11380
"Burleson city, Texas",25049,24094,955,48970,48,11428
"Burlington CDP, Texas",9,9,0,37,48,11440
"Burnet city, Texas",3082,2984,98,6464,48,11464
"Burton city, Texas",145,131,14,275,48,11536
"Bushland CDP, Texas",1386,1359,27,2640,48,11572
"Butterfield CDP, Texas",87,74,13,226,48,11626
"Byers city, Texas",116,112,4,319,48,11644
"Bynum town, Texas",121,108,13,246,48,11656
"Cactus city, Texas",1499,1458,41,3055,48,11692
"Caddo Mills city, Texas",1032,968,64,2051,48,11716
"Cade Lakes CDP, Texas",186,159,27,343,48,11725
"Caldwell city, Texas",1894,1890,4,4120,48,11836
"Callender Lake CDP, Texas",428,428,0,903,48,11940
"Callisburg city, Texas",175,173,2,302,48,11968
"Calvert city, Texas",407,367,40,996,48,11992
"Camargito CDP, Texas",129,129,0,258,48,12010
"Cameron city, Texas",2418,2294,124,5356,48,12040
"Cameron Park CDP, Texas",2252,2022,230,5830,48,12045
"Campbell city, Texas",419,325,94,974,48,12112
"Campo Verde CDP, Texas",148,148,0,197,48,12226
"Camp Swift CDP, Texas",2843,2803,40,6908,48,12334
"Camp Wood city, Texas",225,225,0,970,48,12388
"Canadian city, Texas",1171,1130,41,2330,48,12412
"Caney City town, Texas",58,58,0,149,48,12472
"Canton city, Texas",1742,1696,46,4279,48,12496
"Cantu Addition CDP, Texas",0,0,0,0,48,12502
"Canutillo CDP, Texas",2572,2501,71,6800,48,12508
"Canyon city, Texas",7624,7427,197,15089,48,12532
"Canyon Creek CDP, Texas",397,397,0,843,48,12562
"Canyon Lake CDP, Texas",14164,13734,430,32035,48,12580
"Cape Royale CDP, Texas",267,210,57,469,48,12600
"Carbon town, Texas",113,109,4,287,48,12736
"Carlsbad CDP, Texas",179,179,0,693,48,12892
"Carl's Corner town, Texas",178,150,28,317,48,12895
"Carlton CDP, Texas",10,10,0,10,48,12904
"Carmine city, Texas",76,71,5,231,48,12916
"Carrizo Hill CDP, Texas",307,307,0,1232,48,12982
"Carrizo Springs city, Texas",1194,1136,58,4888,48,12988
"Carrollton city, Texas",81066,78096,2970,132284,48,13024
"Carter CDP, Texas",1113,1065,48,1736,48,13075
"Carthage city, Texas",2775,2753,22,6549,48,13108
"Casa Blanca CDP, Texas",0,0,0,0,48,13128
"Casas CDP, Texas",0,0,0,0,48,13150
"Cashion Community city, Texas",144,144,0,317,48,13198
"Castle Hills city, Texas",1888,1864,24,3982,48,13276
"Castroville city, Texas",1376,1343,33,2994,48,13312
"Catarina CDP, Texas",25,25,0,65,48,13324
"Cedar Creek CDP, Texas",1193,1123,70,3950,48,13432
"Cedar Hill city, Texas",25596,23837,1759,48733,48,13492
"Cedar Park city, Texas",42261,40867,1394,76344,48,13552
"Cedar Point CDP, Texas",55,55,0,301,48,13570
"Celeste city, Texas",353,307,46,974,48,13672
"Celina city, Texas",11132,10956,176,21501,48,13684
"Center city, Texas",2507,2417,90,5221,48,13732
"Center Point CDP, Texas",1096,1044,52,1803,48,13828
"Centerville city, Texas",696,687,9,1266,48,13900
"Central Gardens CDP, Texas",2065,2012,53,3627,48,13972
"César Chávez CDP, Texas",754,697,57,1817,48,14038
"Chandler city, Texas",1596,1514,82,3308,48,14224
"Channelview CDP, Texas",19572,18395,1177,43204,48,14236
"Channing city, Texas",97,96,1,244,48,14260
"Chaparrito CDP, Texas",186,186,0,202,48,14266
"Chapeno CDP, Texas",0,0,0,17,48,14290
"Charlotte city, Texas",559,525,34,1324,48,14404
"Chester town, Texas",132,123,9,262,48,14584
"Chico city, Texas",547,478,69,1224,48,14620
"Childress city, Texas",2577,2323,254,5786,48,14668
"Chillicothe city, Texas",312,309,3,585,48,14680
"Chilton CDP, Texas",526,377,149,1095,48,14692
"China city, Texas",480,442,38,1022,48,14704
"China Grove town, Texas",714,699,15,1660,48,14716
"China Spring CDP, Texas",648,648,0,1412,48,14740
"Chireno city, Texas",210,193,17,578,48,14776
"Christine town, Texas",98,80,18,213,48,14860
"Christoval CDP, Texas",101,101,0,189,48,14872
"Chula Vista CDP (Cameron County), Texas",43,43,0,121,48,14880
"Chula Vista CDP (Maverick County), Texas",1231,1213,18,4317,48,14881
"Chula Vista CDP (Zavala County), Texas",84,57,27,416,48,14882
"Cibolo city, Texas",15353,14479,874,32640,48,14920
"Cienegas Terrace CDP, Texas",752,732,20,1653,48,14927
"Cinco Ranch CDP, Texas",8728,8325,403,18856,48,14929
"Circle D-KC Estates CDP, Texas",1282,1282,0,2500,48,14986
"Cisco city, Texas",1873,1751,122,3901,48,15004
"Citrus City CDP, Texas",1255,901,354,2920,48,15028
"Clarendon city, Texas",642,642,0,1730,48,15112
"Clarksville city, Texas",898,804,94,2868,48,15160
"Clarksville City city, Texas",419,392,27,1009,48,15172
"Claude city, Texas",528,528,0,1218,48,15196
"Clay CDP, Texas",0,0,0,19,48,15232
"Clear Lake Shores city, Texas",626,595,31,1232,48,15328
"Cleburne city, Texas",14649,14258,391,31849,48,15364
"Cleveland city, Texas",3074,2999,75,7756,48,15436
"Clifton city, Texas",1583,1500,83,3487,48,15472
"Clint town, Texas",294,287,7,1010,48,15544
"Cloverleaf CDP, Texas",10935,10106,829,24735,48,15628
"Clute city, Texas",5980,5468,512,10670,48,15652
"Clyde city, Texas",1750,1646,104,3850,48,15676
"Coahoma town, Texas",339,336,3,756,48,15700
"Cockrell Hill city, Texas",1878,1713,165,3799,48,15796
"Coffee City town, Texas",92,90,2,253,48,15820
"Coldspring city, Texas",476,430,46,1221,48,15892
"Coleman city, Texas",1849,1674,175,3973,48,15916
"College Station city, Texas",63187,60214,2973,120451,48,15976
"Colleyville city, Texas",13135,12644,491,25876,48,15988
"Collinsville town, Texas",883,870,13,1762,48,16036
"Colmesneil city, Texas",312,309,3,728,48,16048
"Colorado Acres CDP, Texas",20,20,0,74,48,16110
"Colorado City city, Texas",1802,1774,28,3952,48,16120
"Columbus city, Texas",1629,1575,54,3686,48,16168
"Comanche city, Texas",2015,1935,80,4208,48,16192
"Combes town, Texas",1410,1386,24,3141,48,16204
"Combine city, Texas",1348,1263,85,2609,48,16216
"Comfort CDP, Texas",1040,963,77,1589,48,16228
"Commerce city, Texas",4503,4191,312,9078,48,16240
"Como town, Texas",292,272,20,560,48,16252
"Concepcion CDP, Texas",0,0,0,14,48,16300
"Conroe city, Texas",46395,44800,1595,92475,48,16432
"Converse city, Texas",13179,12646,533,28052,48,16468
"Cool city, Texas",65,65,0,122,48,16540
"Coolidge town, Texas",320,316,4,850,48,16552
"Cooper city, Texas",826,817,9,1910,48,16564
"Coppell city, Texas",23807,23360,447,42513,48,16612
"Copperas Cove city, Texas",15629,14440,1189,36436,48,16624
"Copper Canyon town, Texas",1112,1042,70,2125,48,16636
"Corinth city, Texas",12476,12148,328,22502,48,16696
"Corpus Christi city, Texas",155138,146502,8636,317804,48,17000
"Corrigan town, Texas",886,745,141,2018,48,17036
"Corsicana city, Texas",11753,10847,906,25107,48,17060
"Cottonwood city, Texas",228,212,16,371,48,17200
"Cottonwood Shores city, Texas",864,842,22,1481,48,17208
"Cotulla city, Texas",1459,1373,86,3714,48,17216
"Coupland city, Texas",169,168,1,481,48,17312
"Cove city, Texas",203,187,16,399,48,17336
"Covington city, Texas",137,137,0,298,48,17372
"Coyanosa CDP, Texas",20,15,5,82,48,17408
"Coyote Acres CDP, Texas",284,254,30,678,48,17426
"Coyote Flats city, Texas",154,151,3,337,48,17429
"Crandall city, Texas",2184,2063,121,4028,48,17504
"Crane city, Texas",1779,1742,37,3456,48,17516
"Cranfills Gap city, Texas",130,130,0,307,48,17540
"Crawford town, Texas",391,368,23,852,48,17564
"Creedmoor city, Texas",208,208,0,407,48,17612
"Cresson city, Texas",527,516,11,1435,48,17648
"Crockett city, Texas",2603,2541,62,6365,48,17744
"Crosby CDP, Texas",1124,1087,37,2064,48,17756
"Crosbyton city, Texas",665,615,50,1657,48,17768
"Cross Mountain CDP, Texas",2133,2083,50,4523,48,17811
"Cross Plains town, Texas",420,416,4,1143,48,17816
"Cross Roads town, Texas",981,904,77,1716,48,17852
"Cross Timber town, Texas",202,173,29,532,48,17917
"Crowell city, Texas",338,332,6,770,48,17948
"Crowley city, Texas",9554,8998,556,18392,48,17960
"Crystal City city, Texas",2660,2535,125,6332,48,18020
"Cuero city, Texas",2900,2683,217,8138,48,18092
"Cuevitas CDP, Texas",0,0,0,0,48,18104
"Cumby city, Texas",331,306,25,756,48,18128
"Cumings CDP, Texas",925,723,202,1497,48,18134
"Cuney town, Texas",68,67,1,163,48,18152
"Cushing city, Texas",283,264,19,723,48,18224
"Cut and Shoot city, Texas",467,458,9,1003,48,18260
"Daingerfield city, Texas",1021,930,91,2502,48,18464
"Daisetta city, Texas",423,386,37,1059,48,18476
"Dalhart city, Texas",4344,4247,97,8013,48,18524
"Dallas city, Texas",697945,663340,34605,1300642,48,19000
"Dalworthington Gardens city, Texas",1196,1144,52,2437,48,19084
"Damon CDP, Texas",33,22,11,108,48,19108
"Danbury city, Texas",588,555,33,1465,48,19120
"Darrouzett town, Texas",150,146,4,260,48,19288
"Dawson town, Texas",526,487,39,1070,48,19420
"Dayton city, Texas",4053,3910,143,8839,48,19432
"Dayton Lakes city, Texas",22,8,14,69,48,19435
"Dean city, Texas",198,196,2,453,48,19456
"Deanville CDP, Texas",14,14,0,14,48,19492
"Decatur city, Texas",3386,3335,51,6781,48,19528
"DeCordova city, Texas",1301,1247,54,3035,48,19570
"Deer Park city, Texas",16711,15890,821,34046,48,19624
"Deerwood CDP, Texas",675,675,0,1649,48,19632
"De Kalb city, Texas",560,512,48,1610,48,19648
"De Leon city, Texas",1086,996,90,2108,48,19672
"Dell City city, Texas",33,28,5,82,48,19708
"Del Mar Heights CDP, Texas",15,15,0,86,48,19714
"Delmita CDP, Texas",76,76,0,164,48,19732
"Del Rio city, Texas",14964,14569,395,34722,48,19792
"Del Sol CDP, Texas",115,115,0,267,48,19808
"Denison city, Texas",11337,10742,595,24872,48,19900
"Dennis CDP, Texas",458,444,14,882,48,19924
"Denton city, Texas",81194,77282,3912,142262,48,19972
"Denver City town, Texas",2108,2036,72,4418,48,19984
"Deport city, Texas",335,332,3,773,48,20020
"DeSoto city, Texas",30612,28234,2378,55882,48,20092
"Detroit town, Texas",228,214,14,628,48,20128
"Devers city, Texas",189,158,31,410,48,20140
"Devine city, Texas",1932,1932,0,4375,48,20152
"Deweyville CDP, Texas",219,205,14,517,48,20212
"D'Hanis CDP, Texas",198,195,3,563,48,20248
"Diboll city, Texas",1796,1672,124,4546,48,20308
"Dickens city, Texas",68,68,0,197,48,20332
"Dickinson city, Texas",10931,10455,476,21475,48,20344
"Dilley city, Texas",1361,1341,20,3342,48,20428
"Dime Box CDP, Texas",158,158,0,282,48,20452
"Dimmitt city, Texas",2188,2124,64,4169,48,20464
"DISH town, Texas",309,304,5,537,48,20540
"Dodd City town, Texas",262,257,5,454,48,20680
"Dodson town, Texas",12,10,2,41,48,20716
"Doffing CDP, Texas",1848,1749,99,5209,48,20734
"Domino town, Texas",5,5,0,21,48,20848
"Donna city, Texas",5850,5605,245,16742,48,20884
"Doolittle CDP, Texas",1632,1268,364,6019,48,20926
"Dorchester city, Texas",13,11,2,23,48,20932
"Double Oak town, Texas",1454,1415,39,3039,48,21028
"Double Horn city, Texas",120,120,0,364,48,21031
"Douglassville town, Texas",114,113,1,290,48,21112
"Draper town, Texas",0,0,0,0,48,21310
"Driftwood CDP, Texas",54,54,0,116,48,21412
"Dripping Springs city, Texas",2547,2462,85,5495,48,21424
"Driscoll city, Texas",271,261,10,722,48,21436
"Dublin city, Texas",1454,1420,34,3397,48,21484
"Dumas city, Texas",6747,6593,154,14404,48,21556
"Duncanville city, Texas",19342,17868,1474,40288,48,21628
"Eagle Lake city, Texas",1351,1244,107,3443,48,21844
"Eagle Pass city, Texas",12749,11876,873,28166,48,21892
"Early city, Texas",1485,1449,36,3116,48,21904
"Earth city, Texas",428,427,1,999,48,21928
"East Alto Bonito CDP, Texas",278,278,0,522,48,21958
"East Bernard city, Texas",914,827,87,2218,48,21988
"East Columbia CDP, Texas",55,55,0,156,48,22000
"Eastland city, Texas",1706,1637,69,3627,48,22132
"East Mountain city, Texas",396,383,13,918,48,22168
"Easton city, Texas",138,138,0,415,48,22192
"East Tawakoni city, Texas",460,436,24,893,48,22276
"Ector city, Texas",452,431,21,920,48,22516
"Edcouch city, Texas",1171,1080,91,2754,48,22528
"Eden city, Texas",427,421,6,1822,48,22552
"Edgecliff Village town, Texas",1858,1696,162,3715,48,22588
"Edgewater Estates CDP, Texas",21,21,0,21,48,22593
"Edgewood town, Texas",750,745,5,1724,48,22612
"Edinburg city, Texas",46382,43063,3319,100964,48,22660
"Edmonson town, Texas",55,53,2,114,48,22708
"Edna city, Texas",2549,2363,186,5985,48,22720
"Edom city, Texas",153,147,6,301,48,22744
"Edroy CDP, Texas",118,118,0,402,48,22768
"Eidson Road CDP, Texas",3542,3205,337,9685,48,22810
"Elbert CDP, Texas",2,2,0,9,48,22840
"El Brazil CDP, Texas",24,17,7,37,48,22853
"El Camino Angosto CDP, Texas",0,0,0,0,48,22858
"El Campo city, Texas",5327,4849,478,12242,48,22864
"El Castillo CDP, Texas",87,87,0,140,48,22892
"El Cenizo CDP, Texas",137,112,25,426,48,22898
"El Cenizo city, Texas",799,749,50,2226,48,22905
"El Chaparral CDP, Texas",89,89,0,153,48,22920
"Eldorado city, Texas",789,764,25,1936,48,22960
"Electra city, Texas",857,808,49,2137,48,22984
"Elgin city, Texas",5618,5271,347,10043,48,23044
"Elias-Fela Solis CDP, Texas",0,0,0,0,48,23062
"El Indio CDP, Texas",0,0,0,0,48,23080
"Elkhart town, Texas",499,470,29,1212,48,23140
"El Lago city, Texas",1632,1587,45,3039,48,23164
"Ellinger city, Texas",116,116,0,210,48,23176
"Elm Creek CDP, Texas",1687,1572,115,3559,48,23254
"Elmendorf city, Texas",1057,897,160,2479,48,23272
"El Mesquite CDP, Texas",0,0,0,0,48,23278
"Elmo CDP, Texas",663,562,101,1002,48,23356
"E. Lopez CDP, Texas",37,37,0,84,48,23398
"El Paso city, Texas",317045,295529,21516,677181,48,24000
"El Quiote CDP, Texas",84,84,0,115,48,24013
"El Rancho Vela CDP, Texas",326,326,0,594,48,24015
"El Refugio CDP, Texas",349,331,18,737,48,24018
"Elsa city, Texas",2393,2326,67,5721,48,24036
"El Socio CDP, Texas",5,0,5,27,48,24055
"Emerald Bay CDP, Texas",250,239,11,969,48,24158
"Emhouse town, Texas",78,78,0,160,48,24168
"Emory city, Texas",668,648,20,1373,48,24216
"Encantada-Ranchito-El Calaboz CDP, Texas",872,872,0,2063,48,24223
"Enchanted Oaks town, Texas",118,116,2,252,48,24228
"Encinal city, Texas",486,476,10,1338,48,24240
"Encino CDP, Texas",52,28,24,102,48,24252
"Ennis city, Texas",11496,11144,352,20709,48,24348
"Escobares city, Texas",1018,917,101,2578,48,24552
"Estelline town, Texas",46,41,5,96,48,24636
"Eugenio Saenz CDP, Texas",68,68,0,309,48,24738
"Euless city, Texas",36014,34331,1683,60360,48,24768
"Eureka city, Texas",131,118,13,238,48,24816
"Eustace city, Texas",623,577,46,1457,48,24828
"Evadale CDP, Texas",546,490,56,883,48,24840
"Evant town, Texas",268,246,22,536,48,24864
"Evergreen CDP, Texas",84,84,0,88,48,24894
"Everman city, Texas",2734,2462,272,6102,48,24912
"Fabens CDP, Texas",2449,2347,102,5303,48,25032
"Fabrica CDP, Texas",256,224,32,918,48,25038
"Fairchilds village, Texas",382,363,19,814,48,25068
"Fairfield city, Texas",1286,1240,46,2867,48,25104
"Fair Oaks Ranch city, Texas",4581,4391,190,9917,48,25168
"Fairview town, Texas",4050,3971,79,10354,48,25224
"Falconaire CDP, Texas",0,0,0,19,48,25338
"Falcon Heights CDP, Texas",0,0,0,0,48,25344
"Falcon Lake Estates CDP, Texas",408,408,0,1037,48,25348
"Falcon Mesa CDP, Texas",29,3,26,118,48,25352
"Falcon Village CDP, Texas",0,0,0,0,48,25356
"Falfurrias city, Texas",2066,2054,12,4348,48,25368
"Falls City city, Texas",442,442,0,900,48,25392
"Falman CDP, Texas",0,0,0,15,48,25397
"Fannett CDP, Texas",741,736,5,1667,48,25404
"Farmers Branch city, Texas",22536,21880,656,35985,48,25452
"Farmersville city, Texas",1395,1337,58,3708,48,25488
"Farnsworth CDP, Texas",15,15,0,26,48,25512
"Farwell city, Texas",679,679,0,1530,48,25548
"Fate city, Texas",10041,9354,687,19010,48,25572
"Fayetteville city, Texas",162,162,0,288,48,25644
"Fernando Salinas CDP, Texas",0,0,0,0,48,25744
"Ferris city, Texas",1321,1310,11,2785,48,25752
"Fifth Street CDP, Texas",441,441,0,1523,48,25795
"Flat CDP, Texas",200,136,64,620,48,26004
"Flatonia town, Texas",793,791,2,1801,48,26028
"Flor del Rio CDP, Texas",0,0,0,0,48,26130
"Florence city, Texas",520,491,29,1017,48,26136
"Floresville city, Texas",3192,3067,125,7440,48,26160
"Flowella CDP, Texas",16,16,0,25,48,26220
"Flower Mound town, Texas",42299,40664,1635,76630,48,26232
"Floydada city, Texas",1182,1128,54,2670,48,26268
"Fluvanna CDP, Texas",72,72,0,72,48,26280
"Follett city, Texas",175,173,2,396,48,26328
"Forest Heights CDP, Texas",615,574,41,1482,48,26516
"Forest Hill city, Texas",6675,6169,506,13810,48,26544
"Forney city, Texas",14171,13465,706,25269,48,26604
"Forsan city, Texas",185,178,7,397,48,26640
"Fort Bliss CDP, Texas",1483,1350,133,12511,48,26664
"Fort Clark Springs CDP, Texas",577,577,0,1298,48,26680
"Fort Davis CDP, Texas",412,412,0,924,48,26688
"Fort Hancock CDP, Texas",567,567,0,1213,48,26724
"Fort Hood CDP, Texas",3622,3072,550,25476,48,26736
"Fort Stockton city, Texas",3929,3881,48,8404,48,26808
"Fort Worth city, Texas",480428,455182,25246,924663,48,27000
"Four Corners CDP, Texas",5866,5430,436,11504,48,27102
"Four Points CDP, Texas",0,0,0,0,48,27124
"Fowlerton CDP, Texas",0,0,0,0,48,27144
"Franklin city, Texas",572,517,55,1354,48,27288
"Frankston town, Texas",497,446,51,1282,48,27300
"Fredericksburg city, Texas",5265,5067,198,11020,48,27348
"Freeport city, Texas",4446,4165,281,10738,48,27420
"Freer city, Texas",1220,1140,80,2674,48,27432
"Fresno CDP, Texas",14168,13519,649,23608,48,27540
"Friendswood city, Texas",20462,19527,935,40888,48,27648
"Friona city, Texas",2091,2018,73,4125,48,27660
"Frisco city, Texas",109308,105099,4209,202075,48,27684
"Fritch city, Texas",1210,1114,96,2472,48,27696
"Fronton CDP, Texas",149,120,29,264,48,27744
"Fronton Ranchettes CDP, Texas",60,60,0,140,48,27748
"Frost city, Texas",346,340,6,740,48,27768
"Fruitvale city, Texas",205,193,12,480,48,27804
"Fulshear city, Texas",9944,9460,484,21552,48,27876
"Fulton town, Texas",371,360,11,1241,48,27888
"Gail CDP, Texas",88,88,0,232,48,27972
"Gainesville city, Texas",8623,8095,528,17459,48,27984
"Galena Park city, Texas",4386,3757,629,10641,48,27996
"Gallatin city, Texas",183,170,13,358,48,28008
"Galveston city, Texas",26640,24827,1813,53265,48,28068
"Ganado city, Texas",1072,1072,0,2318,48,28080
"Garceno CDP, Texas",21,21,0,67,48,28128
"Garciasville CDP, Texas",74,74,0,223,48,28152
"Garden City CDP, Texas",99,99,0,214,48,28176
"Gardendale CDP, Texas",653,653,0,1397,48,28200
"Garden Ridge city, Texas",2062,2008,54,4155,48,28248
"Garfield CDP, Texas",739,619,120,2015,48,28320
"Garland city, Texas",129853,123134,6719,244026,48,29000
"Garner CDP, Texas",241,233,8,373,48,29012
"Garrett town, Texas",478,433,45,1069,48,29036
"Garrison city, Texas",432,379,53,987,48,29060
"Garwood CDP, Texas",186,186,0,429,48,29096
"Gary City town, Texas",99,91,8,276,48,29108
"Garza-Salinas II CDP, Texas",140,140,0,513,48,29114
"Gatesville city, Texas",3141,2932,209,15848,48,29168
"Gause CDP, Texas",167,162,5,345,48,29216
"Georgetown city, Texas",31773,29969,1804,71788,48,29336
"George West city, Texas",1122,1089,33,2858,48,29348
"Geronimo CDP, Texas",600,589,11,1075,48,29384
"Gholson city, Texas",551,542,9,1088,48,29408
"Giddings city, Texas",2833,2795,38,5017,48,29432
"Gilmer city, Texas",1821,1662,159,4892,48,29564
"Girard CDP, Texas",11,4,7,25,48,29612
"Gladewater city, Texas",2459,2391,68,6166,48,29660
"Glazier CDP, Texas",0,0,0,0,48,29732
"Glenn Heights city, Texas",8904,8139,765,16445,48,29840
"Glen Rose city, Texas",1299,1265,34,2698,48,29876
"Glidden CDP, Texas",300,291,9,484,48,29912
"Godley city, Texas",902,846,56,1789,48,29972
"Goldsmith city, Texas",114,109,5,234,48,30044
"Goldthwaite city, Texas",987,948,39,1817,48,30056
"Goliad city, Texas",739,673,66,1816,48,30080
"Golinda city, Texas",418,410,8,883,48,30092
"Gonzales city, Texas",3103,3100,3,7190,48,30116
"Goodlow city, Texas",80,80,0,244,48,30188
"Goodrich city, Texas",157,144,13,282,48,30224
"Gordon city, Texas",237,226,11,543,48,30272
"Goree city, Texas",122,122,0,238,48,30296
"Gorman city, Texas",456,419,37,1238,48,30308
"Graford city, Texas",326,295,31,736,48,30380
"Graham city, Texas",4329,4263,66,8726,48,30392
"Granbury city, Texas",4762,4602,160,11218,48,30416
"Grandfalls town, Texas",68,59,9,230,48,30440
"Grand Prairie city, Texas",105106,99874,5232,197279,48,30464
"Grand Saline city, Texas",1357,1282,75,3137,48,30476
"Grandview city, Texas",890,876,14,1978,48,30512
"Granger city, Texas",536,492,44,1100,48,30548
"Grangerland CDP, Texas",356,356,0,679,48,30560
"Granite Shoals city, Texas",2278,2133,145,5161,48,30584
"Granjeno city, Texas",189,185,4,296,48,30608
"Grape Creek CDP, Texas",1854,1830,24,4391,48,30629
"Grapeland city, Texas",943,844,99,1849,48,30632
"Grapevine city, Texas",31810,30209,1601,50763,48,30644
"Grays Prairie village, Texas",226,222,4,351,48,30752
"Green Valley Farms CDP, Texas",185,168,17,468,48,30890
"Greenville city, Texas",14559,13624,935,28923,48,30920
"Gregory city, Texas",849,781,68,2077,48,31064
"Grey Forest city, Texas",433,415,18,727,48,31100
"Groesbeck city, Texas",1420,1406,14,3661,48,31280
"Groom town, Texas",216,216,0,440,48,31292
"Groves city, Texas",8152,7821,331,17110,48,31328
"Groveton city, Texas",376,317,59,991,48,31340
"Gruver city, Texas",700,671,29,1574,48,31412
"Guadalupe Guerra CDP, Texas",33,33,0,55,48,31442
"Guerra CDP, Texas",0,0,0,0,48,31484
"Gun Barrel City city, Texas",2628,2393,235,6247,48,31592
"Gunter city, Texas",1217,1161,56,2279,48,31616
"Gustine town, Texas",191,182,9,397,48,31628
"Guthrie CDP, Texas",67,63,4,156,48,31640
"Gutierrez CDP, Texas",4,4,0,9,48,31646
"Hackberry town, Texas",1567,1523,44,2862,48,31715
"Hale Center city, Texas",813,796,17,1866,48,31820
"Hallettsville city, Texas",1380,1300,80,2729,48,31868
"Hallsburg city, Texas",249,239,10,529,48,31880
"Hallsville city, Texas",2541,2502,39,4359,48,31904
"Haltom City city, Texas",23175,22298,877,45771,48,31928
"Hamilton city, Texas",1385,1354,31,2898,48,31952
"Hamlin city, Texas",1045,1028,17,2066,48,31964
"Hamshire CDP, Texas",946,939,7,1568,48,32012
"Happy town, Texas",265,261,4,625,48,32156
"Hardin city, Texas",279,276,3,721,48,32240
"Harding Gill Tract CDP, Texas",0,0,0,0,48,32246
"Hargill CDP, Texas",154,137,17,838,48,32300
"Harker Heights city, Texas",14809,14107,702,33036,48,32312
"Harlingen city, Texas",30667,29183,1484,71497,48,32372
"Harper CDP, Texas",520,457,63,1214,48,32456
"Harrold CDP, Texas",60,60,0,122,48,32552
"Hart city, Texas",464,443,21,1070,48,32576
"Hartley CDP, Texas",194,191,3,514,48,32612
"Harwood town, Texas",28,28,0,48,48,32684
"Haskell city, Texas",1353,1243,110,2956,48,32696
"Haslet city, Texas",1340,1334,6,2336,48,32720
"Havana CDP, Texas",81,81,0,248,48,32792
"Hawk Cove city, Texas",234,227,7,510,48,32810
"Hawkins city, Texas",967,886,81,1743,48,32816
"Hawley city, Texas",281,262,19,482,48,32840
"Hays city, Texas",60,55,5,138,48,32906
"H. Cuellar Estates CDP, Texas",0,0,0,0,48,32910
"Hearne city, Texas",2182,1846,336,4526,48,32972
"Heartland CDP, Texas",4663,4491,172,8669,48,32978
"Heath city, Texas",4394,4247,147,9771,48,32984
"Hebbronville CDP, Texas",1900,1803,97,4355,48,33008
"Hebron town, Texas",203,203,0,341,48,33020
"Hedley city, Texas",146,146,0,254,48,33044
"Hedwig Village city, Texas",1127,1075,52,2320,48,33068
"Heidelberg CDP, Texas",1107,717,390,1703,48,33092
"Helotes city, Texas",4561,4230,331,9140,48,33146
"Hemphill city, Texas",612,486,126,1439,48,33188
"Hempstead city, Texas",2493,2473,20,5686,48,33200
"Henderson city, Texas",4960,4646,314,13338,48,33212
"Henrietta city, Texas",1353,1336,17,3115,48,33284
"Hereford city, Texas",6926,6741,185,14943,48,33320
"Hermleigh CDP, Texas",135,122,13,429,48,33356
"Hewitt city, Texas",8264,7876,388,16034,48,33428
"Hickory Creek town, Texas",3590,3495,95,4906,48,33476
"Hico city, Texas",545,522,23,1627,48,33548
"Hidalgo city, Texas",6604,6088,516,14075,48,33560
"Hideaway city, Texas",1112,1112,0,3212,48,33578
"Higgins city, Texas",186,154,32,449,48,33608
"Highland Haven city, Texas",113,113,0,467,48,33794
"Highland Park town, Texas",3779,3599,180,8840,48,33824
"Highlands CDP, Texas",3121,2871,250,7359,48,33836
"Highland Village city, Texas",8540,8282,258,15883,48,33848
"Hill Country Village city, Texas",406,397,9,802,48,33968
"Hillcrest village, Texas",346,339,7,727,48,33980
"Hillsboro city, Texas",3655,3442,213,8281,48,34088
"Hillside Acres CDP, Texas",7,7,0,7,48,34105
"Hilltop CDP (Frio County), Texas",226,226,0,266,48,34130
"Hilltop CDP (Starr County), Texas",34,34,0,276,48,34133
"Hilltop Lakes CDP, Texas",346,339,7,737,48,34136
"Hilshire Village city, Texas",489,461,28,1099,48,34148
"Hitchcock city, Texas",3492,3313,179,7398,48,34220
"Holiday Beach CDP, Texas",105,86,19,291,48,34478
"Holiday Lakes town, Texas",331,309,22,834,48,34502
"Holland town, Texas",590,588,2,1297,48,34508
"Holliday city, Texas",787,737,50,1519,48,34532
"Holly Lake Ranch CDP, Texas",626,605,21,2523,48,34586
"Hollywood Park town, Texas",1408,1408,0,3123,48,34628
"Homestead Meadows North CDP, Texas",2596,2244,352,6707,48,34671
"Homestead Meadows South CDP, Texas",3510,3139,371,7861,48,34673
"Hondo city, Texas",3046,2958,88,8424,48,34676
"Honey Grove city, Texas",777,725,52,1950,48,34700
"Hooks city, Texas",1136,1065,71,2400,48,34736
"Horizon City city, Texas",10285,9254,1031,22537,48,34832
"Hornsby Bend CDP, Texas",6321,6218,103,11031,48,34856
"Horseshoe Bay city, Texas",1830,1766,64,4601,48,34862
"Horseshoe Bend CDP, Texas",279,263,16,754,48,34865
"Houston city, Texas",1207805,1128657,79148,2296253,48,35000
"Howardwick city, Texas",165,165,0,404,48,35072
"Howe town, Texas",1850,1752,98,3553,48,35084
"Hubbard city, Texas",601,571,30,1483,48,35180
"Huckabay CDP, Texas",154,146,8,270,48,35204
"Hudson city, Texas",2344,2159,185,4957,48,35228
"Hudson Bend CDP, Texas",2061,1980,81,3672,48,35253
"Hudson Oaks city, Texas",1181,1150,31,2396,48,35254
"Hughes Springs city, Texas",744,736,8,1621,48,35300
"Hull CDP, Texas",92,92,0,330,48,35324
"Humble city, Texas",8576,8055,521,16563,48,35348
"Hungerford CDP, Texas",58,58,0,134,48,35420
"Hunters Creek Village city, Texas",1928,1757,171,4383,48,35480
"Huntington city, Texas",1508,1460,48,3489,48,35492
"Huntsville city, Texas",19143,17430,1713,46202,48,35528
"Hurst city, Texas",21115,20470,645,40053,48,35576
"Hutchins city, Texas",2034,1953,81,5633,48,35612
"Hutto city, Texas",17417,16351,1066,29498,48,35624
"Huxley city, Texas",191,191,0,457,48,35636
"Iago CDP, Texas",4,4,0,5,48,35684
"Idalou city, Texas",1080,1053,27,2211,48,35732
"Iglesia Antigua CDP, Texas",92,92,0,92,48,35754
"Impact town, Texas",0,0,0,12,48,35816
"Imperial CDP, Texas",132,132,0,258,48,35828
"Indian Hills CDP, Texas",886,869,17,3188,48,35915
"Indian Lake town, Texas",430,404,26,1231,48,35918
"Indian Springs CDP, Texas",351,350,1,869,48,35954
"Indio CDP, Texas",0,0,0,0,48,35966
"Industry city, Texas",143,140,3,276,48,35984
"Inez CDP, Texas",1174,1149,25,2435,48,35996
"Ingleside city, Texas",4802,4720,82,9713,48,36008
"Ingleside on the Bay city, Texas",325,301,24,776,48,36020
"Ingram city, Texas",1070,1023,47,2003,48,36032
"Iola city, Texas",115,93,22,259,48,36068
"Iowa Colony village, Texas",4966,4589,377,9500,48,36092
"Iowa Park city, Texas",3684,3618,66,6529,48,36104
"Iraan city, Texas",584,584,0,1585,48,36128
"Iredell city, Texas",130,127,3,348,48,36140
"Irving city, Texas",141601,135777,5824,254962,48,37000
"Italy town, Texas",987,956,31,2329,48,37072
"Itasca city, Texas",1035,1025,10,2025,48,37084
"Ivanhoe city, Texas",411,351,60,1374,48,37112
"Jacinto City city, Texas",4624,4364,260,9589,48,37156
"Jacksboro city, Texas",1364,1225,139,4213,48,37168
"Jacksonville city, Texas",6180,5689,491,14104,48,37216
"Jamaica Beach city, Texas",647,558,89,1103,48,37252
"Jardin de San Julian CDP, Texas",0,0,0,0,48,37390
"Jarrell city, Texas",1281,1241,40,2132,48,37396
"Jasper city, Texas",3034,2741,293,7131,48,37420
"Jayton city, Texas",146,143,3,421,48,37468
"Jefferson city, Texas",984,878,106,2077,48,37528
"Jersey Village city, Texas",4065,3894,171,7763,48,37612
"Jewett city, Texas",257,228,29,634,48,37648
"J.F. Villareal CDP, Texas",94,94,0,329,48,37665
"Joaquin city, Texas",357,343,14,794,48,37684
"Johnson City city, Texas",888,848,40,1755,48,37780
"Jolly city, Texas",74,74,0,159,48,37924
"Jones Creek village, Texas",787,754,33,1936,48,37984
"Jonestown city, Texas",1221,1172,49,2395,48,38020
"Josephine city, Texas",1806,1734,72,3497,48,38068
"Joshua city, Texas",3973,3910,63,8004,48,38080
"Jourdanton city, Texas",1830,1725,105,4138,48,38116
"Juarez CDP, Texas",263,198,65,655,48,38168
"Junction city, Texas",1333,1317,16,2494,48,38248
"Justin city, Texas",2548,2382,166,4731,48,38332
"Karnes City city, Texas",1120,1107,13,3114,48,38452
"Katy city, Texas",11068,10347,721,22826,48,38476
"Kaufman city, Texas",3387,3211,176,7520,48,38488
"K-Bar Ranch CDP, Texas",218,218,0,611,48,38518
"Keene city, Texas",3063,2926,137,6451,48,38548
"Keller city, Texas",23225,22532,693,45320,48,38632
"Kemah city, Texas",1100,1033,67,1945,48,38776
"Kemp city, Texas",650,623,27,1419,48,38788
"Kempner city, Texas",754,739,15,1346,48,38800
"Kendleton city, Texas",94,94,0,239,48,38848
"Kenedy city, Texas",1602,1454,148,3467,48,38860
"Kenefick town, Texas",343,317,26,666,48,38872
"Kennard city, Texas",128,128,0,405,48,38884
"Kennedale city, Texas",4956,4721,235,8590,48,38896
"Kerens city, Texas",843,768,75,1931,48,38992
"Kermit city, Texas",2727,2648,79,5984,48,39004
"Kerrville city, Texas",10685,10419,266,24333,48,39040
"Kilgore city, Texas",6157,5861,296,13400,48,39124
"Killeen city, Texas",67398,60059,7339,153708,48,39148
"Kingsbury city, Texas",72,68,4,157,48,39292
"Kingsland CDP, Texas",2942,2716,226,7075,48,39304
"Kingsville city, Texas",12026,11045,981,25265,48,39352
"Kirby city, Texas",3929,3715,214,8134,48,39448
"Kirbyville city, Texas",954,729,225,2340,48,39460
"Kirvin town, Texas",69,66,3,123,48,39520
"Knippa CDP, Texas",579,557,22,1055,48,39664
"Knollwood city, Texas",325,274,51,494,48,39680
"Knox City town, Texas",316,312,4,898,48,39700
"Kopperl CDP, Texas",62,47,15,103,48,39784
"Kosse town, Texas",307,300,7,527,48,39844
"Kountze city, Texas",753,715,38,2042,48,39868
"Kress city, Texas",290,271,19,592,48,39904
"Krugerville city, Texas",1073,1035,38,2024,48,39916
"Krum city, Texas",3023,2978,45,5627,48,39928
"Kurten town, Texas",314,299,15,670,48,39940
"Kyle city, Texas",26699,25909,790,48484,48,39952
"La Blanca CDP, Texas",1230,1214,16,3326,48,39988
"La Carla CDP, Texas",33,33,0,85,48,39994
"La Casita CDP, Texas",0,0,0,0,48,40000
"La Chuparosa CDP, Texas",30,30,0,46,48,40018
"Lackland AFB CDP, Texas",1344,1266,78,7077,48,40036
"La Coma CDP, Texas",0,0,0,0,48,40100
"La Coma Heights CDP, Texas",119,119,0,172,48,40104
"LaCoste city, Texas",822,819,3,1604,48,40108
"Lacy-Lakeview city, Texas",3848,3690,158,7190,48,40168
"Ladonia town, Texas",323,253,70,746,48,40180
"La Escondida CDP, Texas",155,89,66,297,48,40186
"La Esperanza CDP, Texas",90,90,0,255,48,40188
"La Feria city, Texas",2496,2451,45,6848,48,40204
"La Feria North CDP, Texas",116,116,0,243,48,40210
"Lago CDP, Texas",8,8,0,27,48,40258
"Lago Vista CDP, Texas",48,32,16,88,48,40262
"Lago Vista city, Texas",4182,3972,210,9001,48,40264
"La Grange city, Texas",2131,1987,144,4416,48,40276
"La Grulla city, Texas",568,522,46,1375,48,40288
"Laguna Heights CDP, Texas",294,294,0,1482,48,40300
"Laguna Park CDP, Texas",464,444,20,1536,48,40312
"Laguna Seca CDP, Texas",187,181,6,277,48,40320
"Laguna Vista town, Texas",1271,1246,25,3555,48,40336
"La Homa CDP, Texas",4497,3901,596,10661,48,40342
"La Joya city, Texas",1898,1760,138,4525,48,40384
"Lake Bridgeport city, Texas",191,189,2,349,48,40450
"Lake Brownwood CDP, Texas",858,806,52,1699,48,40456
"Lake Bryan CDP, Texas",660,609,51,1438,48,40462
"Lake Cherokee CDP, Texas",1614,1565,49,3340,48,40468
"Lake City town, Texas",240,231,9,540,48,40472
"Lake Colorado City CDP, Texas",593,585,8,903,48,40475
"Lake Dallas city, Texas",4336,4217,119,7682,48,40516
"Lake Dunlap CDP, Texas",741,741,0,1484,48,40522
"Lakehills CDP, Texas",3055,2850,205,5955,48,40576
"Lake Jackson city, Texas",14592,13573,1019,27954,48,40588
"Lake Kiowa CDP, Texas",1250,1250,0,2728,48,40624
"Lake Medina Shores CDP, Texas",152,152,0,532,48,40674
"Lake Meredith Estates CDP, Texas",104,104,0,123,48,40676
"Lakeport city, Texas",490,478,12,1097,48,40696
"Lakeshore Gardens-Hidden Acres CDP, Texas",358,358,0,1131,48,40714
"Lakeside town (San Patricio County), Texas",135,135,0,310,48,40738
"Lakeside town (Tarrant County), Texas",980,956,24,1898,48,40744
"Lakeside City town, Texas",485,471,14,1091,48,40756
"Lake Tanglewood village, Texas",349,339,10,697,48,40804
"Lakeview town, Texas",26,26,0,38,48,40888
"Lake View CDP, Texas",180,166,14,376,48,40966
"Lakeway city, Texas",8775,8531,244,18835,48,40984
"Lakewood Village city, Texas",425,418,7,747,48,41050
"Lake Worth city, Texas",2688,2474,214,4701,48,41056
"La Loma de Falcon CDP, Texas",26,26,0,51,48,41086
"Lamar CDP, Texas",565,558,7,1559,48,41092
"La Marque city, Texas",9140,8361,779,18464,48,41116
"Lamesa city, Texas",3832,3410,422,8571,48,41164
"La Minita CDP, Texas",103,103,0,187,48,41170
"Lamkin CDP, Texas",6,6,0,14,48,41176
"La Moca Ranch CDP, Texas",10,10,0,34,48,41180
"Lampasas city, Texas",3349,3234,115,7377,48,41188
"Lancaster city, Texas",20233,18843,1390,40958,48,41212
"Lantana CDP, Texas",5408,5213,195,11706,48,41404
"La Paloma CDP, Texas",1185,1154,31,2806,48,41416
"La Paloma Addition CDP, Texas",88,88,0,181,48,41420
"La Paloma-Lost Creek CDP, Texas",236,227,9,621,48,41422
"La Paloma Ranchettes CDP, Texas",25,25,0,25,48,41424
"La Porte city, Texas",17564,16630,934,35782,48,41440
"La Presa CDP, Texas",87,87,0,220,48,41449
"La Pryor CDP, Texas",473,444,29,1090,48,41452
"La Puerta CDP, Texas",250,201,49,714,48,41458
"Laredo city, Texas",113888,107199,6689,255293,48,41464
"Laredo Ranchettes CDP, Texas",0,0,0,0,48,41473
"Laredo Ranchettes West CDP, Texas",0,0,0,0,48,41475
"La Rosita CDP, Texas",140,140,0,201,48,41503
"Lasana CDP, Texas",79,79,0,79,48,41542
"Lasara CDP, Texas",488,425,63,1065,48,41548
"Las Haciendas CDP, Texas",0,0,0,0,48,41565
"Las Lomas CDP, Texas",1019,815,204,2164,48,41566
"Las Lomitas CDP, Texas",31,31,0,56,48,41569
"Las Palmas CDP, Texas",39,39,0,46,48,41579
"Las Palmas II CDP, Texas",394,394,0,850,48,41580
"Las Pilas CDP, Texas",0,0,0,0,48,41582
"Las Quintas Fronterizas CDP, Texas",381,381,0,1058,48,41583
"Latexo city, Texas",142,136,6,352,48,41644
"La Tina Ranch CDP, Texas",329,329,0,725,48,41660
"Laughlin AFB CDP, Texas",398,388,10,1865,48,41704
"Laureles CDP, Texas",1457,1326,131,3818,48,41728
"La Vernia city, Texas",542,517,25,1140,48,41764
"La Victoria CDP, Texas",44,44,0,156,48,41782
"La Villa city, Texas",802,789,13,2872,48,41788
"Lavon city, Texas",2900,2847,53,4939,48,41800
"La Ward city, Texas",124,102,22,239,48,41848
"Lawn town, Texas",188,183,5,411,48,41872
"League City city, Texas",61004,58412,2592,113469,48,41980
"Leakey city, Texas",151,151,0,464,48,42004
"Leander city, Texas",35142,33857,1285,62491,48,42016
"Leary city, Texas",251,246,5,572,48,42028
"Lefors town, Texas",185,155,30,469,48,42148
"Lelia Lake CDP, Texas",31,31,0,98,48,42244
"Leming CDP, Texas",590,526,64,1168,48,42256
"Leona city, Texas",166,155,11,282,48,42340
"Leonard city, Texas",1086,1036,50,2468,48,42352
"Leon Valley city, Texas",5768,5412,356,11485,48,42388
"Leroy city, Texas",240,239,1,429,48,42400
"Levelland city, Texas",6096,5734,362,12607,48,42448
"Lewisville city, Texas",74786,71923,2863,125028,48,42508
"Lexington town, Texas",619,604,15,1300,48,42532
"Liberty city, Texas",3072,2855,217,8348,48,42568
"Liberty City CDP, Texas",1366,1330,36,2991,48,42616
"Liberty Hill city, Texas",2738,2450,288,5265,48,42664
"Lindale city, Texas",2836,2727,109,6174,48,42820
"Linden city, Texas",636,577,59,1707,48,42844
"Lindsay city, Texas",485,478,7,1092,48,42868
"Lindsay CDP, Texas",744,744,0,789,48,42874
"Lingleville CDP, Texas",73,67,6,158,48,42880
"Linn CDP, Texas",369,352,17,759,48,42916
"Lipan city, Texas",205,193,12,417,48,42940
"Lipscomb CDP, Texas",7,7,0,42,48,42952
"Little Cypress CDP, Texas",927,910,17,1931,48,43000
"Little Elm city, Texas",27291,25511,1780,48241,48,43012
"Littlefield city, Texas",2555,2494,61,5939,48,43024
"Little River-Academy city, Texas",1178,1098,80,2374,48,43066
"Live Oak city, Texas",8444,7980,464,15726,48,43096
"Liverpool city, Texas",242,221,21,476,48,43120
"Livingston town, Texas",2744,2567,177,5672,48,43132
"Llano city, Texas",1797,1660,137,3374,48,43144
"Llano Grande CDP, Texas",798,709,89,2065,48,43150
"Lockett CDP, Texas",198,187,11,310,48,43216
"Lockhart city, Texas",6511,6429,82,14463,48,43240
"Lockney town, Texas",843,801,42,1720,48,43252
"Log Cabin city, Texas",283,274,9,898,48,43354
"Lolita CDP, Texas",0,0,0,259,48,43432
"Loma Grande CDP, Texas",129,129,0,210,48,43458
"Loma Linda CDP, Texas",67,67,0,203,48,43460
"Loma Linda East CDP (Jim Wells County), Texas",10,10,0,34,48,43462
"Loma Linda East CDP (Starr County), Texas",0,0,0,0,48,43463
"Loma Linda West CDP, Texas",0,0,0,0,48,43465
"Loma Vista CDP, Texas",95,95,0,117,48,43474
"Lometa city, Texas",377,340,37,795,48,43516
"Lone Oak city, Texas",287,265,22,562,48,43636
"Lone Star city, Texas",670,645,25,1653,48,43684
"Longoria CDP, Texas",20,20,0,60,48,43822
"Longview city, Texas",39967,38582,1385,82176,48,43888
"Loop CDP, Texas",68,68,0,172,48,43948
"Lopeño CDP, Texas",18,18,0,48,48,43960
"Lopezville CDP, Texas",748,647,101,1845,48,43972
"Loraine town, Texas",252,239,13,535,48,43996
"Lorena city, Texas",818,802,16,1650,48,44020
"Lorenzo city, Texas",408,389,19,878,48,44032
"Los Altos CDP, Texas",27,27,0,78,48,44038
"Los Alvarez CDP, Texas",4,4,0,181,48,44044
"Los Angeles CDP, Texas",216,216,0,430,48,44062
"Los Arcos CDP, Texas",19,19,0,41,48,44072
"Los Arrieros CDP, Texas",0,0,0,0,48,44075
"Los Barreras CDP, Texas",144,144,0,351,48,44076
"Los Centenarios CDP, Texas",0,0,0,0,48,44077
"Los Corralitos CDP, Texas",0,0,0,0,48,44079
"Los Ebanos CDP (Hidalgo County), Texas",0,0,0,44,48,44104
"Los Ebanos CDP (Starr County), Texas",69,69,0,139,48,44110
"Los Fresnos city, Texas",3091,2908,183,8081,48,44116
"Los Fresnos CDP, Texas",54,54,0,197,48,44120
"Los Huisaches CDP, Texas",0,0,0,0,48,44123
"Los Indios town, Texas",429,385,44,1012,48,44128
"Los Lobos CDP, Texas",0,0,0,0,48,44142
"Los Minerales CDP, Texas",0,0,0,0,48,44145
"Los Nopalitos CDP, Texas",0,0,0,0,48,44146
"Lost Creek CDP, Texas",519,487,32,1159,48,44162
"Los Veteranos I CDP, Texas",18,10,8,39,48,44167
"Los Veteranos II CDP, Texas",0,0,0,13,48,44168
"Los Ybanez city, Texas",7,7,0,7,48,44170
"Lott city, Texas",288,272,16,630,48,44176
"Louise CDP, Texas",458,458,0,961,48,44212
"Lovelady city, Texas",202,197,5,503,48,44260
"Loving CDP, Texas",82,82,0,144,48,44284
"Lowry Crossing city, Texas",1054,1015,39,1885,48,44308
"Lozano CDP, Texas",119,119,0,185,48,44344
"Lubbock city, Texas",135411,129211,6200,258190,48,45000
"Lucas city, Texas",4278,4148,130,7746,48,45012
"Lueders city, Texas",96,74,22,268,48,45048
"Lufkin city, Texas",16266,15151,1115,34165,48,45072
"Luling city, Texas",2748,2651,97,5455,48,45096
"Lumberton city, Texas",6714,6479,235,13613,48,45120
"Lyford city, Texas",1066,1007,59,2540,48,45228
"Lyons CDP, Texas",92,92,0,459,48,45276
"Lytle city, Texas",1020,955,65,2262,48,45288
"Mabank town, Texas",2122,1995,127,3892,48,45324
"McAllen city, Texas",66865,63256,3609,142722,48,45384
"McCamey city, Texas",706,676,30,1691,48,45432
"McCaulley CDP, Texas",13,13,0,35,48,45444
"McDade CDP, Texas",455,443,12,1369,48,45564
"Macdona CDP, Texas",218,204,14,486,48,45576
"McGregor city, Texas",2644,2514,130,5478,48,45672
"McKinney city, Texas",104640,100725,3915,196160,48,45744
"McKinney Acres CDP, Texas",413,396,17,868,48,45750
"McLean town, Texas",405,395,10,943,48,45780
"McLendon-Chisholm city, Texas",1978,1941,37,3755,48,45804
"McLeod CDP, Texas",84,73,11,309,48,45816
"McQueeney CDP, Texas",1287,1226,61,2371,48,45948
"Madisonville city, Texas",2250,2239,11,4480,48,45996
"Magnolia city, Texas",1263,1250,13,2620,48,46056
"Magnolia Beach CDP, Texas",84,84,0,157,48,46080
"Malakoff city, Texas",1188,1118,70,2364,48,46224
"Malone town, Texas",94,94,0,399,48,46260
"Manchaca CDP, Texas",1176,1176,0,2041,48,46308
"Manor city, Texas",8006,7647,359,15341,48,46440
"Mansfield city, Texas",39656,38200,1456,73680,48,46452
"Manuel Garcia CDP, Texas",0,0,0,57,48,46492
"Manuel Garcia II CDP, Texas",0,0,0,0,48,46494
"Manvel city, Texas",5524,5378,146,11265,48,46500
"Marathon CDP, Texas",154,154,0,275,48,46572
"Marble Falls city, Texas",3705,3548,157,7068,48,46584
"Marfa city, Texas",1300,1300,0,2141,48,46620
"Marietta town, Texas",42,42,0,103,48,46668
"Marion city, Texas",552,528,24,1025,48,46692
"Markham CDP, Texas",330,330,0,1222,48,46716
"Marlin city, Texas",2136,1840,296,5478,48,46740
"Marquez city, Texas",53,46,7,137,48,46752
"Marshall city, Texas",10918,9951,967,23509,48,46776
"Mart city, Texas",822,731,91,2179,48,46824
"Martindale city, Texas",643,625,18,1311,48,46848
"Martinez CDP, Texas",0,0,0,12,48,46854
"Mason city, Texas",947,910,37,2158,48,46968
"Matador town, Texas",361,343,18,747,48,47004
"Matagorda CDP, Texas",224,185,39,383,48,47016
"Mathis city, Texas",1382,1258,124,4350,48,47040
"Maud city, Texas",456,449,7,1137,48,47088
"Mauriceville CDP, Texas",1183,1086,97,2531,48,47100
"May CDP, Texas",83,83,0,224,48,47172
"Maypearl city, Texas",509,469,40,998,48,47268
"Meadow town, Texas",361,351,10,823,48,47316
"Meadowlakes city, Texas",887,844,43,2144,48,47330
"Meadows Place city, Texas",2724,2629,95,4719,48,47337
"Medina CDP, Texas",1676,1430,246,4436,48,47406
"Megargel town, Texas",109,107,2,214,48,47460
"Melissa city, Texas",7800,7477,323,15244,48,47496
"Melvin town, Texas",79,74,5,151,48,47568
"Memphis city, Texas",915,832,83,2130,48,47616
"Menard city, Texas",587,540,47,1356,48,47628
"Mentone CDP, Texas",12,12,0,15,48,47676
"Mercedes city, Texas",6668,6113,555,16361,48,47700
"Meridian city, Texas",740,734,6,1691,48,47760
"Merkel town, Texas",1264,1240,24,2646,48,47796
"Mertens town, Texas",49,49,0,85,48,47820
"Mertzon city, Texas",420,420,0,885,48,47832
"Mesquite city, Texas",78553,74847,3706,149439,48,47892
"Mesquite CDP, Texas",79,61,18,145,48,47898
"Mexia city, Texas",2639,2539,100,6907,48,47916
"Miami city, Texas",249,249,0,496,48,47988
"Midfield CDP, Texas",0,0,0,13,48,48048
"Midland city, Texas",69867,67618,2249,132490,48,48072
"Midlothian city, Texas",19168,18614,554,35460,48,48096
"Midway city, Texas",123,107,16,290,48,48180
"Midway North CDP, Texas",1866,1676,190,4033,48,48272
"Midway South CDP, Texas",1132,1059,73,2419,48,48280
"Miguel Barrera CDP, Texas",55,55,0,138,48,48315
"Mikes CDP, Texas",570,550,20,1364,48,48318
"Mila Doce CDP, Texas",2746,2570,176,7554,48,48320
"Milam CDP, Texas",555,521,34,1536,48,48324
"Milano city, Texas",358,352,6,608,48,48336
"Mildred town, Texas",148,139,9,299,48,48372
"Miles city, Texas",540,518,22,1197,48,48396
"Milford town, Texas",450,407,43,1032,48,48408
"Miller's Cove town, Texas",43,30,13,74,48,48478
"Millsap town, Texas",198,179,19,431,48,48564
"Mineola city, Texas",2031,1915,116,4879,48,48648
"Mineral Wells city, Texas",6969,6401,568,15049,48,48684
"Mingus city, Texas",144,140,4,301,48,48720
"Mi Ranchito Estate CDP, Texas",670,370,300,1039,48,48750
"Mirando City CDP, Texas",95,82,13,199,48,48756
"Mission city, Texas",36588,33380,3208,85755,48,48768
"Mission Bend CDP, Texas",19337,17369,1968,37853,48,48772
"Missouri City city, Texas",39934,37649,2285,74517,48,48804
"Mobeetie city, Texas",69,58,11,105,48,48852
"Mobile City city, Texas",100,99,1,277,48,48858
"Monahans city, Texas",3714,3441,273,7595,48,48936
"Montague CDP, Texas",71,63,8,233,48,49032
"Mont Belvieu city, Texas",3990,3909,81,7868,48,49068
"Monte Alto CDP, Texas",756,701,55,1666,48,49080
"Montgomery city, Texas",768,743,25,1620,48,49128
"Moody city, Texas",652,634,18,1394,48,49200
"Moore CDP, Texas",9,5,4,93,48,49224
"Moore Station city, Texas",69,68,1,189,48,49272
"Moraida CDP, Texas",0,0,0,0,48,49300
"Morales-Sanchez CDP, Texas",0,0,0,0,48,49314
"Moran city, Texas",108,104,4,169,48,49320
"Morgan city, Texas",213,180,33,530,48,49356
"Morgan Farm CDP, Texas",162,162,0,434,48,49359
"Morgan's Point city, Texas",103,98,5,227,48,49380
"Morgan's Point Resort city, Texas",2472,2397,75,4661,48,49392
"Morning Glory CDP, Texas",191,184,7,427,48,49411
"Morse CDP, Texas",104,104,0,242,48,49440
"Morton city, Texas",744,678,66,1572,48,49464
"Mosheim CDP, Texas",0,0,0,14,48,49512
"Moulton town, Texas",407,404,3,868,48,49560
"Mound CDP, Texas",146,129,17,201,48,49572
"Mountain City city, Texas",349,348,1,726,48,49600
"Mount Calm city, Texas",168,159,9,395,48,49692
"Mount Enterprise city, Texas",115,112,3,243,48,49728
"Mount Pleasant city, Texas",7538,7274,264,16065,48,49800
"Mount Vernon town, Texas",1126,1058,68,2527,48,49860
"Muenster city, Texas",866,861,5,1336,48,49932
"Muleshoe city, Texas",2246,2181,65,5515,48,49968
"Mullin town, Texas",113,106,7,191,48,49992
"Munday city, Texas",673,654,19,1319,48,50040
"Muniz CDP, Texas",298,298,0,772,48,50058
"Murchison city, Texas",153,141,12,419,48,50076
"Murillo CDP, Texas",4054,3756,298,8744,48,50092
"Murphy city, Texas",10217,9683,534,20880,48,50100
"Mustang town, Texas",0,0,0,0,48,50184
"Mustang Ridge city, Texas",781,753,28,1475,48,50200
"Myra CDP, Texas",134,134,0,299,48,50220
"Myrtle Springs CDP, Texas",286,286,0,628,48,50232
"Nacogdoches city, Texas",15923,14610,1313,32148,48,50256
"Nada CDP, Texas",62,57,5,227,48,50268
"Naples city, Texas",600,557,43,1389,48,50316
"Narciso Pena CDP, Texas",0,0,0,0,48,50322
"Nash city, Texas",1778,1719,59,3851,48,50352
"Nassau Bay city, Texas",2808,2765,43,5215,48,50376
"Natalia city, Texas",776,722,54,1404,48,50400
"Navarro town, Texas",70,69,1,176,48,50448
"Navasota city, Texas",3795,3473,322,7843,48,50472
"Nazareth city, Texas",87,83,4,254,48,50496
"Neches CDP, Texas",120,97,23,175,48,50544
"Nederland city, Texas",9040,8762,278,18569,48,50580
"Needville city, Texas",1303,1286,17,3078,48,50628
"Nesbitt town, Texas",104,104,0,210,48,50724
"Netos CDP, Texas",0,0,0,0,48,50742
"Nevada city, Texas",692,672,20,1384,48,50760
"Newark city, Texas",552,513,39,1232,48,50772
"New Berlin city, Texas",387,377,10,764,48,50796
"New Boston city, Texas",2163,2005,158,4625,48,50808
"New Braunfels city, Texas",48549,46692,1857,92993,48,50820
"Newcastle city, Texas",254,241,13,634,48,50868
"New Chapel Hill city, Texas",364,325,39,768,48,50876
"New Deal town, Texas",643,640,3,1217,48,50916
"New Fairview city, Texas",864,859,5,1637,48,50920
"New Falcon CDP, Texas",0,0,0,0,48,50924
"New Home city, Texas",193,184,9,367,48,51012
"New Hope town, Texas",478,471,7,888,48,51036
"New London city, Texas",347,326,21,1176,48,51168
"New Summerfield city, Texas",378,350,28,668,48,51336
"Newton city, Texas",932,842,90,2246,48,51372
"New Ulm CDP, Texas",129,129,0,364,48,51384
"New Waverly city, Texas",378,366,12,1102,48,51396
"Neylandville town, Texas",56,56,0,207,48,51444
"Niederwald city, Texas",487,474,13,911,48,51492
"Nina CDP, Texas",306,306,0,852,48,51552
"Nixon city, Texas",1407,1390,17,2898,48,51588
"Nocona city, Texas",1244,1049,195,3027,48,51648
"Nocona Hills CDP, Texas",282,241,41,620,48,51654
"Nolanville city, Texas",3050,2996,54,6102,48,51708
"Nome city, Texas",193,164,29,350,48,51720
"Noonday city, Texas",328,318,10,510,48,51756
"Nordheim city, Texas",160,150,10,442,48,51792
"Normandy CDP, Texas",0,0,0,45,48,51828
"Normangee town, Texas",360,335,25,734,48,51840
"Normanna CDP, Texas",14,10,4,25,48,51852
"North Alamo CDP, Texas",1868,1777,91,5130,48,51900
"North Cleveland city, Texas",88,76,12,206,48,51984
"North Escobares CDP, Texas",27,27,0,194,48,52068
"Northlake town, Texas",3434,3143,291,6202,48,52212
"North Pearsall CDP, Texas",374,363,11,711,48,52302
"North Richland Hills city, Texas",38261,37064,1197,70114,48,52356
"North San Pedro CDP, Texas",378,324,54,824,48,52404
"Novice city, Texas",29,29,0,86,48,52668
"Oak Grove town, Texas",313,313,0,620,48,52902
"Oakhurst CDP, Texas",21,21,0,21,48,52992
"Oak Island CDP, Texas",40,40,0,256,48,53004
"Oak Leaf city, Texas",874,814,60,1653,48,53115
"Oak Point city, Texas",2562,2523,39,4957,48,53130
"Oak Ridge town (Cooke County), Texas",146,138,8,309,48,53154
"Oak Ridge town (Kaufman County), Texas",319,300,19,736,48,53160
"Oak Ridge North city, Texas",1684,1596,88,3033,48,53190
"Oak Trail Shores CDP, Texas",1340,1290,50,3224,48,53212
"Oak Valley town, Texas",233,213,20,505,48,53217
"Oakwood town, Texas",181,181,0,539,48,53232
"O'Brien city, Texas",35,27,8,90,48,53304
"Odem city, Texas",814,778,36,2032,48,53376
"Odessa city, Texas",57820,54268,3552,113353,48,53388
"O'Donnell city, Texas",316,304,12,624,48,53436
"Oglesby city, Texas",228,221,7,511,48,53520
"Oilton CDP, Texas",68,62,6,130,48,53556
"Oklaunion CDP, Texas",15,15,0,66,48,53616
"Old River-Winfree city, Texas",829,776,53,1841,48,53824
"Olivarez CDP, Texas",1804,1737,67,6853,48,53934
"Olivia Lopez de Gutierrez CDP, Texas",92,92,0,440,48,53946
"Olmito CDP, Texas",339,337,2,794,48,53964
"Olmito and Olmito CDP, Texas",86,86,0,284,48,53970
"Olmos Park city, Texas",1139,1032,107,2286,48,53988
"Olney city, Texas",1518,1397,121,3016,48,54000
"Olton city, Texas",692,669,23,1749,48,54012
"Omaha city, Texas",565,496,69,1403,48,54024
"Onalaska city, Texas",1278,1156,122,3050,48,54048
"Opdyke West town, Texas",97,95,2,189,48,54075
"Orange city, Texas",8720,7958,762,19221,48,54132
"Orange Grove city, Texas",448,427,21,1067,48,54168
"Orason CDP, Texas",97,97,0,597,48,54186
"Orchard city, Texas",88,88,0,248,48,54192
"Ore City city, Texas",374,354,20,929,48,54216
"Overton city, Texas",1181,1066,115,2703,48,54432
"Ovilla city, Texas",1924,1859,65,4077,48,54444
"Owl Ranch CDP, Texas",11,11,0,118,48,54509
"Oyster Creek city, Texas",557,515,42,1210,48,54528
"Ozona CDP, Texas",1332,1301,31,2306,48,54552
"Pablo Pena CDP, Texas",160,160,0,309,48,54558
"Paducah town, Texas",512,481,31,1201,48,54600
"Paige CDP, Texas",77,62,15,172,48,54624
"Paint Rock town, Texas",112,112,0,310,48,54636
"Paisano Park CDP, Texas",19,19,0,59,48,54666
"Palacios city, Texas",2116,2116,0,4411,48,54684
"Palestine city, Texas",8885,8531,354,18741,48,54708
"Palisades village, Texas",163,160,3,325,48,54726
"Palmer town, Texas",1455,1350,105,2685,48,54744
"Palmer CDP, Texas",473,473,0,1523,48,54748
"Palmhurst city, Texas",1150,1033,117,2597,48,54780
"Palm Valley city, Texas",645,618,27,1876,48,54798
"Palmview city, Texas",6272,5855,417,15245,48,54804
"Palmview South CDP, Texas",717,589,128,2141,48,54810
"Palo Blanco CDP, Texas",19,19,0,19,48,54846
"Paloma Creek CDP, Texas",1909,1846,63,3194,48,54868
"Paloma Creek South CDP, Texas",4982,4789,193,8558,48,54872
"Palo Pinto CDP, Texas",50,50,0,201,48,54876
"Pampa city, Texas",8232,7763,469,16861,48,54912
"Panhandle town, Texas",1540,1521,19,2743,48,54960
"Panorama Village city, Texas",1047,1030,17,2513,48,55008
"Pantego town, Texas",1268,1171,97,2529,48,55020
"Paradise city, Texas",202,194,8,421,48,55056
"Paris city, Texas",11315,10739,576,24574,48,55080
"Parker city, Texas",2605,2545,60,5573,48,55152
"Pasadena city, Texas",73264,66779,6485,150620,48,56000
"Pattison city, Texas",422,410,12,654,48,56108
"Patton Village city, Texas",649,605,44,1417,48,56156
"Pawnee CDP, Texas",43,41,2,97,48,56252
"Payne Springs town, Texas",228,225,3,613,48,56276
"Pearland city, Texas",64233,62171,2062,124478,48,56348
"Pearsall city, Texas",3305,3157,148,8870,48,56384
"Pecan Acres CDP, Texas",1908,1672,236,3981,48,56462
"Pecan Gap city, Texas",87,82,5,197,48,56468
"Pecan Grove CDP, Texas",12689,12192,497,22784,48,56482
"Pecan Hill city, Texas",374,362,12,684,48,56485
"Pecan Plantation CDP, Texas",2513,2055,458,6664,48,56498
"Pelican Bay city, Texas",947,850,97,2172,48,56640
"Pena CDP, Texas",25,25,0,75,48,56644
"Pendleton CDP, Texas",346,346,0,667,48,56660
"Penelope town, Texas",104,101,3,234,48,56672
"Penitas city, Texas",2304,2114,190,6313,48,56696
"Perezville CDP, Texas",558,558,0,2703,48,56804
"Perrin CDP, Texas",138,138,0,219,48,56864
"Perryton city, Texas",4331,4262,69,8664,48,56912
"Petersburg city, Texas",405,392,13,827,48,56996
"Petrolia city, Texas",130,130,0,368,48,57044
"Petronila city, Texas",38,38,0,69,48,57056
"Pettus CDP, Texas",241,223,18,603,48,57116
"Petty CDP, Texas",104,104,0,158,48,57128
"Pflugerville city, Texas",38852,37350,1502,64528,48,57176
"Pharr city, Texas",33338,31316,2022,79434,48,57200
"Pilot Point city, Texas",2319,2135,184,4509,48,57476
"Pinebrook CDP, Texas",130,125,5,172,48,57494
"Pine Forest city, Texas",185,180,5,467,48,57524
"Pine Harbor CDP, Texas",107,61,46,444,48,57566
"Pinehurst CDP, Texas",1600,1496,104,4109,48,57596
"Pinehurst city, Texas",947,921,26,2237,48,57608
"Pine Island town, Texas",414,390,24,1258,48,57615
"Pineland city, Texas",503,445,58,1192,48,57644
"Pinewood Estates CDP, Texas",671,660,11,1533,48,57752
"Piney Point Village city, Texas",1579,1430,149,3114,48,57800
"Pittsburg city, Texas",1956,1879,77,4382,48,57908
"Placedo CDP, Texas",203,203,0,516,48,57932
"Plains town, Texas",533,502,31,1066,48,57968
"Plainview city, Texas",9489,8859,630,20113,48,57980
"Plano city, Texas",159484,152434,7050,284948,48,58016
"Plantersville city, Texas",225,186,39,423,48,58040
"Pleak village, Texas",1061,1024,37,2001,48,58088
"Pleasant Hill CDP, Texas",534,431,103,975,48,58232
"Pleasanton city, Texas",4575,4367,208,10706,48,58280
"Pleasant Valley town, Texas",191,187,4,352,48,58400
"Plum CDP, Texas",227,227,0,360,48,58436
"Plum Grove city, Texas",732,732,0,1613,48,58448
"Poetry town, Texas",718,703,15,1513,48,58502
"Point city, Texas",521,514,7,1017,48,58532
"Point Blank city, Texas",406,368,38,816,48,58556
"Point Comfort city, Texas",198,198,0,458,48,58568
"Point Venture village, Texas",825,787,38,1521,48,58586
"Ponder town, Texas",1284,1227,57,2421,48,58664
"Port Aransas city, Texas",1358,1358,0,3072,48,58808
"Port Arthur city, Texas",22004,20249,1755,55897,48,58820
"Porter Heights CDP, Texas",629,629,0,1001,48,58850
"Port Isabel city, Texas",2118,2076,42,5137,48,58892
"Portland city, Texas",9724,9423,301,20130,48,58904
"Port Lavaca city, Texas",5659,5390,269,11545,48,58916
"Port Mansfield CDP, Texas",27,27,0,108,48,58928
"Port Neches city, Texas",6746,6390,356,13635,48,58940
"Port O'Connor CDP, Texas",223,222,1,791,48,58952
"Post city, Texas",1194,1125,69,4632,48,59012
"Post Oak Bend City town, Texas",303,293,10,573,48,59066
"Poteet city, Texas",1357,1307,50,2879,48,59084
"Poth town, Texas",792,755,37,1709,48,59096
"Potosi CDP, Texas",2244,2174,70,4706,48,59108
"Pottsboro town, Texas",1349,1284,65,2536,48,59132
"Powderly CDP, Texas",648,611,37,1251,48,59156
"Powell town, Texas",57,57,0,104,48,59168
"Poynor town, Texas",276,267,9,428,48,59192
"Prado Verde CDP, Texas",227,227,0,424,48,59210
"Praesel CDP, Texas",62,62,0,176,48,59216
"Prairie View city, Texas",3495,2795,700,8039,48,59336
"Premont city, Texas",1361,1148,213,2810,48,59384
"Presidio city, Texas",1150,805,345,3299,48,59396
"Preston CDP, Texas",1226,1118,108,2181,48,59420
"Priddy CDP, Texas",58,58,0,111,48,59528
"Primera town, Texas",2760,2682,78,5219,48,59540
"Princeton city, Texas",9728,9491,237,18441,48,59576
"Proctor CDP, Texas",45,45,0,117,48,59612
"Progreso city, Texas",2007,1883,124,4914,48,59636
"Progreso Lakes city, Texas",162,143,19,292,48,59642
"Prosper town, Texas",15634,14923,711,31507,48,59696
"Providence Village town, Texas",3671,3584,87,7710,48,59748
"Pueblo East CDP, Texas",0,0,0,0,48,59794
"Pueblo Nuevo CDP, Texas",254,247,7,569,48,59798
"Putnam town, Texas",18,11,7,73,48,59984
"Pyote town, Texas",71,71,0,130,48,59996
"Quail CDP, Texas",18,18,0,20,48,60020
"Quail Creek CDP, Texas",655,571,84,1301,48,60026
"Quanah city, Texas",877,843,34,2022,48,60044
"Queen City city, Texas",606,587,19,1306,48,60080
"Quemado CDP, Texas",55,55,0,91,48,60092
"Quesada CDP, Texas",0,0,0,62,48,60098
"Quinlan city, Texas",615,583,32,1470,48,60140
"Quintana town, Texas",33,33,0,41,48,60164
"Quitaque city, Texas",140,131,9,353,48,60176
"Quitman city, Texas",839,774,65,2301,48,60188
"Radar Base CDP, Texas",18,18,0,74,48,60278
"Rafael Pena CDP, Texas",0,0,0,12,48,60290
"Ralls city, Texas",892,845,47,1634,48,60356
"Ramireno CDP, Texas",0,0,0,0,48,60380
"Ramirez-Perez CDP, Texas",0,0,0,0,48,60408
"Ramos CDP, Texas",15,15,0,31,48,60422
"Ranchette Estates CDP, Texas",81,81,0,173,48,60458
"Ranchitos del Norte CDP, Texas",68,68,0,214,48,60478
"Ranchitos East CDP, Texas",62,62,0,313,48,60480
"Ranchitos Las Lomas CDP, Texas",148,148,0,369,48,60482
"Rancho Alegre CDP, Texas",264,264,0,1099,48,60518
"Rancho Banquete CDP, Texas",123,123,0,243,48,60529
"Rancho Chico CDP, Texas",20,20,0,53,48,60534
"Ranchos Penitas West CDP, Texas",232,232,0,571,48,60539
"Rancho Viejo town, Texas",1345,1312,33,2814,48,60544
"Rancho Viejo CDP, Texas",70,55,15,148,48,60554
"Randolph AFB CDP, Texas",259,225,34,1195,48,60608
"Ranger city, Texas",1070,1038,32,2524,48,60632
"Rangerville village, Texas",53,53,0,106,48,60644
"Rankin city, Texas",496,459,37,1069,48,60668
"Ransom Canyon town, Texas",524,512,12,1073,48,60672
"Ratamosa CDP, Texas",30,30,0,136,48,60686
"Ravenna city, Texas",102,99,3,196,48,60752
"Raymondville city, Texas",4335,3791,544,10301,48,60836
"Realitos CDP, Texas",39,39,0,93,48,60932
"Redfield CDP, Texas",187,180,7,339,48,61040
"Redford CDP, Texas",0,0,0,0,48,61076
"Redland CDP, Texas",286,147,139,723,48,61124
"Red Lick city, Texas",905,891,14,1586,48,61172
"Red Oak city, Texas",8269,8027,242,14853,48,61196
"Red Rock CDP, Texas",219,219,0,673,48,61280
"Redwater city, Texas",441,435,6,989,48,61340
"Redwood CDP, Texas",2036,1899,137,3423,48,61352
"Refugio town, Texas",1037,1016,21,2728,48,61436
"Regino Ramirez CDP, Texas",0,0,0,0,48,61454
"Reid Hope King CDP, Texas",501,501,0,926,48,61466
"Reklaw city, Texas",159,144,15,359,48,61508
"Relampago CDP, Texas",156,156,0,292,48,61532
"Rendon CDP, Texas",7407,7132,275,15523,48,61568
"Reno city (Lamar County), Texas",1607,1467,140,3449,48,61592
"Reno city (Parker and Tarrant Counties), Texas",1439,1363,76,3034,48,61604
"Retreat town, Texas",482,462,20,749,48,61616
"Rhome city, Texas",956,923,33,1838,48,61700
"Ricardo CDP, Texas",172,172,0,819,48,61724
"Rice city, Texas",532,522,10,1119,48,61736
"Rice Tracts CDP, Texas",515,489,26,1185,48,61766
"Richards CDP, Texas",41,41,0,121,48,61784
"Richardson city, Texas",67817,64423,3394,118063,48,61796
"Richland town, Texas",129,127,2,307,48,61820
"Richland Hills city, Texas",5134,4917,217,8513,48,61844
"Richland Springs town, Texas",62,62,0,247,48,61880
"Richmond city, Texas",5849,5554,295,11931,48,61892
"Richwood city, Texas",2427,2289,138,4712,48,61904
"Riesel city, Texas",837,837,0,1463,48,62108
"Ringgold CDP, Texas",38,34,4,109,48,62132
"Rio Bravo city, Texas",1603,1550,53,4437,48,62138
"Rio Grande City city, Texas",6549,5965,584,15256,48,62168
"Rio Hondo city, Texas",944,944,0,2295,48,62180
"Rio Vista city, Texas",681,659,22,1290,48,62240
"Rising Star town, Texas",242,230,12,660,48,62252
"Rivereno CDP, Texas",0,0,0,0,48,62318
"River Oaks city, Texas",3402,3300,102,7586,48,62384
"Riverside city, Texas",258,257,1,659,48,62408
"Riviera CDP, Texas",385,342,43,758,48,62468
"Road Runner town, Texas",204,204,0,648,48,62486
"Roanoke city, Texas",5332,5114,218,9565,48,62504
"Roaring Springs town, Texas",62,62,0,195,48,62528
"Robert Lee city, Texas",478,462,16,1146,48,62564
"Robinson city, Texas",6256,5923,333,12470,48,62588
"Robstown city, Texas",4476,4014,462,10246,48,62600
"Roby city, Texas",349,339,10,675,48,62612
"Rochelle CDP, Texas",169,169,0,372,48,62624
"Rochester town, Texas",135,130,5,310,48,62636
"Rockdale city, Texas",2754,2627,127,5424,48,62672
"Rock Island CDP, Texas",193,142,51,394,48,62732
"Rockport city, Texas",4506,4280,226,10265,48,62804
"Rocksprings town, Texas",560,560,0,1002,48,62816
"Rockwall city, Texas",26443,25623,820,47859,48,62828
"Rockwell Place CDP, Texas",657,634,23,1340,48,62834
"Rocky Mound town, Texas",83,72,11,169,48,62870
"Rogers town, Texas",753,717,36,1444,48,62924
"Rollingwood city, Texas",678,660,18,1514,48,63008
"Roma city, Texas",4480,3855,625,11531,48,63020
"Roman Forest city, Texas",1040,995,45,2077,48,63044
"Ropesville city, Texas",197,196,1,380,48,63140
"Rosanky CDP, Texas",685,666,19,1487,48,63164
"Roscoe city, Texas",695,645,50,1465,48,63176
"Rosebud city, Texas",421,421,0,1108,48,63188
"Rose City city, Texas",148,146,2,333,48,63200
"Rose Hill Acres city, Texas",152,127,25,295,48,63272
"Rosenberg city, Texas",19487,18825,662,38722,48,63284
"Rosharon CDP, Texas",809,513,296,1689,48,63332
"Rosita CDP, Texas",1600,1380,220,3717,48,63350
"Ross city, Texas",77,77,0,164,48,63380
"Rosser village, Texas",208,196,12,437,48,63404
"Rotan city, Texas",629,603,26,1270,48,63464
"Round Mountain town, Texas",61,56,5,104,48,63476
"Round Rock city, Texas",69007,66377,2630,120465,48,63500
"Round Top town, Texas",62,62,0,111,48,63524
"Rowena CDP, Texas",122,122,0,196,48,63560
"Rowlett city, Texas",36060,34597,1463,63291,48,63572
"Roxton city, Texas",251,242,9,585,48,63584
"Royse City city, Texas",8537,8451,86,15051,48,63668
"Rule town, Texas",261,255,6,742,48,63752
"Runaway Bay city, Texas",799,764,35,1648,48,63782
"Runge town, Texas",531,525,6,1201,48,63788
"Rusk city, Texas",1239,1120,119,5344,48,63848
"Sabinal city, Texas",284,264,20,635,48,64004
"Sachse city, Texas",16215,15380,835,27829,48,64064
"Sadler city, Texas",176,176,0,330,48,64088
"Saginaw city, Texas",12827,12374,453,24106,48,64112
"St. Hedwig town, Texas",1080,1057,23,2256,48,64172
"St. Jo city, Texas",374,359,15,904,48,64184
"St. Paul town, Texas",521,507,14,986,48,64220
"St. Paul CDP, Texas",394,394,0,1102,48,64244
"Salado village, Texas",1211,1198,13,2585,48,64268
"Salida del Sol Estates CDP, Texas",1519,1495,24,6172,48,64307
"Salineño CDP, Texas",24,24,0,98,48,64316
"Salineño North CDP, Texas",21,21,0,77,48,64322
"Sammy Martinez CDP, Texas",110,110,0,144,48,64442
"Samnorwood CDP, Texas",10,10,0,23,48,64448
"Sam Rayburn CDP, Texas",512,485,27,1227,48,64460
"San Angelo city, Texas",48782,47243,1539,99422,48,64472
"San Antonio city, Texas",737615,694269,43346,1445662,48,65000
"San Augustine city, Texas",638,512,126,1845,48,65024
"San Benito city, Texas",9065,8588,477,24766,48,65036
"San Carlos CDP, Texas",1657,1363,294,4069,48,65048
"San Carlos I CDP, Texas",119,119,0,233,48,65049
"San Carlos II CDP, Texas",47,47,0,272,48,65050
"Sanctuary town, Texas",134,122,12,254,48,65066
"Sanderson CDP, Texas",308,308,0,740,48,65084
"Sandia CDP, Texas",221,221,0,333,48,65168
"San Diego city, Texas",1641,1536,105,3801,48,65180
"Sandoval CDP, Texas",0,0,0,0,48,65210
"Sand Springs CDP, Texas",599,588,11,1036,48,65240
"Sandy Hollow-Escondidas CDP, Texas",0,0,0,501,48,65342
"Sandy Oaks city, Texas",2207,2008,199,5097,48,65344
"Sandy Point city, Texas",83,82,1,179,48,65345
"San Elizario city, Texas",4064,3868,196,10072,48,65360
"San Felipe town, Texas",416,400,16,1039,48,65372
"San Fernando CDP, Texas",0,0,0,0,48,65378
"Sanford town, Texas",11,10,1,101,48,65384
"Sanger city, Texas",4971,4884,87,9041,48,65408
"San Isidro CDP, Texas",96,91,5,255,48,65432
"San Juan city, Texas",15187,14131,1056,35463,48,65516
"San Juan CDP, Texas",23,23,0,95,48,65532
"San Leanna village, Texas",244,221,23,492,48,65552
"San Leon CDP, Texas",3233,2989,244,5709,48,65564
"San Marcos city, Texas",39575,36899,2676,67143,48,65600
"San Patricio city, Texas",145,140,5,391,48,65612
"San Pedro CDP, Texas",175,175,0,360,48,65620
"San Perlita city, Texas",294,277,17,784,48,65636
"San Saba city, Texas",1194,1139,55,3122,48,65648
"Sansom Park city, Texas",2408,2231,177,5387,48,65660
"Santa Anna town, Texas",526,503,23,1251,48,65672
"Santa Anna CDP, Texas",3,0,3,3,48,65678
"Santa Clara city, Texas",369,360,9,713,48,65690
"Santa Cruz CDP, Texas",33,33,0,520,48,65708
"Santa Fe city, Texas",6446,5940,506,12792,48,65726
"Santa Maria CDP, Texas",196,196,0,587,48,65744
"Santa Monica CDP, Texas",0,0,0,8,48,65756
"Santa Rita Ranch CDP, Texas",1727,1702,25,3655,48,65762
"Santa Rosa town, Texas",1109,982,127,3093,48,65768
"Santa Rosa CDP, Texas",199,199,0,386,48,65774
"Santel CDP, Texas",4,4,0,10,48,65777
"Santo CDP, Texas",276,237,39,486,48,65780
"San Ygnacio CDP, Texas",211,197,14,590,48,65792
"Sargent CDP, Texas",371,371,0,1240,48,65864
"Sarita CDP, Texas",43,43,0,111,48,65876
"Savannah CDP, Texas",3566,3340,226,6718,48,66000
"Savoy city, Texas",470,464,6,961,48,66008
"Scenic Oaks CDP, Texas",4539,4402,137,10059,48,66089
"Schertz city, Texas",20822,19528,1294,42545,48,66128
"Schulenburg city, Texas",1123,1052,71,2679,48,66188
"Scissors CDP, Texas",1503,1452,51,3667,48,66248
"Scotland city, Texas",302,299,3,562,48,66284
"Scottsville city, Texas",130,130,0,279,48,66332
"Scurry town, Texas",276,270,6,616,48,66368
"Seabrook city, Texas",7564,7275,289,13558,48,66392
"Seadrift city, Texas",694,682,12,1577,48,66416
"Seagoville city, Texas",7719,7157,562,18658,48,66428
"Seagraves city, Texas",1164,1135,29,2772,48,66440
"Sealy city, Texas",3414,3218,196,6837,48,66464
"Sebastian CDP, Texas",568,527,41,1276,48,66512
"Seco Mines CDP, Texas",519,426,93,1274,48,66536
"Seguin city, Texas",14643,14004,639,30318,48,66644
"Seis Lagos CDP, Texas",633,598,35,1244,48,66686
"Selma city, Texas",5803,5546,257,11067,48,66704
"Seminole city, Texas",3244,3164,80,7024,48,66764
"Serenada CDP, Texas",903,875,28,1695,48,66806
"Seth Ward CDP, Texas",844,844,0,1921,48,66848
"Seven Oaks city, Texas",72,70,2,141,48,66884
"Seven Points city, Texas",574,522,52,1409,48,66908
"Seymour city, Texas",1122,1116,6,2786,48,66968
"Shadybrook CDP, Texas",1002,1002,0,2315,48,67010
"Shady Hollow CDP, Texas",2344,2344,0,5300,48,67082
"Shady Shores town, Texas",1512,1401,111,2811,48,67100
"Shallowater city, Texas",1340,1288,52,2926,48,67136
"Shamrock city, Texas",1032,956,76,2000,48,67160
"Shavano Park city, Texas",1614,1589,25,3544,48,67268
"Sheffield CDP, Texas",22,22,0,31,48,67340
"Shelbyville CDP, Texas",93,93,0,221,48,67364
"Sheldon CDP, Texas",1162,1117,45,2410,48,67376
"Shenandoah city, Texas",1401,1345,56,3481,48,67400
"Shepherd city, Texas",961,820,141,2318,48,67424
"Sheridan CDP, Texas",111,94,17,188,48,67472
"Sherman city, Texas",22434,21625,809,44052,48,67496
"Sherwood Shores CDP, Texas",376,376,0,880,48,67554
"Shiner city, Texas",1013,993,20,2095,48,67640
"Shiro CDP, Texas",34,34,0,71,48,67664
"Shoreacres city, Texas",759,739,20,1326,48,67688
"Sienna CDP, Texas",11962,11308,654,23150,48,67763
"Sierra Blanca CDP, Texas",208,192,16,544,48,67772
"Siesta Acres CDP, Texas",727,727,0,1636,48,67775
"Siesta Shores CDP, Texas",528,431,97,1619,48,67778
"Silsbee city, Texas",2788,2672,116,6904,48,67832
"Silverton city, Texas",265,257,8,649,48,67904
"Simonton city, Texas",381,375,6,856,48,67964
"Sinton city, Texas",2076,1906,170,5505,48,68036
"Skellytown town, Texas",142,140,2,403,48,68120
"Skidmore CDP, Texas",581,564,17,1168,48,68132
"Slaton city, Texas",2647,2444,203,5859,48,68180
"Smiley city, Texas",196,172,24,514,48,68300
"Smithville city, Texas",2287,2183,104,3975,48,68456
"Smyer town, Texas",181,178,3,370,48,68504
"Snook city, Texas",340,340,0,514,48,68576
"Snyder city, Texas",5218,5088,130,11378,48,68624
"Socorro city, Texas",16407,15485,922,35429,48,68636
"Solis CDP, Texas",204,146,58,688,48,68678
"Somerset city, Texas",859,778,81,2152,48,68708
"Somerville city, Texas",460,455,5,1246,48,68720
"Sonora city, Texas",1174,1118,56,2852,48,68756
"Sonterra CDP, Texas",4788,4524,264,8082,48,68762
"Sour Lake city, Texas",863,821,42,2083,48,68828
"South Alamo CDP, Texas",1527,1385,142,3433,48,68846
"South Fork Estates CDP, Texas",25,23,2,55,48,68966
"South Frydek city, Texas",133,133,0,215,48,68978
"South Houston city, Texas",7640,6935,705,16169,48,69020
"Southlake city, Texas",13266,12932,334,30779,48,69032
"South La Paloma CDP, Texas",138,138,0,690,48,69072
"Southmayd city, Texas",605,596,9,1490,48,69104
"South Mountain town, Texas",186,168,18,437,48,69120
"South Padre Island town, Texas",1416,1368,48,2386,48,69140
"South Point CDP, Texas",317,308,9,670,48,69194
"Southside Place city, Texas",760,716,44,1535,48,69272
"South Toledo Bend CDP, Texas",111,106,5,372,48,69326
"Southwest Sandhill CDP, Texas",569,569,0,1124,48,69353
"Spade CDP, Texas",31,31,0,39,48,69380
"Sparks CDP, Texas",2289,2045,244,5212,48,69432
"Spearman city, Texas",1514,1433,81,2989,48,69476
"Splendora city, Texas",855,825,30,2049,48,69548
"Spofford city, Texas",68,68,0,103,48,69560
"Spring CDP, Texas",34280,32705,1575,63930,48,69596
"Spring Branch city, Texas",129,127,2,191,48,69608
"Spring Gardens CDP, Texas",314,259,55,727,48,69708
"Springlake town, Texas",42,42,0,91,48,69764
"Springtown city, Texas",1743,1695,48,3232,48,69800
"Spring Valley Village city, Texas",2022,1994,28,4222,48,69830
"Spur city, Texas",284,232,52,778,48,69848
"Stafford city, Texas",10160,9764,396,17240,48,69908
"Stagecoach town, Texas",240,229,11,554,48,69932
"Stamford city, Texas",1211,1192,19,2879,48,69980
"Stanton city, Texas",1260,1104,156,2667,48,70040
"Staples city, Texas",146,146,0,273,48,70052
"Star Harbor city, Texas",242,238,4,508,48,70076
"Steiner Ranch CDP, Texas",9336,9048,288,17879,48,70154
"Stephenville city, Texas",11383,10541,842,21020,48,70208
"Sterling City city, Texas",454,454,0,1135,48,70232
"Stinnett city, Texas",426,397,29,1210,48,70340
"Stockdale city, Texas",565,541,24,1359,48,70376
"Stockton Bend city, Texas",192,192,0,592,48,70406
"Stonewall CDP, Texas",301,301,0,559,48,70460
"Stowell CDP, Texas",865,754,111,1960,48,70520
"Stratford city, Texas",630,614,16,1251,48,70544
"Strawn city, Texas",238,235,3,501,48,70580
"Streetman town, Texas",241,238,3,490,48,70604
"Study Butte CDP, Texas",108,108,0,178,48,70688
"Sudan city, Texas",533,529,4,1054,48,70772
"Sugar Land city, Texas",56523,53712,2811,110077,48,70808
"Sullivan City city, Texas",1626,1542,84,3917,48,70868
"Sulphur Springs city, Texas",8090,7572,518,16033,48,70904
"Summerfield CDP, Texas",0,0,0,0,48,70940
"Sundown city, Texas",743,669,74,1491,48,71060
"Sunnyvale town, Texas",4303,4051,252,7873,48,71156
"Sunray city, Texas",1293,1243,50,2717,48,71180
"Sunrise Beach Village city, Texas",400,397,3,905,48,71228
"Sunrise Shores CDP, Texas",194,147,47,466,48,71236
"Sunset CDP (Montague County), Texas",238,238,0,626,48,71264
"Sunset CDP (Starr County), Texas",11,11,0,60,48,71274
"Sunset Acres CDP, Texas",18,8,10,25,48,71289
"Sunset Valley city, Texas",255,250,5,562,48,71324
"Sun Valley city, Texas",44,44,0,75,48,71356
"Surfside Beach city, Texas",304,286,18,617,48,71384
"Sweeny city, Texas",1455,1381,74,3602,48,71492
"Sweetwater city, Texas",4888,4578,310,10546,48,71540
"Sylvester CDP, Texas",19,19,0,25,48,71636
"Taft city, Texas",1110,999,111,2838,48,71684
"Taft Southwest CDP, Texas",354,354,0,1468,48,71696
"Tahoka city, Texas",1144,1078,66,2439,48,71708
"Talco city, Texas",192,182,10,607,48,71732
"Talty town, Texas",1433,1372,61,2568,48,71756
"Tanquecitos South Acres CDP, Texas",216,26,190,216,48,71820
"Tanquecitos South Acres II CDP, Texas",0,0,0,0,48,71824
"Tatum city, Texas",627,582,45,1319,48,71924
"Taylor city, Texas",7984,7557,427,16449,48,71948
"Taylor Lake Village city, Texas",1755,1705,50,3677,48,71960
"Taylor Landing city, Texas",118,116,2,281,48,71966
"Teague city, Texas",1326,1299,27,3409,48,72020
"Tehuacana town, Texas",113,113,0,230,48,72080
"Temple city, Texas",38008,35317,2691,83473,48,72176
"Tenaha town, Texas",341,341,0,1091,48,72188
"Terlingua CDP, Texas",68,58,10,154,48,72248
"Terrell city, Texas",8429,7953,476,18001,48,72284
"Terrell Hills city, Texas",2312,2217,95,5045,48,72296
"Texarkana city, Texas",15897,14984,913,36156,48,72368
"Texas City city, Texas",25325,23533,1792,53084,48,72392
"Texhoma city, Texas",235,235,0,463,48,72464
"Texline town, Texas",240,220,20,485,48,72476
"The Colony city, Texas",28826,27632,1194,44323,48,72530
"The Hills village, Texas",1006,980,26,2505,48,72578
"The Homesteads CDP, Texas",1091,1074,17,2988,48,72581
"The Woodlands CDP, Texas",56017,53036,2981,118402,48,72656
"Thompsons town, Texas",151,149,2,283,48,72740
"Thompsonville CDP, Texas",147,147,0,147,48,72758
"Thorndale city, Texas",757,749,8,1415,48,72776
"Thornton town, Texas",199,170,29,475,48,72788
"Thorntonville town, Texas",276,271,5,622,48,72800
"Thrall city, Texas",369,339,30,797,48,72824
"Three Rivers city, Texas",536,479,57,1546,48,72872
"Throckmorton town, Texas",321,302,19,540,48,72896
"Thunderbird Bay CDP, Texas",343,293,50,766,48,72902
"Tierra Bonita CDP, Texas",64,64,0,64,48,72948
"Tierra Dorada CDP, Texas",0,0,0,0,48,72950
"Tierra Grande CDP, Texas",20,20,0,61,48,72952
"Tierra Verde CDP, Texas",25,25,0,112,48,72954
"Tiki Island village, Texas",728,715,13,1196,48,72989
"Tilden CDP, Texas",77,77,0,210,48,72992
"Timbercreek Canyon village, Texas",232,228,4,522,48,73030
"Timberwood Park CDP, Texas",17992,17358,634,34253,48,73057
"Timpson city, Texas",447,433,14,1204,48,73076
"Tioga town, Texas",666,640,26,1084,48,73112
"Tira town, Texas",202,202,0,440,48,73124
"Tivoli CDP, Texas",328,250,78,628,48,73148
"Toco city, Texas",21,21,0,44,48,73196
"Todd Mission city, Texas",81,81,0,133,48,73224
"Tolar city, Texas",523,476,47,1358,48,73268
"Tomball city, Texas",5770,5586,184,12630,48,73316
"Tom Bean city, Texas",407,405,2,803,48,73328
"Tool city, Texas",1157,1114,43,2356,48,73352
"Tornillo CDP, Texas",762,723,39,1548,48,73376
"Tow CDP, Texas",35,35,0,148,48,73424
"Town of Pecos city, Texas",5180,4802,378,11919,48,73493
"Toyah town, Texas",12,12,0,30,48,73496
"Tradewinds CDP, Texas",141,141,0,347,48,73526
"Travis Ranch CDP, Texas",4551,4433,118,9037,48,73562
"Trent town, Texas",127,125,2,249,48,73580
"Trenton city, Texas",334,334,0,636,48,73592
"Trinidad city, Texas",320,312,8,933,48,73652
"Trinity city, Texas",1265,1173,92,2493,48,73664
"Trophy Club town, Texas",7300,7005,295,13251,48,73710
"Troup city, Texas",969,790,179,2148,48,73724
"Troy city, Texas",1085,1005,80,2437,48,73748
"Tuleta CDP, Texas",114,110,4,298,48,73856
"Tulia city, Texas",1824,1701,123,4430,48,73868
"Tulsita CDP, Texas",0,0,0,16,48,73904
"Tunis CDP, Texas",0,0,0,12,48,73928
"Turkey city, Texas",137,132,5,292,48,73964
"Tuscola city, Texas",304,303,1,697,48,74048
"Tye city, Texas",490,490,0,1091,48,74132
"Tyler city, Texas",53645,50808,2837,106440,48,74144
"Tynan CDP, Texas",126,117,9,289,48,74168
"Uhland city, Texas",1026,1001,25,1936,48,74216
"Umbarger CDP, Texas",32,32,0,70,48,74228
"Uncertain city, Texas",33,33,0,85,48,74240
"Union Grove city, Texas",459,455,4,844,48,74312
"Union Valley city, Texas",248,248,0,593,48,74372
"Universal City city, Texas",10364,9831,533,19798,48,74408
"University Park city, Texas",11220,10755,465,25179,48,74492
"Utopia CDP, Texas",173,173,0,228,48,74576
"Uvalde city, Texas",6378,6307,71,15342,48,74588
"Uvalde Estates CDP, Texas",1023,856,167,2819,48,74594
"Valentine town, Texas",27,27,0,110,48,74648
"Valera CDP, Texas",48,48,0,54,48,74660
"Valle Hermoso CDP, Texas",0,0,0,0,48,74667
"Valle Verde CDP, Texas",0,0,0,0,48,74668
"Valle Vista CDP, Texas",475,365,110,816,48,74670
"Valley Mills city, Texas",565,556,9,1259,48,74732
"Valley View city, Texas",384,384,0,805,48,74756
"Val Verde Park CDP, Texas",1610,1581,29,3319,48,74895
"Van city, Texas",1254,1191,63,2711,48,74912
"Van Alstyne city, Texas",2275,2275,0,4846,48,74924
"Vanderbilt CDP, Texas",227,179,48,526,48,74984
"Van Horn town, Texas",1021,917,104,2075,48,75032
"Van Vleck CDP, Texas",552,528,24,1049,48,75068
"Vega city, Texas",504,491,13,1035,48,75188
"Venus town, Texas",2342,2225,117,5211,48,75236
"Vernon city, Texas",4811,4268,543,10018,48,75308
"Victoria city, Texas",32125,30365,1760,65481,48,75428
"Victoria Vera CDP, Texas",0,0,0,26,48,75432
"Vidor city, Texas",4741,4406,335,9806,48,75476
"Villa del Sol CDP, Texas",152,152,0,208,48,75554
"Villa Pancho CDP, Texas",197,197,0,452,48,75614
"Villarreal CDP, Texas",90,90,0,90,48,75617
"Villa Verde CDP, Texas",37,26,11,155,48,75626
"Vinton village, Texas",763,714,49,2692,48,75668
"Volente village, Texas",379,354,25,779,48,75752
"Von Ormy city, Texas",502,491,11,1096,48,75764
"Waco city, Texas",67267,64213,3054,140545,48,76000
"Wadsworth CDP, Texas",226,226,0,358,48,76012
"Waelder city, Texas",558,548,10,1061,48,76024
"Waka CDP, Texas",36,36,0,120,48,76048
"Wake Village city, Texas",2806,2758,48,5909,48,76096
"Waller city, Texas",1835,1798,37,3257,48,76228
"Wallis city, Texas",711,578,133,1355,48,76240
"Walnut Springs city, Texas",309,292,17,793,48,76348
"Warren CDP, Texas",305,266,39,731,48,76564
"Warren City city, Texas",199,188,11,378,48,76576
"Washburn CDP, Texas",89,89,0,263,48,76612
"Waskom city, Texas",690,653,37,1682,48,76636
"Watauga city, Texas",13600,12899,701,23509,48,76672
"Waxahachie city, Texas",21919,21237,682,41801,48,76816
"Weatherford city, Texas",16298,15749,549,32168,48,76864
"Webberville village, Texas",281,276,5,497,48,76924
"Webster city, Texas",7745,7370,375,12297,48,76948
"Weimar city, Texas",1356,1248,108,2771,48,77020
"Weinert city, Texas",78,74,4,169,48,77044
"Weir city, Texas",229,229,0,433,48,77056
"Welch CDP, Texas",76,69,7,294,48,77080
"Wellington city, Texas",1003,976,27,2201,48,77152
"Wellman city, Texas",111,111,0,234,48,77164
"Wells town, Texas",250,240,10,774,48,77176
"Wells Branch CDP, Texas",8751,8647,104,13941,48,77196
"Weslaco city, Texas",17074,15894,1180,40858,48,77272
"West city, Texas",1075,1052,23,2577,48,77332
"West Alto Bonito CDP, Texas",251,157,94,505,48,77336
"Westbrook city, Texas",118,118,0,302,48,77380
"West Columbia city, Texas",1838,1736,102,3641,48,77416
"Westdale CDP, Texas",0,0,0,84,48,77422
"Western Lake CDP, Texas",668,486,182,1207,48,77490
"Westlake town, Texas",509,497,12,1300,48,77620
"West Lake Hills city, Texas",1367,1306,61,3360,48,77632
"West Livingston CDP, Texas",1668,1497,171,7559,48,77662
"Westminster CDP, Texas",728,728,0,1317,48,77680
"West Odessa CDP, Texas",14501,13780,721,30904,48,77728
"Weston city, Texas",120,115,5,230,48,77740
"Weston Lakes city, Texas",1494,1477,17,3907,48,77746
"West Orange city, Texas",1422,1370,52,3444,48,77752
"Westover Hills town, Texas",254,244,10,803,48,77788
"West Sharyland CDP, Texas",693,539,154,1718,48,77866
"West Tawakoni city, Texas",758,693,65,1841,48,77896
"West University Place city, Texas",6760,6377,383,14963,48,77956
"Westway CDP, Texas",1291,1222,69,3480,48,78016
"Westwood Shores CDP, Texas",452,417,35,1534,48,78040
"Westworth Village city, Texas",1127,1097,30,2597,48,78076
"Wharton city, Texas",4002,3807,195,8669,48,78136
"Wheeler city, Texas",685,646,39,1454,48,78208
"White Deer town, Texas",475,458,17,914,48,78316
"Whiteface town, Texas",176,162,14,423,48,78328
"Whitehouse city, Texas",4712,4424,288,8512,48,78388
"White Oak city, Texas",3274,3141,133,6227,48,78436
"Whitesboro city, Texas",2021,1946,75,4130,48,78532
"White Settlement city, Texas",8291,7980,311,18106,48,78544
"Whitewright town, Texas",707,656,51,1609,48,78628
"Whitharral CDP, Texas",37,37,0,83,48,78640
"Whitney town, Texas",1005,973,32,2336,48,78664
"Wichita Falls city, Texas",46926,44842,2084,102482,48,79000
"Wickett town, Texas",222,210,12,615,48,79036
"Wildorado CDP, Texas",82,82,0,197,48,79180
"Wild Peach Village CDP, Texas",888,812,76,2325,48,79192
"Wildwood CDP, Texas",293,293,0,795,48,79204
"Willis city, Texas",3390,3103,287,6561,48,79408
"Willow Grove CDP, Texas",1019,997,22,2085,48,79456
"Willow Park city, Texas",2435,2351,84,5055,48,79492
"Wills Point city, Texas",1720,1687,33,3786,48,79564
"Wilmer city, Texas",2654,2486,168,5370,48,79576
"Wilson city, Texas",151,148,3,451,48,79612
"Wimberley city, Texas",1658,1466,192,2858,48,79624
"Windcrest city, Texas",2504,2354,150,5825,48,79672
"Windom town, Texas",58,52,6,100,48,79684
"Windthorst town, Texas",138,138,0,334,48,79696
"Winfield city, Texas",208,199,9,528,48,79720
"Wingate CDP, Texas",37,37,0,120,48,79756
"Wink city, Texas",519,519,0,978,48,79768
"Winnie CDP, Texas",982,915,67,2416,48,79792
"Winnsboro city, Texas",1384,1272,112,3431,48,79816
"Winona town, Texas",352,345,7,584,48,79828
"Winters city, Texas",1097,1076,21,2386,48,79876
"Wixon Valley city, Texas",125,114,11,206,48,79919
"Wolfe City city, Texas",544,520,24,1219,48,79948
"Wolfforth city, Texas",3030,2768,262,5779,48,79972
"Woodbranch city, Texas",723,692,31,1614,48,80044
"Woodcreek city, Texas",1059,882,177,2389,48,80058
"Woodloch town, Texas",84,84,0,153,48,80144
"Woodsboro town, Texas",601,576,25,1227,48,80176
"Woodson town, Texas",172,172,0,391,48,80188
"Woodville town, Texas",1441,1327,114,3081,48,80212
"Woodway city, Texas",4531,4344,187,9399,48,80224
"Wortham town, Texas",391,391,0,1193,48,80296
"Wyldwood CDP, Texas",1328,1287,41,4368,48,80350
"Wylie city, Texas",32749,31601,1148,57063,48,80356
"Yancey CDP, Texas",132,132,0,287,48,80428
"Yantis town, Texas",86,85,1,287,48,80440
"Yoakum city, Texas",2597,2584,13,5841,48,80560
"Yorktown city, Texas",764,707,57,2183,48,80584
"Yznaga CDP, Texas",18,7,11,44,48,80686
"Zapata CDP, Texas",1977,1936,41,5110,48,80716
"Zapata Ranch CDP, Texas",189,189,0,246,48,80722
"Zarate CDP, Texas",0,0,0,0,48,80724
"Zavalla city, Texas",239,221,18,606,48,80728
"Zephyr CDP, Texas",117,113,4,236,48,80740
"Zuehl CDP, Texas",197,197,0,330,48,80836
"Alpine city, Utah",4418,4347,71,10260,49,00540
"Alta town, Utah",327,327,0,376,49,00650
"Altamont town, Utah",166,157,9,434,49,00760
"Alton town, Utah",71,71,0,331,49,00870
"Amalga town, Utah",254,250,4,494,49,01090
"American Fork city, Utah",17380,16809,571,33986,49,01310
"Aneth CDP, Utah",111,85,26,342,49,01530
"Annabella town, Utah",325,325,0,766,49,01750
"Antimony town, Utah",31,29,2,88,49,01860
"Apple Valley town, Utah",602,561,41,1233,49,01905
"Aurora city, Utah",489,486,3,898,49,02740
"Avon CDP, Utah",226,226,0,539,49,02960
"Ballard town, Utah",791,711,80,1700,49,03345
"Bear River City city, Utah",375,371,4,779,49,03950
"Beaver city, Utah",1556,1539,17,3587,49,04060
"Benjamin CDP, Utah",359,359,0,848,49,04720
"Benson CDP, Utah",1039,961,78,1816,49,05050
"Beryl Junction CDP, Utah",11,11,0,23,49,05380
"Bicknell town, Utah",241,239,2,413,49,05490
"Big Water town, Utah",262,249,13,574,49,05534
"Blanding city, Utah",1325,1297,28,3345,49,06370
"Bluebell CDP, Utah",132,132,0,242,49,06590
"Bluff town, Utah",27,27,0,123,49,06700
"Bluffdale city, Utah",9393,9190,203,17460,49,06810
"Bonanza CDP, Utah",0,0,0,0,49,06920
"Boulder town, Utah",126,113,13,352,49,07470
"Bountiful city, Utah",22034,21455,579,45353,49,07690
"Brian Head town, Utah",25,25,0,60,49,08020
"Brigham City city, Utah",9556,9200,356,19602,49,08460
"Brighton town, Utah",202,189,13,299,49,08570
"Bryce Canyon City town, Utah",187,173,14,229,49,08787
"Cache CDP, Utah",46,46,0,105,49,09725
"Cannonville town, Utah",141,139,2,265,49,10330
"Carbonville CDP, Utah",625,625,0,1366,49,10440
"Castle Dale city, Utah",435,418,17,1347,49,10660
"Castle Valley town, Utah",187,187,0,409,49,11000
"Cedar City city, Utah",18015,17465,550,35812,49,11320
"Cedar Fort town, Utah",81,81,0,154,49,11430
"Cedar Highlands CDP, Utah",7,7,0,19,49,11435
"Cedar Hills city, Utah",4401,4278,123,9977,49,11440
"Centerfield town, Utah",731,691,40,1353,49,11870
"Centerville city, Utah",8511,8388,123,16740,49,11980
"Central CDP, Utah",370,335,35,902,49,12200
"Central Valley town, Utah",369,359,10,713,49,12260
"Charleston town, Utah",250,248,2,438,49,12420
"Circleville town, Utah",173,159,14,431,49,12970
"Clarkston town, Utah",317,313,4,659,49,13190
"Clawson town, Utah",13,13,0,61,49,13300
"Clear Creek CDP, Utah",15,15,0,24,49,13740
"Clearfield city, Utah",15448,14985,463,32369,49,13850
"Cleveland town, Utah",221,219,2,501,49,14070
"Clinton city, Utah",11667,11044,623,23389,49,14290
"Coalville city, Utah",1111,1084,27,2014,49,14840
"Copperton metro township, Utah",552,514,38,1017,49,15720
"Corinne city, Utah",372,362,10,777,49,15830
"Cornish town, Utah",118,115,3,236,49,15940
"Cottonwood Heights city, Utah",18807,18208,599,33257,49,16270
"Cove CDP, Utah",166,166,0,475,49,16490
"Dammeron Valley CDP, Utah",130,130,0,817,49,18090
"Daniel town, Utah",523,523,0,1007,49,18140
"Delta city, Utah",1420,1369,51,3636,49,18910
"Deseret CDP, Utah",241,194,47,427,49,19020
"Deweyville town, Utah",147,145,2,288,49,19680
"Draper city, Utah",24955,24405,550,50635,49,20120
"Duchesne city, Utah",769,754,15,1883,49,20340
"Dugway CDP, Utah",278,278,0,394,49,20450
"Dutch John town, Utah",13,13,0,37,49,20780
"Eagle Mountain city, Utah",20512,19814,698,46109,49,20810
"East Basin CDP, Utah",1588,1583,5,3646,49,20850
"East Carbon city, Utah",545,466,79,1441,49,20890
"Echo CDP, Utah",54,39,15,79,49,21880
"Eden CDP, Utah",453,453,0,885,49,21990
"Elberta CDP, Utah",128,128,0,312,49,22210
"Elk Ridge city, Utah",1989,1893,96,4658,49,22370
"Elmo town, Utah",145,139,6,487,49,22540
"Elsinore town, Utah",274,245,29,788,49,22650
"Elwood town, Utah",895,843,52,1598,49,22760
"Emery town, Utah",179,175,4,373,49,22870
"Emigration Canyon metro township, Utah",871,839,32,1503,49,22875
"Enoch city, Utah",3350,3240,110,7563,49,23200
"Enterprise CDP, Utah",375,357,18,772,49,23310
"Enterprise city, Utah",546,530,16,1519,49,23420
"Ephraim city, Utah",2982,2732,250,5739,49,23530
"Erda CDP, Utah",1883,1619,264,3124,49,23640
"Escalante city, Utah",413,413,0,657,49,23750
"Eureka city, Utah",329,297,32,809,49,24080
"Fairfield town, Utah",53,52,1,78,49,24410
"Fairview city, Utah",665,638,27,1288,49,24630
"Farmington city, Utah",10789,10553,236,24463,49,24740
"Farr West city, Utah",4340,4270,70,7747,49,24850
"Fayette town, Utah",160,160,0,339,49,25070
"Ferron city, Utah",549,484,65,1360,49,25180
"Fielding town, Utah",285,258,27,658,49,25290
"Fillmore city, Utah",1232,1159,73,2572,49,25510
"Flaming Gorge CDP, Utah",33,33,0,69,49,25910
"Fort Duchesne CDP, Utah",159,135,24,472,49,26610
"Fountain Green city, Utah",757,720,37,1334,49,26720
"Francis town, Utah",870,870,0,1573,49,26940
"Fremont CDP, Utah",30,30,0,47,49,27270
"Fruit Heights city, Utah",2822,2799,23,6018,49,27490
"Garden CDP, Utah",26,26,0,123,49,27902
"Garden City town, Utah",219,212,7,530,49,27930
"Garland city, Utah",1102,1067,35,2579,49,28150
"Genola town, Utah",753,743,10,1648,49,28810
"Glendale town, Utah",162,152,10,375,49,29360
"Glenwood town, Utah",263,261,2,608,49,29580
"Goshen town, Utah",459,453,6,865,49,30130
"Granite CDP, Utah",376,348,28,703,49,30900
"Grantsville city, Utah",6127,5849,278,12939,49,31120
"Green River city, Utah",393,393,0,788,49,31670
"Gunnison city, Utah",883,853,30,3516,49,32660
"Halchita CDP, Utah",93,93,0,256,49,33002
"Halls Crossing CDP, Utah",0,0,0,0,49,33027
"Hanksville town, Utah",95,95,0,217,49,33100
"Harrisville city, Utah",3726,3628,98,6909,49,33540
"Hatch town, Utah",43,36,7,131,49,33760
"Heber city, Utah",9002,8738,264,16943,49,34200
"Helper city, Utah",1209,1147,62,2482,49,34530
"Henefer town, Utah",380,378,2,708,49,34640
"Henrieville town, Utah",145,145,0,286,49,34750
"Herriman city, Utah",28243,27351,892,55301,49,34970
"Hideout town, Utah",517,517,0,1066,49,35120
"Highland city, Utah",8611,8366,245,19267,49,35190
"Hildale city, Utah",422,395,27,1076,49,35300
"Hinckley town, Utah",458,442,16,790,49,35740
"Hobble Creek CDP, Utah",107,102,5,226,49,35823
"Holden town, Utah",265,252,13,518,49,35960
"Holladay city, Utah",15921,15434,487,31563,49,36070
"Honeyville city, Utah",711,695,16,1601,49,36290
"Hooper city, Utah",4382,4296,86,9080,49,36400
"Howell town, Utah",168,167,1,315,49,36620
"Hoytsville CDP, Utah",252,237,15,769,49,36730
"Huntington city, Utah",922,877,45,2079,49,36950
"Huntsville town, Utah",239,227,12,480,49,37060
"Hurricane city, Utah",8842,8560,282,20609,49,37170
"Hyde Park city, Utah",2278,2201,77,5264,49,37390
"Hyrum city, Utah",4627,4474,153,9680,49,37500
"Independence town, Utah",48,48,0,100,49,37690
"Interlaken town, Utah",55,55,0,84,49,37924
"Ivins city, Utah",3655,3428,227,9174,49,38710
"Jensen CDP, Utah",147,147,0,338,49,39040
"Joseph town, Utah",301,267,34,558,49,39370
"Junction town, Utah",68,54,14,288,49,39590
"Kamas city, Utah",1348,1336,12,2411,49,39810
"Kanab city, Utah",2456,2393,63,4817,49,39920
"Kanarraville town, Utah",160,160,0,327,49,40030
"Kanosh town, Utah",275,275,0,621,49,40250
"Kaysville city, Utah",15122,14731,391,32714,49,40360
"Kearns metro township, Utah",20182,18961,1221,36862,49,40470
"Kenilworth CDP, Utah",69,69,0,95,49,41020
"Kingston town, Utah",137,107,30,362,49,41350
"Koosharem town, Utah",74,74,0,251,49,41680
"Lake Shore CDP, Utah",562,484,78,1235,49,42230
"Laketown town, Utah",156,156,0,320,49,42560
"Lapoint CDP, Utah",16,16,0,48,49,42890
"La Sal CDP, Utah",14,14,0,270,49,43110
"La Verkin city, Utah",2094,2015,79,4360,49,43440
"Layton city, Utah",43521,42507,1014,81726,49,43660
"Leamington town, Utah",130,126,4,303,49,43880
"Leeds town, Utah",315,315,0,798,49,44100
"Lehi city, Utah",37950,36282,1668,77110,49,44320
"Levan town, Utah",337,310,27,779,49,44650
"Lewiston city, Utah",1005,997,8,2185,49,44760
"Liberty CDP, Utah",589,589,0,1216,49,44870
"Lindon city, Utah",5480,5278,202,11478,49,45090
"Loa town, Utah",331,331,0,595,49,45530
"Logan city, Utah",31059,30289,770,53246,49,45860
"Lyman town, Utah",101,101,0,200,49,46410
"Lynndyl town, Utah",25,25,0,119,49,46740
"Maeser CDP, Utah",1566,1511,55,4126,49,47180
"Magna metro township, Utah",16005,15150,855,29275,49,47290
"Manila town, Utah",146,141,5,330,49,47620
"Manti city, Utah",1453,1428,25,3474,49,47730
"Mantua town, Utah",550,539,11,1348,49,47840
"Mapleton city, Utah",4937,4785,152,11756,49,47950
"Marion CDP, Utah",240,240,0,617,49,48170
"Marriott-Slaterville city, Utah",1066,1051,15,2041,49,48300
"Marysvale town, Utah",202,202,0,524,49,48610
"Mayfield town, Utah",179,175,4,416,49,48720
"Meadow town, Utah",107,102,5,244,49,48830
"Mendon city, Utah",814,814,0,1475,49,49160
"Mexican Hat CDP, Utah",0,0,0,22,49,49380
"Midvale city, Utah",21442,20792,650,35609,49,49710
"Midway city, Utah",2480,2372,108,6019,49,49820
"Milford city, Utah",850,793,57,1786,49,50040
"Millcreek city, Utah",35305,33910,1395,63520,49,50150
"Millville city, Utah",849,837,12,1827,49,50370
"Minersville town, Utah",420,378,42,920,49,50590
"Moab city, Utah",3277,3205,72,5329,49,50700
"Modena CDP, Utah",0,0,0,0,49,50810
"Mona city, Utah",809,809,0,1742,49,51140
"Monroe city, Utah",1135,1101,34,2530,49,51360
"Montezuma Creek CDP, Utah",93,67,26,272,49,51470
"Monticello city, Utah",809,809,0,2393,49,51580
"Morgan city, Utah",1914,1862,52,4173,49,51910
"Moroni city, Utah",642,626,16,1259,49,52130
"Mountain Green CDP, Utah",1572,1557,15,3646,49,52460
"Mount Pleasant city, Utah",1730,1656,74,3676,49,53010
"Murray city, Utah",29145,28200,945,50041,49,53230
"Myton city, Utah",242,210,32,616,49,53340
"Naples city, Utah",1081,1057,24,2801,49,53560
"Navajo Mountain CDP, Utah",315,162,153,663,49,53890
"Neola CDP, Utah",181,174,7,470,49,54110
"Nephi city, Utah",3222,3198,24,6507,49,54220
"Newcastle CDP, Utah",121,87,34,335,49,54330
"New Harmony town, Utah",149,146,3,356,49,54440
"Newton town, Utah",418,413,5,901,49,54550
"Nibley city, Utah",3444,3356,88,7373,49,54660
"North Logan city, Utah",5623,5502,121,10981,49,54990
"North Ogden city, Utah",10752,10408,344,21065,49,55100
"North Salt Lake city, Utah",12164,11786,378,21875,49,55210
"Oak City town, Utah",302,297,5,795,49,55430
"Oakley city, Utah",905,868,37,1744,49,55650
"Oasis CDP, Utah",20,20,0,30,49,55760
"Ogden city, Utah",46469,44460,2009,86754,49,55980
"Oljato-Monument Valley CDP, Utah",304,254,50,729,49,56440
"Ophir CDP, Utah",37,37,0,41,49,56750
"Orangeville city, Utah",613,613,0,1340,49,56860
"Orderville town, Utah",266,264,2,636,49,57080
"Orem city, Utah",52526,50745,1781,97100,49,57300
"Palmyra CDP, Utah",224,212,12,602,49,57630
"Panguitch city, Utah",704,661,43,1702,49,57740
"Paradise town, Utah",390,382,8,830,49,57850
"Paragonah town, Utah",247,247,0,663,49,57960
"Park City city, Utah",5085,5023,62,8379,49,58070
"Parowan city, Utah",1231,1130,101,3036,49,58510
"Payson city, Utah",10942,10411,531,21529,49,58730
"Peoa CDP, Utah",70,70,0,87,49,59280
"Perry city, Utah",2619,2610,9,5579,49,59390
"Peter CDP, Utah",118,118,0,276,49,59555
"Pine Valley CDP, Utah",133,133,0,310,49,60270
"Plain City city, Utah",3838,3796,42,7873,49,60710
"Pleasant Grove city, Utah",18660,18172,488,37453,49,60930
"Pleasant View city, Utah",5192,5091,101,10942,49,61150
"Plymouth town, Utah",183,181,2,357,49,61260
"Portage town, Utah",86,82,4,209,49,61590
"Price city, Utah",3739,3434,305,8174,49,62030
"Providence city, Utah",3702,3613,89,8418,49,62360
"Provo city, Utah",69410,66350,3060,114400,49,62470
"Randlett CDP, Utah",12,12,0,62,49,62910
"Randolph town, Utah",288,288,0,966,49,63020
"Redmond town, Utah",405,392,13,846,49,63240
"Richfield city, Utah",3483,3300,183,8213,49,63570
"Richmond city, Utah",1391,1360,31,2926,49,63680
"Riverdale city, Utah",4599,4398,201,9313,49,64010
"River Heights city, Utah",1188,1160,28,2236,49,64120
"Riverside CDP, Utah",541,541,0,1283,49,64230
"Riverton city, Utah",23092,22283,809,44864,49,64340
"Rockville town, Utah",68,68,0,180,49,64560
"Rocky Ridge town, Utah",332,325,7,859,49,64590
"Roosevelt city, Utah",3044,2837,207,6884,49,64670
"Roy city, Utah",20685,20145,540,39064,49,65110
"Rush Valley town, Utah",185,182,3,437,49,65240
"St. George city, Utah",41969,40582,1387,96174,49,65330
"Salem city, Utah",4344,4206,138,9467,49,65770
"Salina city, Utah",1273,1146,127,2500,49,65880
"Salt Lake City city, Utah",123259,118816,4443,201269,49,67000
"Samak CDP, Utah",52,43,9,122,49,67400
"Sandy city, Utah",51409,50301,1108,95635,49,67440
"Santa Clara city, Utah",3756,3628,128,7625,49,67660
"Santaquin city, Utah",6792,6580,212,14463,49,67770
"Saratoga Springs city, Utah",17272,16897,375,40391,49,67825
"Scipio town, Utah",203,201,2,400,49,67880
"Scofield town, Utah",26,20,6,43,49,67990
"Sigurd town, Utah",241,228,13,498,49,68650
"Silver Summit CDP, Utah",1036,956,80,1703,49,69280
"Smithfield city, Utah",6173,6005,168,13658,49,69640
"Snowville town, Utah",59,59,0,247,49,69970
"Snyderville CDP, Utah",3218,3185,33,5730,49,70190
"South Jordan city, Utah",40424,39414,1010,78118,49,70850
"South Ogden city, Utah",8989,8802,187,17476,49,70960
"South Salt Lake city, Utah",15774,15010,764,26315,49,71070
"South Weber city, Utah",4186,4073,113,7939,49,71180
"South Willard CDP, Utah",721,721,0,1548,49,71255
"Spanish Fork city, Utah",20929,20527,402,42694,49,71290
"Spanish Valley CDP, Utah",363,363,0,545,49,71455
"Spring City city, Utah",467,411,56,1108,49,71730
"Springdale town, Utah",224,220,4,454,49,71840
"Spring Glen CDP, Utah",494,494,0,1070,49,72060
"Spring Lake CDP, Utah",247,247,0,517,49,72170
"Springville city, Utah",16442,15997,445,35195,49,72280
"Stansbury Park CDP, Utah",5722,5639,83,10512,49,72720
"Sterling town, Utah",135,126,9,355,49,72940
"Stockton town, Utah",492,464,28,915,49,73050
"Summit CDP, Utah",135,135,0,234,49,74040
"Summit Park CDP, Utah",4954,4786,168,8708,49,74095
"Sundance CDP, Utah",14,14,0,47,49,74260
"Sunset city, Utah",2997,2905,92,5443,49,74480
"Sutherland CDP, Utah",80,80,0,185,49,74590
"Syracuse city, Utah",16352,16162,190,32798,49,74810
"Tabiona town, Utah",66,64,2,156,49,74920
"Taylorsville city, Utah",31787,30341,1446,59729,49,75360
"Teasdale CDP, Utah",98,98,0,217,49,75470
"Thatcher CDP, Utah",425,425,0,1056,49,75800
"Thompson Springs CDP, Utah",0,0,0,0,49,76180
"Timber Lakes CDP, Utah",281,281,0,710,49,76280
"Tooele city, Utah",18811,18076,735,36315,49,76680
"Toquerville city, Utah",951,918,33,2034,49,76900
"Torrey town, Utah",86,86,0,219,49,77010
"Tremonton city, Utah",4866,4746,120,10273,49,77120
"Trenton town, Utah",309,300,9,567,49,77230
"Tropic town, Utah",252,252,0,524,49,77560
"Tselakai Dezza CDP, Utah",23,19,4,89,49,77697
"Uintah town, Utah",749,728,21,1611,49,77890
"Vernal city, Utah",4816,4387,429,10141,49,80090
"Vernon town, Utah",84,83,1,228,49,80200
"Veyo CDP, Utah",157,141,16,381,49,80310
"Vineyard town, Utah",7573,7434,139,12663,49,80420
"Virgin town, Utah",238,228,10,690,49,80530
"Wales town, Utah",137,128,9,371,49,80860
"Wallsburg town, Utah",140,140,0,289,49,80970
"Wanship CDP, Utah",192,192,0,320,49,81190
"Washington city, Utah",13783,13675,108,29161,49,81960
"Washington Terrace city, Utah",4287,4162,125,9220,49,82070
"Wellington city, Utah",608,563,45,1506,49,82510
"Wellsville city, Utah",1923,1910,13,4078,49,82620
"Wendover city, Utah",589,569,20,1163,49,82730
"West Bountiful city, Utah",2946,2905,41,5905,49,82840
"West Haven city, Utah",9608,9431,177,18334,49,82930
"West Jordan city, Utah",65958,63209,2749,116383,49,82950
"West Mountain CDP, Utah",679,646,33,1267,49,83252
"West Point city, Utah",6506,6445,61,11226,49,83390
"West Valley City city, Utah",72792,69912,2880,138868,49,83470
"West Wood CDP, Utah",229,219,10,967,49,83730
"White City metro township, Utah",2964,2796,168,5562,49,84050
"White Mesa CDP, Utah",26,26,0,60,49,84095
"Whiterocks CDP, Utah",45,26,19,191,49,84160
"Willard city, Utah",919,912,7,1753,49,84710
"Wolf Creek CDP, Utah",838,838,0,1642,49,84950
"Woodland CDP, Utah",140,126,14,471,49,85040
"Woodland Hills city, Utah",610,596,14,1329,49,85050
"Woodruff town, Utah",88,88,0,262,49,85260
"Woods Cross city, Utah",6484,6337,147,11432,49,85370
"Albany village, Vermont",98,98,0,201,50,00400
"Alburgh village, Vermont",224,218,6,443,50,00850
"Algiers CDP, Vermont",141,141,0,226,50,01035
"Arlington CDP, Vermont",949,894,55,1781,50,01375
"Ascutney CDP, Vermont",144,144,0,429,50,01750
"Bakersfield CDP, Vermont",262,232,30,443,50,02425
"Barnet CDP, Vermont",31,31,0,131,50,02800
"Barre city, Vermont",4275,3967,308,8488,50,03175
"Barton village, Vermont",283,239,44,700,50,03475
"Beecher Falls CDP, Vermont",46,39,7,101,50,04150
"Bellows Falls village, Vermont",1539,1493,46,2824,50,04225
"Bennington CDP, Vermont",3895,3709,186,8753,50,04750
"Benson CDP, Vermont",94,88,6,232,50,05125
"Bethel CDP, Vermont",389,363,26,666,50,05725
"Bolton CDP, Vermont",29,20,9,37,50,06475
"Bolton Valley CDP, Vermont",133,133,0,165,50,06700
"Bradford CDP, Vermont",746,715,31,1272,50,07225
"Brandon CDP, Vermont",847,836,11,1858,50,07675
"Brattleboro CDP, Vermont",3547,3220,327,7543,50,07975
"Bristol CDP, Vermont",1103,1015,88,1956,50,08950
"Burlington city, Vermont",26151,24920,1231,44646,50,10675
"Cabot CDP, Vermont",120,109,11,272,50,11050
"Cambridge village, Vermont",143,135,8,198,50,11425
"Canaan CDP, Vermont",164,144,20,286,50,11725
"Castleton CDP, Vermont",363,338,25,905,50,11875
"Castleton Four Corners CDP, Vermont",382,367,15,780,50,12062
"Cavendish CDP, Vermont",113,99,14,208,50,12175
"Chelsea CDP, Vermont",202,187,15,486,50,13450
"Chester CDP, Vermont",538,526,12,1097,50,13600
"Chimney Hill CDP, Vermont",15,15,0,38,50,13860
"Chittenden CDP, Vermont",97,97,0,156,50,14275
"Concord CDP, Vermont",111,111,0,181,50,15175
"Coventry CDP, Vermont",12,12,0,14,50,16075
"Danby CDP, Vermont",105,99,6,178,50,16750
"Danville CDP, Vermont",256,256,0,450,50,17050
"Derby Center village, Vermont",414,402,12,802,50,17425
"Derby Line village, Vermont",300,291,9,692,50,17500
"Dorset CDP, Vermont",139,139,0,374,50,17650
"East Barre CDP, Vermont",526,467,59,1136,50,19075
"East Burke CDP, Vermont",83,83,0,110,50,19600
"East Charlotte CDP, Vermont",129,123,6,161,50,19975
"East Dorset CDP, Vermont",169,169,0,253,50,20350
"East Middlebury CDP, Vermont",286,286,0,483,50,21700
"East Montpelier CDP, Vermont",15,15,0,63,50,21850
"East Poultney CDP, Vermont",92,92,0,255,50,22300
"Enosburg Falls village, Vermont",719,668,51,1554,50,24025
"Essex Junction village, Vermont",6276,6120,156,10646,50,24400
"Fairfax CDP, Vermont",473,409,64,880,50,24850
"Fair Haven CDP, Vermont",1260,1216,44,2422,50,25450
"Fairlee CDP, Vermont",61,58,3,119,50,25600
"Gilman CDP, Vermont",86,86,0,214,50,27925
"Glover CDP, Vermont",75,65,10,223,50,28000
"Grafton CDP, Vermont",54,54,0,87,50,28825
"Graniteville CDP, Vermont",290,276,14,487,50,29425
"Greensboro CDP, Vermont",42,42,0,102,50,30100
"Greensboro Bend CDP, Vermont",139,139,0,265,50,30325
"Groton CDP, Vermont",281,251,30,576,50,30475
"Hanksville CDP, Vermont",24,24,0,33,50,31600
"Hardwick CDP, Vermont",638,628,10,1247,50,31750
"Harmonyville CDP, Vermont",157,157,0,218,50,32050
"Hartford Village CDP, Vermont",371,371,0,479,50,32205
"Hartland CDP, Vermont",282,264,18,625,50,32350
"Highgate Center CDP, Vermont",80,80,0,263,50,33175
"Highgate Springs CDP, Vermont",3,3,0,3,50,33325
"Hinesburg CDP, Vermont",516,495,21,790,50,33400
"Huntington CDP, Vermont",294,287,7,589,50,34525
"Huntington Center CDP, Vermont",93,93,0,118,50,34675
"Hyde Park village, Vermont",221,213,8,433,50,34975
"Irasburg CDP, Vermont",80,80,0,189,50,35500
"Island Pond CDP, Vermont",316,316,0,759,50,35725
"Jacksonville village, Vermont",117,93,24,232,50,36025
"Jamaica CDP, Vermont",68,52,16,68,50,36100
"Jeffersonville village, Vermont",470,430,40,739,50,36475
"Jericho village, Vermont",675,675,0,1166,50,36625
"Johnson village, Vermont",783,704,79,1347,50,37000
"Killington Village CDP, Vermont",261,244,17,468,50,37750
"Lincoln CDP, Vermont",135,123,12,259,50,40000
"Londonderry CDP, Vermont",31,31,0,68,50,40150
"Lowell CDP, Vermont",109,93,16,210,50,40450
"Ludlow village, Vermont",397,383,14,711,50,41200
"Lunenburg CDP, Vermont",161,127,34,342,50,41350
"Lyndon CDP, Vermont",70,49,21,116,50,41650
"Lyndon Center CDP, Vermont",163,144,19,295,50,41800
"Lyndonville village, Vermont",674,655,19,1143,50,41950
"Manchester village, Vermont",220,220,0,703,50,42700
"Manchester Center CDP, Vermont",981,948,33,1835,50,42925
"Marshfield village, Vermont",192,185,7,418,50,43525
"Middlebury CDP, Vermont",2835,2670,165,6913,50,44275
"Middletown Springs CDP, Vermont",76,76,0,153,50,44725
"Milton CDP, Vermont",2176,1827,349,3712,50,45175
"Montpelier city, Vermont",4637,4498,139,8030,50,46000
"Morrisville village, Vermont",1507,1411,96,2576,50,46825
"Newbury village, Vermont",188,185,3,429,50,48100
"Newfane village, Vermont",114,114,0,135,50,48325
"New Haven CDP, Vermont",140,131,9,168,50,48550
"Newport city, Vermont",2037,1841,196,4431,50,48850
"Newport Center CDP, Vermont",99,92,7,199,50,49000
"North Bennington village, Vermont",620,583,37,1420,50,49075
"North Clarendon CDP, Vermont",250,250,0,424,50,49450
"Northfield CDP, Vermont",2192,2148,44,4390,50,50200
"North Hartland CDP, Vermont",191,191,0,416,50,50500
"North Hyde Park CDP, Vermont",247,247,0,395,50,50725
"North Pownal CDP, Vermont",188,139,49,390,50,51325
"North Springfield CDP, Vermont",326,326,0,447,50,51925
"North Troy village, Vermont",297,268,29,584,50,52075
"North Westminster CDP, Vermont",62,28,34,131,50,52375
"Norwich CDP, Vermont",396,381,15,839,50,52825
"Old Bennington village, Vermont",84,83,1,161,50,53125
"Orleans village, Vermont",493,477,16,983,50,53575
"Pawlet CDP, Vermont",126,119,7,303,50,54175
"Peacham CDP, Vermont",70,63,7,224,50,54325
"Pittsford CDP, Vermont",266,242,24,583,50,55525
"Plainfield CDP, Vermont",252,252,0,430,50,55750
"Poultney village, Vermont",493,466,27,1250,50,56800
"Pownal CDP, Vermont",184,153,31,556,50,56950
"Pownal Center CDP, Vermont",308,308,0,519,50,57100
"Proctor CDP, Vermont",745,726,19,1652,50,57246
"Proctorsville CDP, Vermont",210,206,4,359,50,57400
"Putney CDP, Vermont",130,127,3,360,50,57625
"Quechee CDP, Vermont",133,120,13,340,50,57775
"Randolph CDP, Vermont",1198,1106,92,2010,50,58000
"Readsboro CDP, Vermont",189,189,0,284,50,58525
"Richford CDP, Vermont",653,601,52,1636,50,59050
"Richmond CDP, Vermont",462,462,0,689,50,59200
"Rochester CDP, Vermont",106,103,3,296,50,60025
"Rutland city, Vermont",8368,7858,510,15819,50,61225
"St. Albans city, Vermont",3318,3245,73,6891,50,61675
"St. George CDP, Vermont",212,209,3,445,50,62046
"St. Johnsbury CDP, Vermont",3091,2949,142,5963,50,62125
"Saxtons River village, Vermont",342,332,10,633,50,62950
"Sheffield CDP, Vermont",96,96,0,194,50,64000
"Shelburne CDP, Vermont",3061,2927,134,6195,50,64225
"South Barre CDP, Vermont",1001,1001,0,1362,50,66025
"South Burlington city, Vermont",12568,11895,673,20241,50,66175
"South Hero CDP, Vermont",91,91,0,162,50,66925
"South Lincoln CDP, Vermont",109,107,2,153,50,67150
"South Londonderry CDP, Vermont",186,186,0,214,50,67225
"South Royalton CDP, Vermont",282,282,0,475,50,68050
"South Shaftsbury CDP, Vermont",263,263,0,427,50,68200
"South Woodstock CDP, Vermont",24,24,0,24,50,69250
"Springfield CDP, Vermont",1626,1558,68,3946,50,69475
"Stamford CDP, Vermont",253,236,17,533,50,69700
"Stowe CDP, Vermont",213,189,24,721,50,70450
"Stratton Mountain CDP, Vermont",30,30,0,57,50,70825
"Sutton CDP, Vermont",93,93,0,155,50,71500
"Swanton village, Vermont",1142,1048,94,2428,50,71650
"Townshend CDP, Vermont",35,31,4,170,50,73225
"Troy CDP, Vermont",82,82,0,137,50,73450
"Underhill Center CDP, Vermont",40,40,0,56,50,74050
"Underhill Flats CDP, Vermont",403,403,0,650,50,74125
"Vergennes city, Vermont",1563,1532,31,2561,50,74650
"Waitsfield CDP, Vermont",116,116,0,228,50,75250
"Wallingford CDP, Vermont",385,385,0,786,50,75850
"Wardsboro CDP, Vermont",53,47,6,98,50,76150
"Waterbury CDP, Vermont",883,861,22,1686,50,76900
"Waterbury Center CDP, Vermont",157,157,0,261,50,77050
"Websterville CDP, Vermont",153,153,0,249,50,77800
"Wells CDP, Vermont",224,224,0,369,50,77875
"Wells River village, Vermont",128,118,10,326,50,78025
"West Brattleboro CDP, Vermont",1521,1446,75,2817,50,78850
"West Burke village, Vermont",77,68,9,175,50,79150
"West Charlotte CDP, Vermont",129,129,0,223,50,79335
"West Dummerston CDP, Vermont",36,36,0,57,50,79750
"Westford CDP, Vermont",105,93,12,203,50,80275
"Westminster village, Vermont",271,269,2,600,50,81325
"Weston CDP, Vermont",18,18,0,39,50,81925
"West Pawlet CDP, Vermont",175,166,9,301,50,82150
"West Rutland CDP, Vermont",1105,1088,17,2222,50,82375
"West Woodstock CDP, Vermont",223,223,0,397,50,83125
"White River Junction CDP, Vermont",1437,1371,66,2766,50,83575
"Whitingham CDP, Vermont",46,46,0,109,50,83875
"Wilder CDP, Vermont",2132,2008,124,3634,50,84025
"Williamstown CDP, Vermont",920,909,11,1508,50,84100
"Wilmington CDP, Vermont",138,138,0,385,50,84625
"Windsor CDP, Vermont",1120,1078,42,2138,50,85000
"Winooski city, Vermont",5450,5346,104,8122,50,85150
"Wolcott CDP, Vermont",120,120,0,171,50,85300
"Woodstock village, Vermont",504,504,0,1033,50,85900
"Worcester CDP, Vermont",61,37,24,115,50,86050
"Abbs Valley CDP, Virginia",77,77,0,184,51,00110
"Abingdon town, Virginia",4306,4133,173,8346,51,00148
"Accomac town, Virginia",363,356,7,981,51,00180
"Adwolf CDP, Virginia",416,416,0,1434,51,00468
"Afton CDP, Virginia",217,217,0,263,51,00484
"Alberta town, Virginia",163,156,7,297,51,00724
"Aldie CDP, Virginia",79,70,9,211,51,00772
"Alexandria city, Virginia",99420,96223,3197,157594,51,01000
"Allison Gap CDP, Virginia",172,141,31,647,51,01240
"Allisonia CDP, Virginia",25,25,0,56,51,01256
"Altavista town, Virginia",1648,1459,189,3370,51,01528
"Amelia Court House CDP, Virginia",382,317,65,916,51,01640
"Amherst town, Virginia",966,954,12,2299,51,01672
"Amonate CDP, Virginia",0,0,0,0,51,01752
"Annandale CDP, Virginia",23583,22786,797,42330,51,01912
"Appalachia town, Virginia",568,510,58,1585,51,02040
"Apple Mountain Lake CDP, Virginia",893,876,17,1584,51,02064
"Appomattox town, Virginia",1107,1035,72,2157,51,02072
"Aquia Harbour CDP, Virginia",3369,3249,120,6947,51,02112
"Arcola CDP, Virginia",1306,1276,30,2437,51,02248
"Arlington CDP, Virginia",151158,146957,4201,235845,51,03000
"Arrington CDP, Virginia",523,505,18,1226,51,03208
"Ashburn CDP, Virginia",24916,24234,682,45479,51,03320
"Ashland town, Virginia",3629,3518,111,7617,51,03368
"Atkins CDP, Virginia",550,541,9,1028,51,03512
"Atlantic CDP, Virginia",217,193,24,560,51,03528
"Augusta Springs CDP, Virginia",79,79,0,124,51,03608
"Austinville CDP, Virginia",0,0,0,0,51,03656
"Bailey's Crossroads CDP, Virginia",12851,11914,937,24785,51,04088
"Barboursville CDP, Virginia",232,232,0,708,51,04392
"Baskerville CDP, Virginia",45,45,0,231,51,04856
"Bassett CDP, Virginia",227,197,30,852,51,04872
"Bastian CDP, Virginia",83,83,0,373,51,04904
"Basye CDP, Virginia",640,640,0,1341,51,04920
"Bayside CDP, Virginia",138,138,0,194,51,05200
"Baywood CDP, Virginia",245,245,0,661,51,05256
"Bealeton CDP, Virginia",2673,2658,15,4670,51,05336
"Bedford town, Virginia",3048,2975,73,6676,51,05544
"Belle Haven town, Virginia",371,371,0,747,51,05912
"Belle Haven CDP, Virginia",3446,3331,115,6359,51,05928
"Bellwood CDP, Virginia",3964,3667,297,7783,51,06216
"Belmont CDP, Virginia",5608,5421,187,9888,51,06275
"Belmont Estates CDP, Virginia",431,431,0,1192,51,06336
"Belspring CDP, Virginia",96,96,0,170,51,06424
"Belview CDP, Virginia",464,464,0,1197,51,06512
"Benns Church CDP, Virginia",499,442,57,1157,51,06712
"Bensley CDP, Virginia",3240,2966,274,6032,51,06728
"Berryville town, Virginia",1886,1793,93,4598,51,06968
"Bethel Manor CDP, Virginia",1006,1006,0,4422,51,07160
"Big Island CDP, Virginia",52,52,0,181,51,07400
"Big Rock CDP, Virginia",58,58,0,162,51,07448
"Big Stone Gap town, Virginia",1924,1698,226,5221,51,07480
"Big Stone Gap East CDP, Virginia",161,154,7,656,51,07484
"Blacksburg town, Virginia",19599,18927,672,45147,51,07784
"Blackstone town, Virginia",1602,1530,72,3362,51,07832
"Blairs CDP, Virginia",437,437,0,1015,51,07944
"Bland CDP, Virginia",196,184,12,433,51,07976
"Bloxom town, Virginia",184,174,10,398,51,08120
"Bluefield town, Virginia",2009,1952,57,5059,51,08152
"Blue Ridge CDP, Virginia",1555,1485,70,2994,51,08200
"Blue Ridge Shores CDP, Virginia",381,358,23,666,51,08264
"Bobtown CDP, Virginia",91,91,0,214,51,08320
"Boissevain CDP, Virginia",204,204,0,680,51,08376
"Bon Air CDP, Virginia",9788,9360,428,17452,51,08472
"Boones Mill town, Virginia",131,118,13,205,51,08584
"Boston CDP, Virginia",231,222,9,406,51,08675
"Boswell's Corner CDP, Virginia",727,711,16,1215,51,08708
"Bowling Green town, Virginia",647,622,25,1538,51,08888
"Boyce town, Virginia",588,565,23,956,51,08984
"Boydton town, Virginia",137,136,1,279,51,09016
"Boykins town, Virginia",247,246,1,550,51,09032
"Bracey CDP, Virginia",678,606,72,1417,51,09064
"Braddock CDP, Virginia",3136,3073,63,6360,51,09072
"Brambleton CDP, Virginia",13126,12796,330,22796,51,09188
"Branchville town, Virginia",86,65,21,131,51,09208
"Brandermill CDP, Virginia",8130,7785,345,14285,51,09248
"Brandy Station CDP, Virginia",50,50,0,180,51,09352
"Breaks CDP, Virginia",32,32,0,182,51,09400
"Bridgewater town, Virginia",3376,3154,222,6575,51,09656
"Brightwood CDP, Virginia",983,954,29,1775,51,09752
"Bristol city, Virginia",7751,7430,321,17036,51,09816
"Broadlands CDP, Virginia",8050,7859,191,14582,51,09952
"Broadway town, Virginia",2427,2389,38,4169,51,10040
"Brodnax town, Virginia",218,209,9,365,51,10072
"Brookneal town, Virginia",462,421,41,1225,51,10296
"Brucetown CDP, Virginia",170,150,20,235,51,10568
"Buchanan town, Virginia",540,496,44,1108,51,10744
"Buckhall CDP, Virginia",11282,10877,405,20095,51,10776
"Buckingham Courthouse CDP, Virginia",149,149,0,272,51,10856
"Buena Vista city, Virginia",3159,3117,42,6639,51,11032
"Bull Run CDP (Fairfax County), Virginia",3987,3909,78,7504,51,11224
"Bull Run CDP (Prince William County), Virginia",10215,9916,299,16620,51,11230
"Bull Run Mountain Estates CDP, Virginia",660,606,54,1525,51,11245
"Burke CDP, Virginia",23043,21594,1449,44228,51,11464
"Burke Centre CDP, Virginia",9703,9178,525,17926,51,11470
"Burkeville town, Virginia",226,225,1,485,51,11560
"Callaghan CDP, Virginia",210,207,3,317,51,12136
"Calverton CDP, Virginia",31,31,0,54,51,12264
"Camp Barrett CDP, Virginia",84,84,0,1506,51,12472
"Camptown CDP, Virginia",347,314,33,627,51,12590
"Cana CDP, Virginia",797,780,17,1330,51,12600
"Cape Charles town, Virginia",491,454,37,1183,51,12808
"Capron town, Virginia",58,58,0,132,51,12904
"Captains Cove CDP, Virginia",323,283,40,1189,51,12915
"Carrollton CDP, Virginia",3993,3522,471,7330,51,13160
"Carrsville CDP, Virginia",128,128,0,253,51,13192
"Cascades CDP, Virginia",7314,7033,281,12542,51,13403
"Castlewood CDP, Virginia",347,340,7,1122,51,13512
"Catlett CDP, Virginia",153,153,0,190,51,13624
"Cats Bridge CDP, Virginia",59,59,0,168,51,13635
"Cave Spring CDP, Virginia",13943,13566,377,26013,51,13720
"Cedar Bluff town, Virginia",447,421,26,1210,51,13784
"Central Garage CDP, Virginia",925,879,46,1393,51,14312
"Centreville CDP, Virginia",43415,41489,1926,72680,51,14440
"Chamberlayne CDP, Virginia",2759,2559,200,4965,51,14544
"Chantilly CDP, Virginia",13081,12705,376,23107,51,14744
"Charles City CDP, Virginia",19,19,0,31,51,14904
"Charlotte Court House town, Virginia",330,324,6,696,51,14952
"Charlottesville city, Virginia",25267,23975,1292,46289,51,14968
"Chase City town, Virginia",960,939,21,2339,51,14984
"Chase Crossing CDP, Virginia",229,170,59,502,51,14995
"Chatham town, Virginia",655,636,19,1637,51,15000
"Chatmoss CDP, Virginia",615,615,0,1064,51,15048
"Cheriton town, Virginia",213,208,5,562,51,15112
"Cherry Hill CDP, Virginia",12799,12092,707,22505,51,15176
"Chesapeake city, Virginia",123884,117682,6202,249377,51,16000
"Chester CDP, Virginia",12200,11771,429,23068,51,16096
"Chester Gap CDP, Virginia",526,509,17,1069,51,16240
"Chilhowie town, Virginia",1119,1089,30,2371,51,16480
"Chincoteague town, Virginia",1272,1180,92,3303,51,16512
"Christiansburg town, Virginia",12161,11870,291,22947,51,16608
"Churchville CDP, Virginia",48,48,0,61,51,16736
"Claremont town, Virginia",182,182,0,421,51,16880
"Clarksville town, Virginia",555,517,38,1629,51,16992
"Claypool Hill CDP, Virginia",439,410,29,1219,51,17120
"Cleveland town, Virginia",139,93,46,352,51,17296
"Clifton town, Virginia",184,184,0,358,51,17376
"Cliftondale Park CDP, Virginia",26,26,0,196,51,17424
"Clifton Forge town, Virginia",1108,1014,94,3541,51,17440
"Clinchco town, Virginia",49,47,2,354,51,17504
"Clinchport town, Virginia",18,18,0,66,51,17536
"Clintwood town, Virginia",473,433,40,1381,51,17552
"Clover CDP, Virginia",178,178,0,563,51,17632
"Cloverdale CDP, Virginia",1845,1750,95,3501,51,17680
"Cluster Springs CDP, Virginia",413,413,0,953,51,17776
"Coeburn town, Virginia",568,503,65,1533,51,17952
"Collinsville CDP, Virginia",3590,3347,243,7640,51,18352
"Colonial Beach town, Virginia",1327,1273,54,3895,51,18400
"Colonial Heights city, Virginia",9266,8700,566,18158,51,18448
"Columbia CDP, Virginia",18,18,0,40,51,18624
"Concord CDP, Virginia",673,673,0,1117,51,18880
"Countryside CDP, Virginia",5823,5644,179,9646,51,19560
"County Center CDP, Virginia",2190,2031,159,4024,51,19571
"Courtland town, Virginia",697,615,82,1642,51,19600
"Covington city, Virginia",2419,2357,62,5722,51,19728
"Craigsville town, Virginia",362,343,19,931,51,19904
"Crewe town, Virginia",1394,1268,126,2931,51,20160
"Crimora CDP, Virginia",1014,953,61,2017,51,20240
"Crosspointe CDP, Virginia",2816,2772,44,5305,51,20436
"Crozet CDP, Virginia",4541,4419,122,8894,51,20560
"Culpeper town, Virginia",10395,9985,410,20105,51,20752
"Cumberland CDP, Virginia",168,153,15,334,51,20768
"Dahlgren CDP, Virginia",1975,1897,78,3517,51,21008
"Dahlgren Center CDP, Virginia",154,146,8,723,51,21016
"Dale City CDP, Virginia",40375,38534,1841,73928,51,21088
"Daleville CDP, Virginia",1370,1253,117,3169,51,21152
"Damascus town, Virginia",322,319,3,767,51,21184
"Dante CDP, Virginia",46,36,10,518,51,21312
"Danville city, Virginia",17694,16670,1024,42507,51,21344
"Dayton town, Virginia",1132,1087,45,1915,51,21648
"Deep Creek CDP, Virginia",0,0,0,38,51,21776
"Deerfield CDP, Virginia",321,321,0,351,51,21872
"Deltaville CDP, Virginia",314,291,23,809,51,22064
"Dendron town, Virginia",138,127,11,243,51,22160
"Difficult Run CDP, Virginia",5000,4924,76,10434,51,22472
"Dillwyn town, Virginia",294,282,12,580,51,22560
"Dinwiddie CDP, Virginia",192,192,0,280,51,22576
"Disputanta CDP, Virginia",482,482,0,807,51,22640
"Dooms CDP, Virginia",556,556,0,1040,51,22976
"Doran CDP, Virginia",0,0,0,14,51,23008
"Drakes Branch town, Virginia",152,152,0,508,51,23376
"Dranesville CDP, Virginia",6714,6489,225,12154,51,23392
"Draper CDP, Virginia",234,234,0,441,51,23408
"Dryden CDP, Virginia",277,256,21,684,51,23584
"Dublin town, Virginia",1003,971,32,2673,51,23648
"Duffield town, Virginia",25,24,1,65,51,23680
"Dulles Town Center CDP, Virginia",3805,3650,155,5884,51,23732
"Dumbarton CDP, Virginia",5493,5248,245,8271,51,23744
"Dumfries town, Virginia",2900,2756,144,5697,51,23760
"Dunbar CDP, Virginia",0,0,0,43,51,23776
"Dungannon town, Virginia",89,89,0,309,51,23952
"Dunn Loring CDP, Virginia",4684,4506,178,8707,51,23984
"Eagle Rock CDP, Virginia",51,51,0,156,51,24208
"Earlysville CDP, Virginia",643,625,18,1182,51,24272
"East Highland Park CDP, Virginia",9755,9364,391,16499,51,24496
"East Lexington CDP, Virginia",845,845,0,2034,51,24544
"East Stone Gap CDP, Virginia",515,444,71,828,51,24720
"Eastville town, Virginia",171,168,3,316,51,24752
"Ebony CDP, Virginia",54,54,0,126,51,24816
"Edinburg town, Virginia",788,761,27,1321,51,25008
"Eggleston CDP, Virginia",40,40,0,83,51,25136
"Elkton town, Virginia",1654,1639,15,2948,51,25408
"Elliston CDP, Virginia",391,391,0,1092,51,25488
"Emory CDP, Virginia",563,518,45,1052,51,25792
"Emporia city, Virginia",2349,2185,164,5680,51,25808
"Enon CDP, Virginia",1878,1801,77,4087,51,25877
"Esmont CDP, Virginia",243,232,11,456,51,25968
"Ettrick CDP, Virginia",2907,2468,439,5632,51,26128
"Ewing CDP, Virginia",235,235,0,476,51,26384
"Exmore town, Virginia",776,724,52,1744,51,26416
"Fairfax city, Virginia",13639,13137,502,24242,51,26496
"Fairfax Station CDP, Virginia",6543,6278,265,12277,51,26592
"Fairfield CDP, Virginia",198,198,0,337,51,26656
"Fair Lakes CDP, Virginia",5566,5418,148,8918,51,26701
"Fairlawn CDP, Virginia",1074,1040,34,2400,51,26736
"Fair Oaks CDP, Virginia",22159,20860,1299,35130,51,26875
"Fairview CDP, Virginia",99,99,0,274,51,26944
"Fairview Beach CDP, Virginia",139,139,0,251,51,27040
"Falls Church city, Virginia",8448,7941,507,14576,51,27200
"Falls Mills CDP, Virginia",35,35,0,128,51,27232
"Falmouth CDP, Virginia",2439,2263,176,4689,51,27264
"Fancy Gap CDP, Virginia",14,14,0,23,51,27296
"Farmville town, Virginia",2651,2566,85,7647,51,27440
"Ferrum CDP, Virginia",876,819,57,1717,51,27712
"Fieldale CDP, Virginia",200,200,0,802,51,27744
"Fincastle town, Virginia",240,237,3,621,51,27824
"Fishersville CDP, Virginia",4180,3926,254,9422,51,27968
"Flint Hill CDP, Virginia",45,45,0,319,51,28496
"Floris CDP, Virginia",4186,3961,225,7417,51,28528
"Floyd town, Virginia",283,274,9,570,51,28544
"Forest CDP, Virginia",5848,5578,270,11559,51,28688
"Fort Belvoir CDP, Virginia",1246,1174,72,7815,51,29008
"Fort Chiswell CDP, Virginia",421,421,0,680,51,29040
"Fort Hunt CDP, Virginia",7596,7466,130,16009,51,29136
"Fort Lee CDP, Virginia",1412,978,434,7577,51,29152
"Franconia CDP, Virginia",11414,11103,311,17906,51,29552
"Franklin city, Virginia",3641,3449,192,8194,51,29600
"Franklin Farm CDP, Virginia",10612,10347,265,18903,51,29628
"Franktown CDP, Virginia",0,0,0,0,51,29712
"Fredericksburg city, Virginia",15551,14745,806,28258,51,29744
"Free Union CDP, Virginia",31,31,0,185,51,29840
"Fries town, Virginia",116,106,10,364,51,29920
"Front Royal town, Virginia",7595,7027,568,15064,51,29968
"Gainesville CDP, Virginia",9412,9142,270,16972,51,30176
"Galax city, Virginia",2924,2796,128,6687,51,30208
"Gargatha CDP, Virginia",324,324,0,634,51,30384
"Gasburg CDP, Virginia",206,185,21,606,51,30480
"Gate City town, Virginia",758,741,17,1910,51,30496
"George Mason CDP, Virginia",4754,4190,564,10017,51,30618
"Glade Spring town, Virginia",867,846,21,2249,51,31056
"Glasgow town, Virginia",636,552,84,1376,51,31136
"Glen Allen CDP, Virginia",8761,8319,442,16246,51,31200
"Glen Lyn town, Virginia",30,30,0,78,51,31376
"Glenvar CDP, Virginia",221,207,14,932,51,31488
"Glen Wilton CDP, Virginia",88,88,0,216,51,31504
"Gloucester Courthouse CDP, Virginia",1240,1222,18,3513,51,31608
"Gloucester Point CDP, Virginia",5131,4901,230,11016,51,31616
"Goochland CDP, Virginia",473,449,24,953,51,31808
"Goose Creek Village CDP, Virginia",1355,1296,59,2332,51,31912
"Gordonsville town, Virginia",917,868,49,1946,51,31936
"Gore CDP, Virginia",10,10,0,36,51,31952
"Goshen town, Virginia",143,128,15,317,51,31968
"Gratton CDP, Virginia",512,512,0,1176,51,32320
"Great Falls CDP, Virginia",7294,7055,239,14968,51,32496
"Great Falls Crossing CDP, Virginia",967,918,49,1462,51,32498
"Greenbackville CDP, Virginia",28,28,0,43,51,32560
"Greenbriar CDP, Virginia",4176,4096,80,7945,51,32592
"Greenbush CDP, Virginia",44,44,0,149,51,32624
"Greenville CDP, Virginia",462,462,0,1224,51,32944
"Gretna town, Virginia",413,392,21,1227,51,33232
"Grottoes town, Virginia",1829,1756,73,2904,51,33488
"Groveton CDP, Virginia",8046,7447,599,14619,51,33584
"Grundy town, Virginia",236,236,0,777,51,33648
"Gwynn CDP, Virginia",293,293,0,639,51,33824
"Halifax town, Virginia",536,501,35,1320,51,34064
"Hallwood town, Virginia",76,74,2,172,51,34176
"Hamilton town, Virginia",382,372,10,674,51,34240
"Hampden-Sydney CDP, Virginia",721,713,8,1936,51,34304
"Hampton city, Virginia",66804,62438,4366,137217,51,35000
"Hanover CDP, Virginia",23,23,0,111,51,35160
"Harborton CDP, Virginia",0,0,0,0,51,35240
"Harrisonburg city, Virginia",26481,24694,1787,51784,51,35624
"Harriston CDP, Virginia",491,491,0,1033,51,35640
"Hayfield CDP, Virginia",2053,1979,74,4390,51,35912
"Haymarket town, Virginia",961,920,41,1572,51,35976
"Haysi town, Virginia",72,71,1,592,51,36008
"Heathsville CDP, Virginia",38,38,0,126,51,36216
"Henry Fork CDP, Virginia",388,388,0,897,51,36445
"Herndon town, Virginia",15152,14737,415,24456,51,36648
"Highland Springs CDP, Virginia",7798,7375,423,14881,51,37032
"Hillsboro town, Virginia",100,100,0,152,51,37288
"Hillsville town, Virginia",1285,1175,110,2856,51,37336
"Hilltown CDP, Virginia",80,47,33,91,51,37380
"Hiltons CDP, Virginia",81,81,0,385,51,37432
"Hiwassee CDP, Virginia",62,45,17,86,51,37544
"Hollins CDP, Virginia",7972,7732,240,16386,51,37880
"Hollymead CDP, Virginia",4462,4344,118,8740,51,38032
"Honaker town, Virginia",464,449,15,1213,51,38280
"Hopewell city, Virginia",10487,9568,919,23046,51,38424
"Horntown CDP, Virginia",87,87,0,453,51,38504
"Horse Pasture CDP, Virginia",792,758,34,2291,51,38552
"Hot Springs CDP, Virginia",255,252,3,455,51,38632
"Huntington CDP, Virginia",9367,9006,361,13913,51,39064
"Hurt town, Virginia",569,543,26,1378,51,39224
"Hutchison CDP, Virginia",4031,3915,116,6947,51,39259
"Hybla Valley CDP, Virginia",8605,8052,553,18104,51,39304
"Idylwood CDP, Virginia",10146,9907,239,17788,51,39448
"Independence town, Virginia",400,369,31,1176,51,39528
"Independent Hill CDP, Virginia",5458,5262,196,9858,51,39544
"Innovation CDP, Virginia",531,493,38,1389,51,39916
"Innsbrook CDP, Virginia",4750,4543,207,8699,51,39920
"Iron Gate town, Virginia",166,132,34,397,51,40024
"Irvington town, Virginia",264,260,4,519,51,40088
"Ivanhoe CDP, Virginia",272,251,21,608,51,40216
"Ivor town, Virginia",124,124,0,276,51,40232
"Ivy CDP, Virginia",469,366,103,682,51,40248
"Jarratt town, Virginia",573,552,21,935,51,40536
"Jewell Ridge CDP, Virginia",18,18,0,34,51,41016
"Jolivue CDP, Virginia",589,564,25,1083,51,41144
"Jonesville town, Virginia",355,278,77,1259,51,41272
"Keezletown CDP, Virginia",219,210,9,507,51,41624
"Keller town, Virginia",72,72,0,286,51,41656
"Kenbridge town, Virginia",443,420,23,1389,51,41832
"Keokee CDP, Virginia",98,98,0,327,51,42104
"Keswick CDP, Virginia",143,143,0,336,51,42216
"Keysville town, Virginia",323,316,7,760,51,42264
"Kilmarnock town, Virginia",444,419,25,1284,51,42424
"Kincora CDP, Virginia",215,215,0,317,51,42501
"King and Queen Court House CDP, Virginia",34,34,0,42,51,42536
"King George CDP, Virginia",2078,2005,73,4826,51,42568
"Kings Park CDP, Virginia",2289,2178,111,4003,51,42664
"Kings Park West CDP, Virginia",7588,7284,304,13254,51,42680
"Kingstowne CDP, Virginia",9798,9487,311,18228,51,42746
"King William CDP, Virginia",81,81,0,155,51,42792
"La Crosse town, Virginia",229,223,6,565,51,43176
"Lafayette CDP, Virginia",293,114,179,582,51,43224
"Lake Barcroft CDP, Virginia",6045,5728,317,10591,51,43352
"Lake Caroline CDP, Virginia",1473,1473,0,2652,51,43359
"Lake Holiday CDP, Virginia",1006,988,18,2233,51,43392
"Lake Land'Or CDP, Virginia",1687,1625,62,3179,51,43420
"Lake Monticello CDP, Virginia",5196,5114,82,10834,51,43424
"Lake of the Woods CDP, Virginia",3503,3347,156,8356,51,43430
"Lake Ridge CDP, Virginia",24278,23178,1100,44720,51,43432
"Lakeside CDP, Virginia",6757,6616,141,12124,51,43464
"Lake Wilderness CDP, Virginia",1779,1706,73,3122,51,43600
"Lancaster CDP, Virginia",0,0,0,22,51,43704
"Lansdowne CDP, Virginia",6700,6611,89,12840,51,44048
"Laurel CDP, Virginia",11154,10702,452,18480,51,44280
"Laurel Hill CDP, Virginia",4189,3962,227,7338,51,44430
"Laurel Park CDP, Virginia",421,421,0,1114,51,44476
"Lawrenceville town, Virginia",574,517,57,1199,51,44520
"Laymantown CDP, Virginia",795,795,0,1685,51,44620
"Lebanon town, Virginia",1209,1209,0,3139,51,44696
"Lee Mont CDP, Virginia",24,24,0,108,51,44952
"Leesburg town, Virginia",28244,27361,883,48465,51,44984
"Leesylvania CDP, Virginia",12477,11716,761,22114,51,45008
"Lexington city, Virginia",2879,2808,71,7346,51,45512
"Lincolnia CDP, Virginia",12347,11787,560,19812,51,45784
"Linton Hall CDP, Virginia",23171,22268,903,42702,51,45957
"Linville CDP, Virginia",122,122,0,277,51,45960
"Loch Lomond CDP, Virginia",2190,1971,219,3851,51,46328
"Locust Mount CDP, Virginia",97,97,0,97,51,46456
"Long Branch CDP, Virginia",3880,3759,121,7635,51,46760
"Lorton CDP, Virginia",11138,10589,549,22049,51,47064
"Loudoun Valley Estates CDP, Virginia",6251,6159,92,10514,51,47136
"Louisa town, Virginia",929,884,45,2173,51,47144
"Lovettsville town, Virginia",1324,1307,17,2666,51,47208
"Lovingston CDP, Virginia",153,153,0,382,51,47224
"Lowes Island CDP, Virginia",6720,6513,207,11265,51,47296
"Low Moor CDP, Virginia",173,173,0,389,51,47352
"Lunenburg CDP, Virginia",132,132,0,220,51,47496
"Luray town, Virginia",2402,2263,139,4838,51,47528
"Lynchburg city, Virginia",38645,36550,2095,79166,51,47672
"Lyndhurst CDP, Virginia",854,827,27,1750,51,47720
"McDowell CDP, Virginia",4,4,0,45,51,48184
"McGaheysville CDP, Virginia",649,643,6,1064,51,48232
"McKenney town, Virginia",255,193,62,559,51,48344
"McLean CDP, Virginia",24573,24053,520,49587,51,48376
"McMullin CDP, Virginia",148,148,0,240,51,48445
"McNair CDP, Virginia",14182,13665,517,22187,51,48450
"Madison town, Virginia",198,177,21,383,51,48488
"Madison Heights CDP, Virginia",5474,5197,277,10694,51,48520
"Makemie Park CDP, Virginia",109,92,17,142,51,48776
"Mallow CDP, Virginia",249,249,0,604,51,48856
"Manassas city, Virginia",23686,22899,787,42620,51,48952
"Manassas Park city, Virginia",10289,9964,325,17123,51,48968
"Manchester CDP, Virginia",7088,6537,551,11929,51,48996
"Mantua CDP, Virginia",3891,3710,181,7531,51,49144
"Mappsburg CDP, Virginia",8,8,0,27,51,49320
"Mappsville CDP, Virginia",353,353,0,445,51,49336
"Marion town, Virginia",2391,2269,122,5722,51,49464
"Marshall CDP, Virginia",1786,1743,43,3033,51,49656
"Martinsville city, Virginia",5801,5554,247,13539,51,49784
"Mason Neck CDP, Virginia",1029,979,50,1932,51,49998
"Massanetta Springs CDP, Virginia",3189,3080,109,6254,51,50020
"Massanutten CDP, Virginia",1321,1289,32,2368,51,50030
"Mathews CDP, Virginia",323,279,44,1094,51,50104
"Matoaca CDP, Virginia",1318,1318,0,2374,51,50136
"Maurertown CDP, Virginia",482,470,12,1019,51,50200
"Max Meadows CDP, Virginia",444,444,0,580,51,50312
"Meadowbrook CDP, Virginia",10006,9462,544,20047,51,50568
"Meadows of Dan CDP, Virginia",0,0,0,39,51,50696
"Meadowview CDP, Virginia",458,413,45,928,51,50760
"Mechanicsburg CDP, Virginia",0,0,0,13,51,50840
"Mechanicsville CDP, Virginia",20700,20291,409,38328,51,50856
"Melfa town, Virginia",194,185,9,436,51,50984
"Mendota CDP, Virginia",38,38,0,132,51,51096
"Merrifield CDP, Virginia",13517,13238,279,19923,51,51192
"Merrimac CDP, Virginia",1184,1117,67,2719,51,51208
"Metompkin CDP, Virginia",171,171,0,244,51,51362
"Middlebrook CDP, Virginia",0,0,0,45,51,51432
"Middleburg town, Virginia",331,308,23,643,51,51448
"Middletown town, Virginia",882,882,0,1558,51,51512
"Midland CDP, Virginia",117,117,0,167,51,51544
"Midlothian CDP, Virginia",9973,9689,284,19123,51,51560
"Millboro CDP, Virginia",52,52,0,124,51,51848
"Mineral town, Virginia",253,246,7,614,51,52120
"Modest Town CDP, Virginia",97,97,0,227,51,52408
"Moneta CDP, Virginia",188,160,28,378,51,52536
"Montclair CDP, Virginia",10719,10248,471,22083,51,52658
"Monterey town, Virginia",48,48,0,164,51,52680
"Montrose CDP, Virginia",4062,3886,176,8363,51,52904
"Montross town, Virginia",216,214,2,368,51,52952
"Montvale CDP, Virginia",226,203,23,424,51,52968
"Moorefield CDP, Virginia",3298,3222,76,5491,51,53030
"Motley CDP, Virginia",336,334,2,762,51,53480
"Mountain Road CDP, Virginia",441,441,0,1419,51,53584
"Mount Clifton CDP, Virginia",53,53,0,186,51,53832
"Mount Crawford town, Virginia",312,309,3,509,51,53864
"Mount Hermon CDP, Virginia",2601,2456,145,4434,51,53944
"Mount Jackson town, Virginia",897,801,96,1833,51,53992
"Mount Sidney CDP, Virginia",638,638,0,894,51,54120
"Mount Vernon CDP, Virginia",6871,6645,226,13299,51,54144
"Narrows town, Virginia",909,891,18,1990,51,54904
"Nassawadox town, Virginia",231,222,9,742,51,54984
"Nathalie CDP, Virginia",55,55,0,70,51,55000
"Navy CDP, Virginia",2063,2052,11,3638,51,55208
"Nellysford CDP, Virginia",436,436,0,1396,51,55400
"Nelsonia CDP, Virginia",177,166,11,314,51,55448
"New Baltimore CDP, Virginia",6135,6044,91,11743,51,55528
"New Castle town, Virginia",115,112,3,224,51,55592
"New Church CDP, Virginia",257,257,0,487,51,55608
"New Hope CDP, Virginia",592,592,0,927,51,55720
"Newington CDP, Virginia",7658,7403,255,13560,51,55752
"Newington Forest CDP, Virginia",7008,6591,417,12647,51,55758
"New Kent CDP, Virginia",518,518,0,796,51,55800
"New Market town, Virginia",1000,981,19,2162,51,55848
"Newport News city, Virginia",89920,84879,5041,185118,51,56000
"New River CDP, Virginia",335,321,14,387,51,56048
"Newsoms town, Virginia",177,168,9,325,51,56096
"Nickelsville town, Virginia",93,82,11,360,51,56304
"Nokesville CDP, Virginia",894,857,37,1452,51,56464
"Norfolk city, Virginia",109986,102606,7380,236973,51,57000
"North Garden CDP, Virginia",209,203,6,374,51,57368
"North Shore CDP, Virginia",1344,1292,52,3588,51,57531
"North Springfield CDP, Virginia",3669,3541,128,6916,51,57560
"Norton city, Virginia",1624,1505,119,3668,51,57688
"Nottoway Court House CDP, Virginia",40,14,26,103,51,57870
"Oak Grove CDP, Virginia",1590,1575,15,2533,51,58104
"Oak Hall CDP, Virginia",45,20,25,45,51,58184
"Oak Level CDP, Virginia",179,179,0,453,51,58312
"Oakton CDP, Virginia",20629,19958,671,36529,51,58472
"Occoquan town, Virginia",811,770,41,1072,51,58696
"Onancock town, Virginia",590,533,57,1434,51,59336
"One Loudoun CDP, Virginia",1607,1597,10,2779,51,59364
"Onley town, Virginia",354,344,10,656,51,59384
"Opal CDP, Virginia",512,506,6,756,51,59416
"Orange town, Virginia",2191,2043,148,4919,51,59496
"Osaka CDP, Virginia",26,22,4,102,51,59752
"Painter town, Virginia",94,93,1,244,51,60296
"Palmyra CDP, Virginia",125,125,0,125,51,60392
"Pamplin City town, Virginia",39,29,10,70,51,60488
"Pantops CDP, Virginia",2301,2229,72,4189,51,60512
"Paris CDP, Virginia",22,22,0,60,51,60536
"Parksley town, Virginia",375,365,10,764,51,60680
"Parrott CDP, Virginia",66,32,34,350,51,60840
"Passapatanzy CDP, Virginia",692,646,46,1284,51,60888
"Pastoria CDP, Virginia",405,405,0,761,51,60920
"Patrick Springs CDP, Virginia",819,805,14,2204,51,60984
"Pearisburg town, Virginia",1300,1223,77,2876,51,61208
"Pembroke town, Virginia",560,556,4,1005,51,61336
"Penhook CDP, Virginia",539,534,5,1390,51,61464
"Pennington Gap town, Virginia",631,497,134,2254,51,61560
"Petersburg city, Virginia",16205,14367,1838,33261,51,61832
"Phenix town, Virginia",158,151,7,437,51,61896
"Pimmit Hills CDP, Virginia",3564,3445,119,6500,51,62264
"Piney Mountain CDP, Virginia",1197,1197,0,2415,51,62738
"Plum Creek CDP, Virginia",580,507,73,1047,51,63190
"Pocahontas town, Virginia",53,48,5,163,51,63288
"Poquoson city, Virginia",6331,6241,90,12479,51,63768
"Port Republic CDP, Virginia",164,164,0,343,51,63896
"Port Royal town, Virginia",87,87,0,139,51,63928
"Portsmouth city, Virginia",44735,41764,2971,97384,51,64000
"Potomac Mills CDP, Virginia",3192,3072,120,6510,51,64152
"Pound town, Virginia",310,244,66,933,51,64272
"Pounding Mill CDP, Virginia",146,125,21,314,51,64288
"Powhatan CDP, Virginia",222,222,0,473,51,64384
"Prices Fork CDP, Virginia",569,538,31,1014,51,64512
"Prince George CDP, Virginia",990,990,0,1964,51,64560
"Pulaski town, Virginia",4164,3994,170,8982,51,64880
"Pungoteague CDP, Virginia",80,80,0,195,51,64976
"Purcellville town, Virginia",4910,4810,100,8928,51,65008
"Quantico town, Virginia",355,339,16,543,51,65120
"Quantico Base CDP, Virginia",820,751,69,5372,51,65128
"Quinby CDP, Virginia",109,109,0,298,51,65280
"Radford city, Virginia",8552,7936,616,16379,51,65392
"Raven CDP, Virginia",656,576,80,2065,51,65744
"Ravensworth CDP, Virginia",1512,1443,69,2661,51,65776
"Rectortown CDP, Virginia",13,13,0,59,51,66032
"Remington town, Virginia",448,427,21,836,51,66512
"Reston CDP, Virginia",38073,36426,1647,62339,51,66672
"Rich Creek town, Virginia",272,262,10,707,51,66896
"Richlands town, Virginia",2011,1839,172,5266,51,66928
"Richmond city, Virginia",129681,121796,7885,227171,51,67000
"Ridgeway town, Virginia",398,393,5,1095,51,67208
"Riner CDP, Virginia",434,434,0,953,51,67256
"Rio CDP, Virginia",676,638,38,969,51,67288
"Ripplemead CDP, Virginia",205,205,0,275,51,67304
"Rivanna CDP, Virginia",671,633,38,2088,51,67331
"Riverdale CDP, Virginia",302,302,0,1046,51,67352
"Riverview CDP, Virginia",86,72,14,479,51,67704
"Roanoke city, Virginia",50305,46998,3307,99213,51,68000
"Rockwood CDP, Virginia",4116,3931,185,8076,51,68470
"Rocky Gap CDP, Virginia",0,0,0,0,51,68480
"Rocky Mount town, Virginia",2133,2028,105,4916,51,68496
"Rose Hill CDP (Fairfax County), Virginia",11246,10910,336,21203,51,68880
"Rose Hill CDP (Lee County), Virginia",233,233,0,588,51,68885
"Round Hill town, Virginia",424,410,14,668,51,69168
"Ruckersville CDP, Virginia",733,708,25,1275,51,69360
"Rural Retreat town, Virginia",744,728,16,1531,51,69456
"Rushmere CDP, Virginia",425,396,29,896,51,69472
"Rustburg CDP, Virginia",804,725,79,1610,51,69536
"St. Charles town, Virginia",9,7,2,64,51,69792
"St. Paul town, Virginia",396,315,81,1129,51,69936
"Salem city, Virginia",12941,12483,458,25372,51,70000
"Saltville town, Virginia",857,795,62,2085,51,70096
"Saluda CDP, Virginia",349,349,0,650,51,70112
"Sandston CDP, Virginia",4403,4127,276,7152,51,70256
"Sandy Level CDP, Virginia",208,208,0,621,51,70296
"Sanford CDP, Virginia",0,0,0,36,51,70352
"Savage Town CDP, Virginia",115,115,0,247,51,70520
"Savageville CDP, Virginia",377,377,0,574,51,70528
"Saxis town, Virginia",99,99,0,256,51,70576
"Schooner Bay CDP, Virginia",0,0,0,47,51,70680
"Schuyler CDP, Virginia",162,162,0,323,51,70704
"Scotland CDP, Virginia",48,48,0,123,51,70715
"Scottsburg town, Virginia",63,58,5,124,51,70752
"Scottsville town, Virginia",283,280,3,571,51,70800
"Sedley CDP, Virginia",388,357,31,687,51,71040
"Selma CDP, Virginia",156,156,0,455,51,71072
"Seven Corners CDP, Virginia",4727,4336,391,9141,51,71216
"Seven Mile Ford CDP, Virginia",253,242,11,697,51,71264
"Shawneeland CDP, Virginia",1143,1103,40,2347,51,71625
"Shawsville CDP, Virginia",915,883,32,1529,51,71632
"Shenandoah town, Virginia",1395,1346,49,3020,51,71776
"Shenandoah Farms CDP, Virginia",1645,1540,105,3926,51,71810
"Shenandoah Retreat CDP, Virginia",360,358,2,622,51,71825
"Shenandoah Shores CDP, Virginia",392,350,42,753,51,71826
"Sherando CDP, Virginia",126,126,0,246,51,71904
"Shipman CDP, Virginia",170,153,17,439,51,72080
"Short Pump CDP, Virginia",15412,15131,281,28400,51,72272
"Singers Glen CDP, Virginia",68,68,0,155,51,72736
"Skyland Estates CDP, Virginia",473,473,0,791,51,72935
"Smithfield town, Virginia",4277,4075,202,8625,51,73200
"Snowville CDP, Virginia",27,27,0,79,51,73376
"Southampton Meadows CDP, Virginia",133,47,86,479,51,73624
"South Boston town, Virginia",3025,2896,129,7942,51,73712
"Southern Gateway CDP, Virginia",1745,1672,73,2551,51,73760
"South Hill town, Virginia",2278,2175,103,4683,51,73904
"South Riding CDP, Virginia",19246,18422,824,33358,51,74100
"South Run CDP, Virginia",3164,3058,106,6940,51,74120
"Southside Chesconessex CDP, Virginia",0,0,0,55,51,74160
"Sperryville CDP, Virginia",130,130,0,327,51,74384
"Spotsylvania Courthouse CDP, Virginia",3135,2740,395,6610,51,74470
"Springfield CDP, Virginia",16047,15046,1001,31022,51,74592
"Springville CDP, Virginia",543,537,6,1017,51,74848
"Stafford Courthouse CDP, Virginia",2127,2090,37,4996,51,74916
"Stanardsville town, Virginia",245,229,16,492,51,75008
"Stanley town, Virginia",1006,947,59,1811,51,75024
"Stanleytown CDP, Virginia",408,380,28,1463,51,75040
"Staunton city, Virginia",13026,12367,659,25581,51,75216
"Stephens City town, Virginia",1263,1220,43,2107,51,75344
"Sterling CDP, Virginia",18329,17408,921,31058,51,75376
"Stevens Creek CDP, Virginia",35,35,0,107,51,75440
"Stewartsville CDP, Virginia",350,337,13,514,51,75504
"Stickleyville CDP, Virginia",69,58,11,209,51,75536
"Stonega CDP, Virginia",13,13,0,150,51,75680
"Stone Ridge CDP, Virginia",8880,8780,100,16049,51,75702
"Stony Creek town, Virginia",137,115,22,350,51,75840
"Strasburg town, Virginia",3406,3273,133,7104,51,76000
"Stuart town, Virginia",464,424,40,1533,51,76256
"Stuarts Draft CDP, Virginia",6149,5938,211,11554,51,76272
"Sudley CDP, Virginia",10329,9917,412,19289,51,76416
"Suffolk city, Virginia",47345,44358,2987,94856,51,76432
"Sugar Grove CDP, Virginia",326,294,32,723,51,76448
"Sugarland Run CDP, Virginia",7508,7170,338,12818,51,76464
"Sully Square CDP, Virginia",1341,1341,0,2560,51,76516
"Surry town, Virginia",111,109,2,222,51,76880
"Sussex CDP, Virginia",111,108,3,145,51,76912
"Tacoma CDP, Virginia",0,0,0,154,51,77408
"Tangier town, Virginia",197,186,11,345,51,77520
"Tappahannock town, Virginia",760,717,43,1919,51,77568
"Tasley CDP, Virginia",48,48,0,89,51,77648
"Tazewell town, Virginia",1700,1685,15,4456,51,77792
"Temperanceville CDP, Virginia",125,125,0,262,51,77856
"Templeton CDP, Virginia",61,61,0,119,51,77925
"The Plains town, Virginia",150,149,1,273,51,78192
"The University of Virginia's College at Wise CDP, Virginia",361,359,2,650,51,78264
"Thynedale CDP, Virginia",25,25,0,53,51,78532
"Timberlake CDP, Virginia",7417,7095,322,12999,51,78688
"Timberville town, Virginia",1529,1484,45,2966,51,78736
"Toms Brook town, Virginia",205,198,7,363,51,79024
"Triangle CDP, Virginia",5664,5134,530,10886,51,79360
"Troutdale town, Virginia",73,73,0,185,51,79456
"Troutville town, Virginia",218,215,3,467,51,79472
"Tuckahoe CDP, Virginia",24930,23797,1133,48049,51,79560
"Twin Lakes CDP, Virginia",746,746,0,1374,51,79768
"Tysons CDP, Virginia",17797,16900,897,27617,51,79950
"Union Hall CDP, Virginia",444,436,8,1071,51,80000
"Union Level CDP, Virginia",41,41,0,73,51,80016
"Union Mill CDP, Virginia",2200,2191,9,4302,51,80029
"University Center CDP, Virginia",2588,2461,127,4223,51,80120
"University of Virginia CDP, Virginia",3143,2909,234,9648,51,80165
"Upperville CDP, Virginia",41,41,0,55,51,80224
"Urbanna town, Virginia",208,208,0,437,51,80272
"Vansant CDP, Virginia",101,101,0,229,51,80608
"Verona CDP, Virginia",2012,1959,53,4582,51,80864
"Victoria town, Virginia",667,635,32,1946,51,81024
"Vienna town, Virginia",8556,8246,310,16401,51,81072
"Villa Heights CDP, Virginia",130,130,0,540,51,81152
"Vinton town, Virginia",4276,4192,84,8045,51,81280
"Virgilina town, Virginia",69,69,0,157,51,81312
"Virginia Beach city, Virginia",234294,224334,9960,457900,51,82000
"Wachapreague town, Virginia",100,98,2,270,51,82320
"Wakefield CDP, Virginia",5745,5583,162,11621,51,82371
"Wakefield town, Virginia",773,740,33,1286,51,82384
"Warfield CDP, Virginia",0,0,0,46,51,83056
"Warm Springs CDP, Virginia",0,0,0,0,51,83088
"Warrenton town, Virginia",5238,5130,108,10111,51,83136
"Warsaw town, Virginia",787,750,37,2330,51,83168
"Washington town, Virginia",34,34,0,54,51,83248
"Waterford CDP, Virginia",75,75,0,248,51,83440
"Wattsville CDP, Virginia",677,654,23,1480,51,83568
"Waverly town, Virginia",1352,1223,129,2890,51,83600
"Waynesboro city, Virginia",11436,10895,541,22341,51,83680
"Weber City town, Virginia",695,663,32,1591,51,83808
"Weems CDP, Virginia",79,79,0,235,51,83888
"West Falls Church CDP, Virginia",18351,17304,1047,31121,51,84368
"Westlake Corner CDP, Virginia",780,780,0,1815,51,84632
"West Point town, Virginia",1832,1785,47,3396,51,84960
"West Springfield CDP, Virginia",12492,12156,336,23372,51,84976
"Weyers Cave CDP, Virginia",1287,1287,0,2212,51,85184
"White Stone town, Virginia",173,159,14,311,51,85600
"Whitesville CDP, Virginia",9,9,0,60,51,85608
"Williamsburg city, Virginia",6828,6417,411,15486,51,86160
"Willis Wharf CDP, Virginia",83,67,16,90,51,86336
"Winchester city, Virginia",15318,14519,799,28103,51,86720
"Windsor town, Virginia",1241,1181,60,2765,51,86784
"Wintergreen CDP, Virginia",258,258,0,413,51,87008
"Wise town, Virginia",1276,1222,54,2962,51,87072
"Wolf Trap CDP, Virginia",7715,7529,186,15712,51,87240
"Woodbridge CDP, Virginia",25018,23169,1849,42619,51,87312
"Woodburn CDP, Virginia",4943,4796,147,9960,51,87333
"Woodlake CDP, Virginia",4336,4108,228,7566,51,87380
"Woodlawn CDP (Carroll County), Virginia",1076,1020,56,2264,51,87408
"Woodlawn CDP (Fairfax County), Virginia",13497,12775,722,22966,51,87410
"Woodstock town, Virginia",2569,2435,134,5798,51,87712
"Wyndham CDP, Virginia",6556,6356,200,12110,51,87960
"Wytheville town, Virginia",3551,3359,192,8228,51,88000
"Yogaville CDP, Virginia",65,65,0,144,51,88145
"Yorkshire CDP, Virginia",5691,5496,195,10563,51,88176
"Yorktown CDP, Virginia",151,151,0,217,51,88240
"Aberdeen city, Washington",7173,6718,455,16969,53,00100
"Aberdeen Gardens CDP, Washington",102,102,0,273,53,00135
"Acme CDP, Washington",113,113,0,113,53,00275
"Addy CDP, Washington",6,6,0,30,53,00380
"Ahtanum CDP, Washington",1574,1436,138,3353,53,00800
"Airway Heights city, Washington",3698,3342,356,10570,53,00905
"Albion town, Washington",297,274,23,509,53,01010
"Alder CDP, Washington",44,44,0,124,53,01045
"Alderton CDP, Washington",1531,1392,139,2686,53,01150
"Alderwood Manor CDP, Washington",5765,5491,274,10525,53,01185
"Alger CDP, Washington",170,164,6,364,53,01255
"Algona city, Washington",1751,1599,152,3264,53,01290
"Allyn CDP, Washington",1019,931,88,2249,53,01430
"Almira town, Washington",107,96,11,363,53,01500
"Altoona CDP, Washington",21,16,5,53,53,01745
"Amanda Park CDP, Washington",44,24,20,71,53,01780
"Amboy CDP, Washington",794,761,33,1680,53,01850
"Ames Lake CDP, Washington",610,584,26,1108,53,01920
"Anacortes city, Washington",7433,7118,315,17667,53,01990
"Anatone CDP, Washington",9,9,0,9,53,02025
"Anderson Island CDP, Washington",575,575,0,1621,53,02060
"Arlington city, Washington",10708,10297,411,20263,53,02585
"Arlington Heights CDP, Washington",1380,1340,40,3122,53,02620
"Artondale CDP, Washington",6539,6382,157,13862,53,02910
"Ashford CDP, Washington",332,332,0,675,53,03005
"Asotin city, Washington",574,553,21,1192,53,03075
"Auburn city, Washington",46081,43916,2165,85623,53,03180
"Bainbridge Island city, Washington",11708,11364,344,24681,53,03736
"Bangor Base CDP, Washington",535,517,18,6045,53,04100
"Banks Lake South CDP, Washington",78,75,3,197,53,04125
"Barberton CDP, Washington",4020,3833,187,7945,53,04195
"Baring CDP, Washington",122,110,12,206,53,04300
"Barney's Junction CDP, Washington",0,0,0,26,53,04347
"Barstow CDP, Washington",12,12,0,54,53,04370
"Basin City CDP, Washington",640,640,0,1570,53,04405
"Battle Ground city, Washington",10364,9916,448,20888,53,04475
"Bay Center CDP, Washington",76,69,7,180,53,04615
"Bay View CDP, Washington",320,320,0,635,53,04790
"Beacon Hill CDP, Washington",953,953,0,2122,53,04825
"Beaux Arts Village town, Washington",146,138,8,258,53,04895
"Belfair CDP, Washington",1907,1814,93,4175,53,05140
"Bellevue city, Washington",82665,79351,3314,150606,53,05210
"Bell Hill CDP, Washington",130,100,30,900,53,05245
"Bellingham city, Washington",52255,49728,2527,91353,53,05280
"Benton City city, Washington",1283,1215,68,3498,53,05560
"Bethel CDP, Washington",2054,1782,272,4220,53,05735
"Beverly CDP, Washington",185,185,0,308,53,05770
"Bickleton CDP, Washington",32,32,0,78,53,05980
"Big Lake CDP, Washington",857,839,18,2267,53,06050
"Bingen city, Washington",518,495,23,933,53,06085
"Birch Bay CDP, Washington",4684,4438,246,11142,53,06190
"Black Diamond city, Washington",3007,2981,26,5314,53,06330
"Blaine city, Washington",2554,2305,249,5865,53,06505
"Blyn CDP, Washington",61,61,0,173,53,06855
"Bonney Lake city, Washington",12081,11744,337,22590,53,07170
"Bothell city, Washington",26984,25934,1050,47917,53,07380
"Bothell East CDP, Washington",7540,7263,277,13948,53,07390
"Bothell West CDP, Washington",11802,11429,373,20530,53,07395
"Boulevard Park CDP, Washington",2145,2056,89,4411,53,07397
"Bow CDP, Washington",303,303,0,357,53,07450
"Boyds CDP, Washington",0,0,0,34,53,07485
"Brady CDP, Washington",275,266,9,962,53,07590
"Bremerton city, Washington",20358,19248,1110,43983,53,07695
"Brewster city, Washington",885,853,32,2241,53,07835
"Bridgeport city, Washington",1120,1050,70,2416,53,07870
"Brier city, Washington",3468,3296,172,6539,53,07940
"Brinnon CDP, Washington",255,232,23,874,53,08080
"Browns Point CDP, Washington",484,458,26,1097,53,08325
"Brush Prairie CDP, Washington",1361,1308,53,2623,53,08465
"Bryant CDP, Washington",1465,1465,0,2486,53,08500
"Bryn Mawr-Skyway CDP, Washington",9607,8875,732,18032,53,08552
"Buckley city, Washington",2570,2497,73,5191,53,08570
"Bucoda town, Washington",233,209,24,564,53,08605
"Buena CDP, Washington",178,178,0,543,53,08640
"Bunk Foss CDP, Washington",1892,1774,118,3639,53,08770
"Burbank CDP, Washington",1519,1353,166,3383,53,08780
"Burien city, Washington",28664,27277,1387,51505,53,08850
"Burley CDP, Washington",1107,1107,0,2808,53,08885
"Burlington city, Washington",4877,4612,265,9361,53,08920
"Camano CDP, Washington",7959,7578,381,17642,53,09365
"Camas city, Washington",12913,12601,312,26387,53,09480
"Canterwood CDP, Washington",1187,1140,47,2991,53,09810
"Canyon Creek CDP, Washington",1806,1698,108,3548,53,09820
"Carbonado town, Washington",278,278,0,550,53,09970
"Carlsborg CDP, Washington",302,302,0,932,53,10075
"Carnation city, Washington",1454,1405,49,2515,53,10215
"Carson CDP, Washington",1026,962,64,2349,53,10320
"Cascade Valley CDP, Washington",2212,1929,283,3457,53,10455
"Cashmere city, Washington",1474,1458,16,3244,53,10495
"Castle Rock city, Washington",959,892,67,2624,53,10565
"Cathcart CDP, Washington",1057,1046,11,2105,53,10600
"Cathlamet town, Washington",182,178,4,546,53,10635
"Cavalero CDP, Washington",745,745,0,1457,53,10645
"Centerville CDP, Washington",83,67,16,113,53,11090
"Centralia city, Washington",7974,7464,510,18234,53,11160
"Central Park CDP, Washington",1831,1819,12,3416,53,11195
"Chain Lake CDP, Washington",2765,2628,137,5122,53,11325
"Chehalis city, Washington",3510,3165,345,7512,53,11475
"Chelan city, Washington",2137,2066,71,4269,53,11615
"Chelan Falls CDP, Washington",61,61,0,106,53,11685
"Cheney city, Washington",7349,6394,955,12848,53,11825
"Cherry Grove CDP, Washington",209,209,0,456,53,12015
"Chewelah city, Washington",1066,985,81,2508,53,12140
"Chico CDP, Washington",1395,1344,51,3076,53,12175
"Chinook CDP, Washington",235,235,0,447,53,12315
"Clallam Bay CDP, Washington",447,447,0,734,53,12525
"Clarkston city, Washington",3638,3279,359,7222,53,12630
"Clarkston Heights-Vineland CDP, Washington",3106,2985,121,6784,53,12680
"Clayton CDP, Washington",75,75,0,127,53,12735
"Clear Lake CDP (Pierce County), Washington",585,550,35,1157,53,12820
"Clear Lake CDP (Skagit County), Washington",463,456,7,1121,53,12840
"Clearview CDP, Washington",2024,1982,42,3763,53,12875
"Cle Elum city, Washington",1086,1062,24,2116,53,12945
"Cliffdell CDP, Washington",36,35,1,61,53,13015
"Clinton CDP, Washington",476,441,35,1165,53,13155
"Clover Creek CDP, Washington",4308,4003,305,7354,53,13215
"Clyde Hill city, Washington",1403,1358,45,3108,53,13365
"Cohassett Beach CDP, Washington",174,174,0,291,53,13595
"Colfax city, Washington",1342,1293,49,2799,53,13785
"College Place city, Washington",4659,4400,259,9796,53,13855
"Colton town, Washington",164,159,5,340,53,13890
"Colville city, Washington",2008,1942,66,4927,53,14170
"Conconully town, Washington",80,67,13,199,53,14310
"Concrete town, Washington",318,306,12,792,53,14380
"Connell city, Washington",1619,1433,186,5175,53,14485
"Conway CDP, Washington",45,45,0,45,53,14520
"Copalis Beach CDP, Washington",88,88,0,293,53,14660
"Cosmopolis city, Washington",985,884,101,2255,53,14870
"Cottage Lake CDP, Washington",11230,10824,406,23233,53,14940
"Cougar CDP, Washington",11,11,0,33,53,15010
"Coulee City town, Washington",170,156,14,503,53,15080
"Coulee Dam town, Washington",632,594,38,1334,53,15115
"Country Homes CDP, Washington",2751,2485,266,6248,53,15150
"Coupeville town, Washington",750,741,9,2040,53,15185
"Covington city, Washington",11592,11195,397,20814,53,15290
"Cowiche CDP, Washington",202,202,0,445,53,15325
"Crescent Bar CDP, Washington",83,82,1,225,53,15603
"Creston town, Washington",74,74,0,213,53,15710
"Crocker CDP, Washington",503,492,11,1218,53,15780
"Curlew CDP, Washington",49,49,0,108,53,16165
"Curlew Lake CDP, Washington",234,234,0,585,53,16170
"Cusick town, Washington",61,55,6,185,53,16340
"Custer CDP, Washington",218,183,35,301,53,16375
"Dallesport CDP, Washington",618,531,87,1426,53,16550
"Danville CDP, Washington",23,23,0,82,53,16585
"Darrington town, Washington",500,431,69,1233,53,16690
"Dash Point CDP, Washington",442,423,19,923,53,16760
"Davenport city, Washington",772,729,43,1850,53,16795
"Dayton city, Washington",1334,1277,57,2763,53,16970
"Deep River CDP, Washington",38,38,0,159,53,17215
"Deer Park city, Washington",1777,1539,238,4482,53,17320
"Deming CDP, Washington",181,128,53,427,53,17495
"Desert Aire CDP, Washington",1278,1278,0,2714,53,17617
"Des Moines city, Washington",16716,15341,1375,32667,53,17635
"Disautel CDP, Washington",9,9,0,18,53,17880
"Dixie CDP, Washington",67,67,0,156,53,18055
"Dollars Corner CDP, Washington",521,517,4,824,53,18198
"Donald CDP, Washington",97,97,0,126,53,18265
"Duluth CDP, Washington",827,827,0,1725,53,18775
"DuPont city, Washington",3842,3660,182,9955,53,18965
"Duvall city, Washington",4242,4061,181,8128,53,19035
"East Cathlamet CDP, Washington",149,145,4,620,53,19290
"Eastmont CDP, Washington",11698,11013,685,23173,53,19630
"Easton CDP, Washington",178,148,30,328,53,19700
"East Port Orchard CDP, Washington",2848,2669,179,5501,53,19770
"East Renton Highlands CDP, Washington",5699,5572,127,12079,53,19857
"East Wenatchee city, Washington",7200,6889,311,14065,53,20155
"Eatonville town, Washington",1451,1378,73,2845,53,20260
"Edgewood city, Washington",6824,6764,60,12397,53,20645
"Edison CDP, Washington",23,23,0,200,53,20680
"Edmonds city, Washington",23273,22329,944,42705,53,20750
"Elbe CDP, Washington",0,0,0,0,53,20890
"Electric City city, Washington",241,241,0,732,53,21030
"Elk Plain CDP, Washington",7574,7254,320,14224,53,21205
"Ellensburg city, Washington",11048,10053,995,19003,53,21240
"Elma city, Washington",1502,1410,92,3426,53,21450
"Elmer City town, Washington",95,90,5,276,53,21485
"Endicott town, Washington",130,124,6,378,53,21730
"Enetai CDP, Washington",819,736,83,1869,53,21800
"Entiat city, Washington",600,567,33,1038,53,22010
"Enumclaw city, Washington",6947,6657,290,12630,53,22045
"Ephrata city, Washington",3511,3345,166,8419,53,22080
"Erlands Point CDP, Washington",292,285,7,803,53,22115
"Eschbach CDP, Washington",149,130,19,209,53,22150
"Esperance CDP, Washington",2316,2247,69,4268,53,22255
"Everett city, Washington",59831,56364,3467,110847,53,22640
"Everson city, Washington",1394,1358,36,2960,53,22745
"Fairchild AFB CDP, Washington",487,468,19,3184,53,22955
"Fairfield town, Washington",239,239,0,614,53,22990
"Fairwood CDP (King County), Washington",9794,9243,551,18612,53,23160
"Fairwood CDP (Spokane County), Washington",4150,3993,157,10228,53,23165
"Fall City CDP, Washington",1016,983,33,2018,53,23200
"Farmington town, Washington",60,56,4,144,53,23340
"Federal Way city, Washington",52078,49190,2888,99614,53,23515
"Felida CDP, Washington",5655,5356,299,10520,53,23550
"Ferndale city, Washington",7277,7036,241,15130,53,23620
"Fern Prairie CDP, Washington",750,720,30,1946,53,23690
"Fife city, Washington",6163,5928,235,10887,53,23795
"Fife Heights CDP, Washington",925,888,37,1573,53,23830
"Finley CDP, Washington",3009,2763,246,5848,53,23865
"Fircrest city, Washington",3953,3633,320,7098,53,23970
"Five Corners CDP, Washington",11266,10693,573,20916,53,24188
"Fobes Hill CDP, Washington",1580,1514,66,2957,53,24425
"Fords Prairie CDP, Washington",1376,1320,56,2842,53,24565
"Forks city, Washington",1666,1532,134,3380,53,24810
"Fort Lewis CDP, Washington",2018,1965,53,13440,53,24915
"Four Lakes CDP, Washington",264,247,17,564,53,25300
"Fox Island CDP, Washington",1601,1527,74,3644,53,25370
"Frederickson CDP, Washington",11360,10755,605,24741,53,25475
"Freeland CDP, Washington",798,720,78,1894,53,25510
"Friday Harbor town, Washington",1473,1433,40,2647,53,25615
"Garfield town, Washington",255,246,9,586,53,26140
"Garrett CDP, Washington",886,821,65,1873,53,26245
"Geneva CDP, Washington",1204,1070,134,2096,53,26420
"George city, Washington",418,379,39,892,53,26455
"Gig Harbor city, Washington",5402,5305,97,11917,53,26735
"Glacier CDP, Washington",219,219,0,241,53,26875
"Gleed CDP, Washington",1554,1471,83,3231,53,26945
"Glenwood CDP, Washington",115,113,2,220,53,27225
"Gold Bar city, Washington",1221,1156,65,2338,53,27365
"Goldendale city, Washington",1464,1190,274,3448,53,27435
"Gorst CDP, Washington",255,229,26,495,53,27680
"Graham CDP, Washington",17077,16087,990,34778,53,27785
"Grand Coulee city, Washington",417,364,53,1034,53,27855
"Grand Mound CDP, Washington",1578,1497,81,3442,53,27890
"Grandview city, Washington",5107,4887,220,10922,53,27925
"Granger city, Washington",1646,1371,275,3632,53,27960
"Granite Falls city, Washington",2087,2067,20,4567,53,27995
"Grapeview CDP, Washington",550,550,0,1128,53,28135
"Grayland CDP, Washington",196,145,51,575,53,28345
"Grays River CDP, Washington",175,175,0,257,53,28450
"Green Bluff CDP, Washington",106,106,0,219,53,28590
"Greenwater CDP, Washington",70,70,0,97,53,28695
"Hamilton town, Washington",155,142,13,376,53,29255
"Hansville CDP, Washington",1029,1020,9,3246,53,29430
"Harrah town, Washington",346,306,40,640,53,29710
"Harrington city, Washington",168,152,16,450,53,29745
"Hartline town, Washington",105,105,0,202,53,29920
"Hat Island CDP, Washington",0,0,0,21,53,30030
"Hatton town, Washington",248,248,0,492,53,30060
"Hazel Dell CDP, Washington",12470,11513,957,22714,53,30305
"Herron Island CDP, Washington",0,0,0,122,53,30690
"High Bridge CDP, Washington",1502,1453,49,2871,53,30750
"Hobart CDP, Washington",3657,3532,125,7155,53,31495
"Hockinson CDP, Washington",2611,2555,56,5833,53,31530
"Hogans Corner CDP, Washington",0,0,0,8,53,31540
"Home CDP, Washington",699,699,0,1692,53,31985
"Hoodsport CDP, Washington",37,37,0,162,53,32125
"Hoquiam city, Washington",3837,3455,382,8742,53,32300
"Humptulips CDP, Washington",78,73,5,245,53,32650
"Hunts Point town, Washington",123,122,1,323,53,32755
"Ilwaco city, Washington",726,722,4,1433,53,33000
"Inchelium CDP, Washington",179,156,23,338,53,33105
"Index town, Washington",52,52,0,132,53,33175
"Indianola CDP, Washington",1810,1724,86,3553,53,33280
"Ione town, Washington",139,118,21,342,53,33560
"Issaquah city, Washington",23393,22638,755,39400,53,33805
"Jamestown CDP, Washington",115,102,13,326,53,33890
"Kahlotus city, Washington",71,59,12,134,53,34575
"Kalama city, Washington",1304,1283,21,2952,53,34645
"Kapowsin CDP, Washington",362,362,0,378,53,34890
"Kayak Point CDP, Washington",886,845,41,1661,53,34915
"Keller CDP, Washington",106,100,6,256,53,34960
"Kelso city, Washington",5970,5610,360,12661,53,35065
"Kendall CDP, Washington",502,395,107,959,53,35135
"Kenmore city, Washington",13328,12833,495,23611,53,35170
"Kennewick city, Washington",39332,37572,1760,83823,53,35275
"Kent city, Washington",73044,67515,5529,135169,53,35415
"Ketron Island CDP, Washington",0,0,0,0,53,35450
"Kettle Falls city, Washington",679,637,42,1598,53,35485
"Key Center CDP, Washington",1541,1450,91,3359,53,35555
"Keyport CDP, Washington",137,137,0,284,53,35625
"Kingston CDP, Washington",1648,1573,75,2999,53,35870
"Kirkland city, Washington",53189,50694,2495,92015,53,35940
"Kitsap Lake CDP, Washington",1093,1065,28,2054,53,36010
"Kittitas city, Washington",610,586,24,1281,53,36045
"Klickitat CDP, Washington",144,126,18,335,53,36115
"Krupp town, Washington",27,27,0,39,53,36395
"La Center city, Washington",1820,1744,76,3685,53,36710
"Lacey city, Washington",26096,24680,1416,56263,53,36745
"La Conner town, Washington",454,452,2,1000,53,36780
"LaCrosse town, Washington",176,176,0,417,53,36850
"La Grande CDP, Washington",132,132,0,219,53,36920
"Lake Bosworth CDP, Washington",584,552,32,1059,53,37077
"Lake Cassidy CDP, Washington",1255,1233,22,2782,53,37100
"Lake Cavanaugh CDP, Washington",54,54,0,341,53,37105
"Lake Forest Park city, Washington",7706,7484,222,13462,53,37270
"Lake Goodwin CDP, Washington",3050,2938,112,5581,53,37287
"Lake Holm CDP, Washington",2152,2132,20,3653,53,37345
"Lake Ketchum CDP, Washington",584,584,0,1402,53,37415
"Lakeland North CDP, Washington",7756,7357,399,14960,53,37420
"Lakeland South CDP, Washington",6790,6369,421,12606,53,37430
"Lake McMurray CDP, Washington",176,176,0,473,53,37526
"Lake Marcel-Stillwater CDP, Washington",793,793,0,1396,53,37538
"Lake Morton-Berrydale CDP, Washington",5425,5264,161,10457,53,37567
"Lake Roesiger CDP, Washington",349,349,0,1051,53,37672
"Lake Shore CDP, Washington",3681,3540,141,6587,53,37830
"Lake Stevens city, Washington",20635,19574,1061,38816,53,37900
"Lake Stickney CDP, Washington",8122,7672,450,14668,53,37917
"Lake Tapps CDP, Washington",6540,6305,235,12196,53,37920
"Lakeview CDP, Washington",652,575,77,1540,53,37926
"Lakewood city, Washington",29975,28431,1544,63142,53,38038
"Lamont town, Washington",53,53,0,159,53,38215
"Langley city, Washington",432,420,12,1076,53,38355
"Larch Way CDP, Washington",2609,2582,27,4399,53,38420
"Latah town, Washington",47,47,0,168,53,38495
"Laurier CDP, Washington",0,0,0,0,53,38705
"Leavenworth city, Washington",1314,1310,4,2619,53,38845
"Lebam CDP, Washington",68,68,0,168,53,38880
"Lewisville CDP, Washington",1110,1061,49,2474,53,39212
"Lexington CDP, Washington",2121,1872,249,4549,53,39230
"Liberty Lake city, Washington",5487,5231,256,12026,53,39335
"Lind town, Washington",290,268,22,569,53,39510
"Lochsloy CDP, Washington",1338,1306,32,2679,53,39860
"Lofall CDP, Washington",1124,1086,38,2038,53,39930
"Long Beach city, Washington",614,614,0,1831,53,40070
"Longbranch CDP, Washington",1902,1828,74,4081,53,40105
"Longview city, Washington",17313,16531,782,37722,53,40245
"Longview Heights CDP, Washington",1765,1643,122,4199,53,40270
"Loomis CDP, Washington",9,9,0,98,53,40350
"Loon Lake CDP, Washington",266,255,11,702,53,40385
"Lower Elochoman CDP, Washington",241,241,0,445,53,40570
"Lyle CDP, Washington",89,89,0,254,53,40735
"Lyman town, Washington",225,212,13,386,53,40770
"Lynden city, Washington",7920,7560,360,15723,53,40805
"Lynnwood city, Washington",21034,20165,869,39867,53,40840
"Mabton city, Washington",1045,945,100,2314,53,40980
"McChord AFB CDP, Washington",474,461,13,2899,53,41155
"McCleary city, Washington",1000,917,83,2426,53,41225
"Machias CDP, Washington",797,730,67,1260,53,41470
"McKenna CDP, Washington",249,197,52,554,53,41645
"McMillin CDP, Washington",622,597,25,1194,53,41785
"Malden town, Washington",86,70,16,194,53,42275
"Malo CDP, Washington",7,7,0,27,53,42310
"Malone CDP, Washington",193,148,45,341,53,42345
"Malott CDP, Washington",280,280,0,927,53,42380
"Maltby CDP, Washington",6354,6156,198,11347,53,42415
"Manchester CDP, Washington",2962,2911,51,6033,53,42450
"Mansfield town, Washington",99,95,4,324,53,42800
"Manson CDP, Washington",638,589,49,1385,53,42835
"Maple Falls CDP, Washington",129,129,0,231,53,43010
"Maple Heights-Lake Desire CDP, Washington",1627,1610,17,3436,53,43062
"Maple Valley city, Washington",13976,13287,689,27889,53,43150
"Maplewood CDP, Washington",2741,2530,211,5518,53,43255
"Marblemount CDP, Washington",111,111,0,198,53,43325
"Marcus town, Washington",47,47,0,182,53,43395
"Marietta-Alderwood CDP, Washington",1806,1728,78,3304,53,43491
"Marine View CDP, Washington",43,43,0,336,53,43552
"Markham CDP, Washington",41,41,0,132,53,43640
"Marrowstone CDP, Washington",354,342,12,882,53,43762
"Martha Lake CDP, Washington",13395,12807,588,23259,53,43815
"Maryhill CDP, Washington",14,14,0,37,53,43885
"Marysville city, Washington",38179,36566,1613,70847,53,43955
"Mattawa city, Washington",1730,1541,189,3506,53,44165
"May Creek CDP, Washington",496,461,35,873,53,44260
"Mead CDP, Washington",3309,3011,298,7172,53,44480
"Meadowdale CDP, Washington",1745,1663,82,2995,53,44585
"Meadow Glade CDP, Washington",976,933,43,2390,53,44620
"Medical Lake city, Washington",2041,1950,91,4909,53,44690
"Medina city, Washington",1253,1225,28,2923,53,44725
"Mercer Island city, Washington",12205,11891,314,25464,53,45005
"Mesa city, Washington",254,210,44,717,53,45180
"Metaline town, Washington",54,50,4,135,53,45285
"Metaline Falls town, Washington",64,46,18,237,53,45320
"Methow CDP, Washington",28,24,4,90,53,45355
"Midland CDP, Washington",4490,4193,297,9081,53,45495
"Mill Creek city, Washington",11333,10860,473,20797,53,45865
"Mill Creek East CDP, Washington",13422,12844,578,25302,53,45870
"Millwood city, Washington",1028,993,35,1930,53,45985
"Milton city, Washington",4839,4537,302,8543,53,46020
"Mineral CDP, Washington",55,55,0,69,53,46090
"Minnehaha CDP, Washington",6466,5960,506,11582,53,46125
"Mirrormont CDP, Washington",2026,1955,71,4102,53,46215
"Moclips CDP, Washington",78,78,0,78,53,46405
"Monroe city, Washington",9523,9111,412,19632,53,46685
"Monroe North CDP, Washington",1066,1066,0,1880,53,46725
"Montesano city, Washington",1446,1392,54,4124,53,46895
"Morton city, Washington",507,451,56,1333,53,47175
"Moses Lake city, Washington",12305,11683,622,25155,53,47245
"Moses Lake North CDP, Washington",2182,2080,102,4958,53,47280
"Mossyrock city, Washington",332,319,13,911,53,47315
"Mountlake Terrace city, Washington",12171,11670,501,21350,53,47490
"Mount Vernon city, Washington",16559,15520,1039,35120,53,47560
"Mount Vista CDP, Washington",5122,4973,149,10399,53,47630
"Moxee city, Washington",2280,2250,30,4411,53,47665
"Mukilteo city, Washington",11415,11134,281,21365,53,47735
"Naches town, Washington",435,410,25,814,53,47805
"Napavine city, Washington",869,806,63,1700,53,47980
"Naselle CDP, Washington",327,327,0,629,53,48015
"Navy Yard City CDP, Washington",1222,1205,17,2643,53,48225
"Neah Bay CDP, Washington",529,484,45,1081,53,48295
"Neilton CDP, Washington",103,103,0,278,53,48330
"Nespelem town, Washington",49,46,3,155,53,48540
"Nespelem Community CDP, Washington",123,110,13,309,53,48550
"Newcastle city, Washington",6971,6631,340,12931,53,48645
"Newport city, Washington",774,751,23,2136,53,48820
"Nile CDP, Washington",48,24,24,115,53,49030
"Nisqually Indian Community CDP, Washington",186,168,18,593,53,49193
"Nooksack city, Washington",787,766,21,1564,53,49275
"Normandy Park city, Washington",3293,3168,125,6697,53,49415
"North Bend city, Washington",4237,4152,85,7549,53,49485
"North Bonneville city, Washington",645,598,47,1146,53,49555
"North Fort Lewis CDP, Washington",688,587,101,6022,53,49765
"North Lynnwood CDP, Washington",14966,14427,539,24235,53,49940
"North Omak CDP, Washington",230,225,5,395,53,50007
"Northport town, Washington",108,108,0,236,53,50045
"North Puyallup CDP, Washington",859,824,35,1544,53,50115
"North Sultan CDP, Washington",168,168,0,336,53,50183
"Northwest Stanwood CDP, Washington",2,2,0,50,53,50195
"North Yelm CDP, Washington",1698,1661,37,2785,53,50210
"Oakesdale town, Washington",169,160,9,427,53,50325
"Oak Harbor city, Washington",8967,8351,616,24458,53,50360
"Oakville city, Washington",382,331,51,656,53,50430
"Ocean City CDP, Washington",46,46,0,107,53,50500
"Ocean Park CDP, Washington",656,602,54,1906,53,50535
"Ocean Shores city, Washington",2358,2233,125,6838,53,50570
"Ocosta CDP, Washington",42,42,0,111,53,50675
"Odessa town, Washington",323,306,17,798,53,50745
"Okanogan city, Washington",1107,1073,34,2640,53,50920
"Olympia city, Washington",28160,26229,1931,55151,53,51300
"Omak city, Washington",2172,2066,106,4877,53,51340
"Onalaska CDP, Washington",225,225,0,599,53,51410
"Orchards CDP, Washington",15090,14077,1013,29214,53,51795
"Orient CDP, Washington",4,4,0,47,53,51830
"Oroville city, Washington",672,625,47,1753,53,51970
"Orting city, Washington",4723,4537,186,8898,53,52005
"Oso CDP, Washington",132,132,0,313,53,52110
"Othello city, Washington",3527,3220,307,8582,53,52215
"Otis Orchards-East Farms CDP, Washington",2762,2624,138,5699,53,52267
"Outlook CDP, Washington",263,263,0,340,53,52285
"Oyehut CDP, Washington",9,9,0,51,53,52378
"Pacific city, Washington",4071,3946,125,7097,53,52495
"Pacific Beach CDP, Washington",76,76,0,76,53,52530
"Packwood CDP, Washington",27,27,0,116,53,52600
"Palouse city, Washington",516,509,7,997,53,52950
"Parker CDP, Washington",31,31,0,90,53,53265
"Parkland CDP, Washington",19982,18793,1189,39398,53,53335
"Parkwood CDP, Washington",3499,3454,45,7303,53,53440
"Pasco city, Washington",37159,34993,2166,77274,53,53545
"Pataha CDP, Washington",40,40,0,77,53,53660
"Pateros city, Washington",303,269,34,668,53,53720
"Peaceful Valley CDP, Washington",963,913,50,2715,53,53800
"Pe Ell town, Washington",250,250,0,513,53,53930
"Picnic Point CDP, Washington",5554,5310,244,9951,53,54213
"Pine Grove CDP, Washington",10,10,0,53,53,54405
"Point Roberts CDP, Washington",649,633,16,1249,53,55015
"Pomeroy city, Washington",488,452,36,1397,53,55120
"Port Angeles city, Washington",9226,8699,527,20007,53,55365
"Port Angeles East CDP, Washington",1401,1351,50,3035,53,55400
"Porter CDP, Washington",66,50,16,146,53,55540
"Port Gamble Tribal Community CDP, Washington",374,347,27,850,53,55612
"Port Hadlock-Irondale CDP, Washington",1779,1694,85,3326,53,55620
"Port Ludlow CDP, Washington",981,929,52,3096,53,55645
"Port Orchard city, Washington",6657,6339,318,15820,53,55785
"Port Townsend city, Washington",4114,3551,563,10161,53,55855
"Poulsbo city, Washington",5321,5100,221,11824,53,55995
"Prairie Heights CDP, Washington",2522,2421,101,4845,53,56150
"Prairie Ridge CDP, Washington",6670,6205,465,12444,53,56170
"Prescott city, Washington",144,129,15,303,53,56240
"Prosser city, Washington",2679,2399,280,6138,53,56450
"Puget Island CDP, Washington",361,342,19,1057,53,56555
"Pullman city, Washington",17353,15993,1360,31972,53,56625
"Purdy CDP, Washington",635,574,61,1422,53,56660
"Puyallup city, Washington",22534,21122,1412,42610,53,56695
"Queets CDP, Washington",33,29,4,114,53,56905
"Quilcene CDP, Washington",342,317,25,610,53,56975
"Qui-nai-elt Village CDP, Washington",14,14,0,49,53,57030
"Quincy city, Washington",3314,3239,75,7754,53,57115
"Raft Island CDP, Washington",266,253,13,451,53,57140
"Rainier city, Washington",1194,1105,89,2707,53,57220
"Ravensdale CDP, Washington",253,253,0,370,53,57395
"Raymond city, Washington",1306,1300,6,3092,53,57430
"Reardan town, Washington",313,302,11,611,53,57465
"Redmond city, Washington",41221,39676,1545,73728,53,57535
"Renton city, Washington",60619,58081,2538,105355,53,57745
"Republic city, Washington",370,350,20,1120,53,57850
"Richland city, Washington",30335,28802,1533,60867,53,58235
"Ridgefield city, Washington",5354,4992,362,11486,53,58410
"Ritzville city, Washington",691,681,10,1733,53,58725
"Riverbend CDP, Washington",1203,1184,19,2041,53,58742
"Riverpoint CDP, Washington",563,522,41,963,53,58768
"River Road CDP, Washington",316,282,34,800,53,58777
"Riverside town, Washington",180,169,11,424,53,58795
"Roche Harbor CDP, Washington",309,307,2,753,53,59075
"Rochester CDP, Washington",2935,2924,11,6282,53,59110
"Rockford town, Washington",198,194,4,430,53,59145
"Rock Island city, Washington",517,481,36,1259,53,59180
"Rockport CDP, Washington",10,10,0,59,53,59250
"Rocky Point CDP, Washington",856,798,58,1546,53,59390
"Ronald CDP, Washington",192,192,0,251,53,59635
"Roosevelt CDP, Washington",70,58,12,192,53,59705
"Rosalia town, Washington",285,267,18,599,53,59775
"Rosburg CDP, Washington",194,175,19,429,53,59845
"Rosedale CDP, Washington",1732,1595,137,4273,53,59880
"Roslyn city, Washington",431,403,28,827,53,60055
"Roy city, Washington",394,369,25,920,53,60160
"Royal City city, Washington",1013,920,93,2060,53,60230
"Ruston city, Washington",687,677,10,1270,53,60510
"Ryderwood CDP, Washington",59,59,0,425,53,60580
"St. John town, Washington",187,171,16,612,53,60860
"Salmon Creek CDP, Washington",9832,9546,286,20312,53,61000
"Sammamish city, Washington",34305,33336,969,66586,53,61115
"Santiago CDP, Washington",16,16,0,75,53,61235
"Satsop CDP, Washington",312,294,18,768,53,61350
"Schwana CDP, Washington",210,210,0,351,53,61925
"Seabeck CDP, Washington",443,377,66,898,53,62120
"SeaTac city, Washington",17339,16056,1283,30927,53,62288
"Seattle city, Washington",472657,452728,19929,734603,53,63000
"Sedro-Woolley city, Washington",5838,5569,269,12470,53,63210
"Sekiu CDP, Washington",36,36,0,56,53,63245
"Selah city, Washington",4317,4134,183,8203,53,63280
"Sequim city, Washington",2822,2655,167,8073,53,63385
"Shadow Lake CDP, Washington",1215,1127,88,2115,53,63545
"Shelton city, Washington",4485,4252,233,10484,53,63735
"Shoreline city, Washington",31971,30576,1395,58673,53,63960
"Silvana CDP, Washington",0,0,0,12,53,64190
"Silverdale CDP, Washington",9618,9131,487,21774,53,64365
"Silver Firs CDP, Washington",12732,12359,373,22230,53,64380
"Sisco Heights CDP, Washington",1545,1471,74,2972,53,64610
"Skamokawa Valley CDP, Washington",34,34,0,288,53,64755
"Skokomish CDP, Washington",278,224,54,644,53,64775
"Skykomish town, Washington",51,48,3,116,53,64855
"Snohomish city, Washington",5061,4695,366,10133,53,65170
"Snoqualmie city, Washington",8064,7843,221,13762,53,65205
"Snoqualmie Pass CDP, Washington",230,221,9,420,53,65275
"Soap Lake city, Washington",579,525,54,1378,53,65345
"South Bend city, Washington",662,654,8,1859,53,65625
"South Cle Elum town, Washington",390,360,30,715,53,65765
"South Creek CDP, Washington",1017,954,63,2346,53,65810
"South Hill CDP, Washington",34995,33402,1593,67835,53,65922
"South Prairie town, Washington",181,173,8,353,53,66045
"South Wenatchee CDP, Washington",577,559,18,1267,53,66185
"Southworth CDP, Washington",1042,984,58,1953,53,66220
"Spanaway CDP, Washington",16380,15495,885,34015,53,66255
"Spangle city, Washington",145,145,0,284,53,66290
"Spokane city, Washington",115974,108822,7152,227922,53,67000
"Spokane Valley city, Washington",53170,50103,3067,103761,53,67167
"Sprague city, Washington",263,230,33,632,53,67175
"Springdale town, Washington",124,124,0,513,53,67210
"Stansberry Lake CDP, Washington",860,806,54,1810,53,67435
"Stanwood city, Washington",3490,3439,51,8051,53,67455
"Starbuck town, Washington",58,57,1,100,53,67490
"Startup CDP, Washington",389,389,0,651,53,67595
"Steilacoom town, Washington",3132,3029,103,6680,53,67770
"Steptoe CDP, Washington",48,48,0,100,53,67805
"Stevenson city, Washington",740,720,20,1697,53,67875
"Sudden Valley CDP, Washington",3360,3239,121,7103,53,68200
"Sultan city, Washington",3024,2860,164,5462,53,68260
"Sumas city, Washington",684,658,26,1397,53,68330
"Summit CDP, Washington",4491,4194,297,8819,53,68365
"Summit View CDP, Washington",5236,4878,358,8748,53,68410
"Summitview CDP, Washington",1105,1091,14,2059,53,68417
"Sumner city, Washington",5269,5037,232,10589,53,68435
"Suncrest CDP, Washington",2503,2410,93,5344,53,68460
"Sunday Lake CDP, Washington",567,567,0,1166,53,68480
"Sunland Estates CDP, Washington",22,22,0,110,53,68557
"Sunnyside city, Washington",6877,6265,612,16329,53,68750
"Sunnyslope CDP, Washington",1727,1704,23,3553,53,68785
"Suquamish CDP, Washington",2173,2047,126,4329,53,69170
"Swede Heaven CDP, Washington",497,489,8,1092,53,69280
"Tacoma city, Washington",117847,111540,6307,219234,53,70000
"Taholah CDP, Washington",351,318,33,823,53,70175
"Tampico CDP, Washington",185,158,27,455,53,70245
"Tanglewilde CDP, Washington",3050,2747,303,6407,53,70280
"Tehaleh CDP, Washington",2687,2508,179,5846,53,70543
"Tekoa city, Washington",211,202,9,661,53,70560
"Tenino city, Washington",1028,981,47,2045,53,70630
"Terrace Heights CDP, Washington",4935,4862,73,9781,53,70805
"Thorp CDP, Washington",47,41,6,90,53,71225
"Three Lakes CDP, Washington",1760,1725,35,3571,53,71330
"Tieton city, Washington",678,672,6,1546,53,71400
"Tokeland CDP, Washington",38,38,0,102,53,71680
"Toledo city, Washington",285,265,20,523,53,71785
"Tonasket city, Washington",372,355,17,912,53,71890
"Toppenish city, Washington",4243,3900,343,8820,53,71960
"Torboy CDP, Washington",131,131,0,227,53,71995
"Touchet CDP, Washington",228,228,0,485,53,72030
"Town and Country CDP, Washington",2866,2603,263,5243,53,72170
"Tracyton CDP, Washington",2618,2548,70,5614,53,72205
"Trout Lake CDP, Washington",516,512,4,822,53,72450
"Tukwila city, Washington",13042,12229,813,21569,53,72625
"Tumwater city, Washington",13519,12743,776,25617,53,72905
"Twin Lakes CDP, Washington",20,17,3,74,53,73065
"Twisp town, Washington",478,429,49,1095,53,73080
"Union CDP, Washington",114,114,0,406,53,73255
"Union Gap city, Washington",3037,2694,343,6512,53,73290
"Union Hill-Novelty Hill CDP, Washington",10446,9947,499,23173,53,73307
"Uniontown town, Washington",168,168,0,387,53,73360
"University Place city, Washington",17204,16575,629,34696,53,73465
"Upper Elochoman CDP, Washington",63,63,0,107,53,73580
"Vader city, Washington",300,279,21,892,53,73780
"Valley CDP, Washington",10,10,0,92,53,73885
"Vancouver city, Washington",99592,93995,5597,190700,53,74060
"Vantage CDP, Washington",0,0,0,0,53,74200
"Vashon CDP, Washington",5413,5055,358,10939,53,74305
"Vaughn CDP, Washington",859,807,52,1313,53,74445
"Venersborg CDP, Washington",1926,1827,99,4212,53,74585
"Verlot CDP, Washington",175,175,0,329,53,74760
"Waitsburg city, Washington",409,383,26,956,53,75565
"Walla Walla city, Washington",15977,15002,975,33842,53,75775
"Walla Walla East CDP, Washington",619,619,0,1826,53,75810
"Waller CDP, Washington",3882,3744,138,7991,53,75905
"Wallula CDP, Washington",23,23,0,88,53,75985
"Wapato city, Washington",2053,1880,173,4600,53,76125
"Warden city, Washington",1069,987,82,2483,53,76160
"Warm Beach CDP, Washington",1165,1125,40,3156,53,76195
"Washougal city, Washington",9129,8388,741,16828,53,76405
"Washtucna town, Washington",51,43,8,176,53,76440
"Waterville town, Washington",899,887,12,1488,53,76510
"Wauna CDP, Washington",2392,2280,112,4689,53,76615
"Waverly town, Washington",92,89,3,171,53,76720
"Wenatchee city, Washington",16878,16334,544,35365,53,77105
"West Clarkston-Highland CDP, Washington",2412,2312,100,6080,53,77297
"West Pasco CDP, Washington",1029,945,84,1870,53,77612
"Westport city, Washington",959,939,20,2498,53,77630
"West Richland city, Washington",7747,7446,301,16547,53,77665
"Wheeler CDP, Washington",126,126,0,236,53,78050
"Whidbey Island Station CDP, Washington",67,67,0,2482,53,78155
"White Center CDP, Washington",8884,8386,498,15479,53,78225
"White Salmon city, Washington",1302,1288,14,2505,53,78330
"White Swan CDP, Washington",222,169,53,561,53,78365
"Wilbur town, Washington",265,261,4,802,53,78680
"Wilderness Rim CDP, Washington",1204,1168,36,1872,53,78780
"Wilkeson town, Washington",215,202,13,463,53,78925
"Willapa CDP, Washington",71,71,0,178,53,78995
"Wilson Creek town, Washington",60,56,4,174,53,79135
"Winlock city, Washington",807,715,92,1958,53,79275
"Winthrop town, Washington",199,196,3,408,53,79380
"Wishram CDP, Washington",155,128,27,502,53,79485
"Wollochet CDP, Washington",3862,3789,73,7276,53,79555
"Woodinville city, Washington",7685,7394,291,13301,53,79590
"Woodland city, Washington",3110,2900,210,6463,53,79625
"Woods Creek CDP, Washington",3340,3160,180,7048,53,79825
"Woodway city, Washington",507,501,6,1118,53,79835
"Yacolt town, Washington",697,682,15,1563,53,79975
"Yakima city, Washington",42653,39178,3475,96764,53,80010
"Yarrow Point town, Washington",622,609,13,1280,53,80150
"Yelm city, Washington",4430,4224,206,10438,53,80220
"Zillah city, Washington",1417,1373,44,3153,53,80500
"Accoville CDP, West Virginia",124,106,18,596,54,00196
"Addison (Webster Springs) town, West Virginia",278,248,30,917,54,00364
"Adrian CDP, West Virginia",41,41,0,107,54,00460
"Albright town, West Virginia",211,203,8,333,54,00748
"Alderson town, West Virginia",296,291,5,969,54,00772
"Alum Creek CDP, West Virginia",689,610,79,1420,54,01396
"Amherstdale CDP, West Virginia",15,15,0,60,54,01660
"Anawalt town, West Virginia",26,24,2,184,54,01780
"Anmoore town, West Virginia",232,217,15,562,54,01900
"Ansted town, West Virginia",651,595,56,1276,54,01996
"Apple Grove CDP, West Virginia",71,71,0,155,54,02188
"Arbovale CDP, West Virginia",70,70,0,160,54,02260
"Arthurdale CDP, West Virginia",559,541,18,957,54,02908
"Athens town, West Virginia",451,405,46,1146,54,03292
"Auburn town, West Virginia",5,5,0,36,54,03364
"Aurora CDP, West Virginia",93,93,0,250,54,03460
"Bancroft town, West Virginia",260,259,1,466,54,04204
"Barboursville village, West Virginia",1662,1642,20,4394,54,04276
"Barrackville town, West Virginia",623,572,51,1430,54,04612
"Bartley CDP, West Virginia",0,0,0,0,54,04732
"Bartow CDP, West Virginia",40,40,0,111,54,04780
"Bath (Berkeley Springs) town, West Virginia",322,315,7,897,54,04876
"Baxter CDP, West Virginia",67,0,67,150,54,04900
"Bayard town, West Virginia",123,117,6,263,54,04924
"Beards Fork CDP, West Virginia",40,40,0,64,54,05068
"Beaver CDP, West Virginia",416,416,0,918,54,05260
"Beckley city, West Virginia",7013,6685,328,17132,54,05332
"Beech Bottom village, West Virginia",312,292,20,627,54,05452
"Belington town, West Virginia",975,848,127,2015,54,05788
"Belle town, West Virginia",618,567,51,1445,54,05836
"Belmont city, West Virginia",380,355,25,824,54,06004
"Belva CDP, West Virginia",13,13,0,46,54,06052
"Benwood city, West Virginia",674,643,31,1251,54,06340
"Bergoo CDP, West Virginia",24,24,0,93,54,06436
"Berwind CDP, West Virginia",35,18,17,200,54,06748
"Bethany town, West Virginia",475,451,24,1125,54,06844
"Bethlehem village, West Virginia",1290,1254,36,2577,54,06940
"Beverly town, West Virginia",199,185,14,681,54,06988
"Big Chimney CDP, West Virginia",184,184,0,412,54,07204
"Big Creek CDP, West Virginia",0,0,0,74,54,07228
"Big Sandy CDP, West Virginia",0,0,0,16,54,07516
"Birch River CDP, West Virginia",0,0,0,7,54,07756
"Blacksville town, West Virginia",28,28,0,48,54,08092
"Blennerhassett CDP, West Virginia",1610,1529,81,3564,54,08308
"Bluefield city, West Virginia",4011,3755,256,9619,54,08524
"Bluewell CDP, West Virginia",829,800,29,2369,54,08764
"Boaz CDP, West Virginia",575,564,11,1400,54,08836
"Bolivar town, West Virginia",817,771,46,1283,54,08932
"Bolt CDP, West Virginia",41,41,0,256,54,08956
"Boomer CDP, West Virginia",184,167,17,537,54,09100
"Booth CDP, West Virginia",190,190,0,318,54,09148
"Bowden CDP, West Virginia",0,0,0,0,54,09364
"Bradley CDP, West Virginia",726,608,118,1603,54,09676
"Bradshaw town, West Virginia",76,73,3,248,54,09700
"Bramwell town, West Virginia",61,46,15,180,54,09796
"Brandonville town, West Virginia",109,101,8,230,54,09844
"Brandywine CDP, West Virginia",84,75,9,183,54,09868
"Brenton CDP, West Virginia",23,23,0,66,54,09964
"Bridgeport city, West Virginia",4710,4636,74,9255,54,10180
"Brookhaven CDP, West Virginia",3228,2976,252,6485,54,10420
"Bruceton Mills town, West Virginia",67,67,0,80,54,10852
"Bruno CDP, West Virginia",108,108,0,413,54,10876
"Brush Fork CDP, West Virginia",473,473,0,1150,54,10948
"Buckhannon city, West Virginia",2119,1989,130,5201,54,11188
"Bud CDP, West Virginia",25,25,0,96,54,11212
"Buffalo town, West Virginia",480,444,36,1151,54,11284
"Burlington CDP, West Virginia",96,96,0,187,54,11620
"Burnsville town, West Virginia",219,195,24,509,54,11716
"Cairo town, West Virginia",50,50,0,164,54,12124
"Camden-on-Gauley town, West Virginia",61,53,8,154,54,12436
"Cameron city, West Virginia",193,169,24,496,54,12484
"Capon Bridge town, West Virginia",234,229,5,526,54,13108
"Carolina CDP, West Virginia",82,57,25,237,54,13468
"Carpendale town, West Virginia",661,602,59,1256,54,13525
"Cass CDP, West Virginia",0,0,0,13,54,13684
"Cassville CDP, West Virginia",1052,1032,20,1570,54,13756
"Cedar Grove town, West Virginia",219,194,25,517,54,13924
"Century CDP, West Virginia",36,24,12,121,54,14212
"Ceredo city, West Virginia",417,393,24,1255,54,14308
"Chapmanville town, West Virginia",324,324,0,875,54,14524
"Charleston city, West Virginia",23106,21760,1346,48415,54,14600
"Charles Town city, West Virginia",3664,3398,266,6584,54,14610
"Charlton Heights CDP, West Virginia",264,264,0,406,54,14630
"Chattaroy CDP, West Virginia",129,109,20,641,54,14692
"Chauncey CDP, West Virginia",172,162,10,378,54,14716
"Cheat Lake CDP, West Virginia",5582,5516,66,10034,54,14775
"Chelyan CDP, West Virginia",155,155,0,452,54,14812
"Chesapeake town, West Virginia",503,476,27,1585,54,15028
"Chester city, West Virginia",889,805,84,2134,54,15076
"Clarksburg city, West Virginia",6817,6416,401,15977,54,15628
"Clay town, West Virginia",74,52,22,524,54,15676
"Clearview village, West Virginia",307,300,7,592,54,15916
"Clendenin town, West Virginia",384,375,9,982,54,16012
"Clifton CDP, West Virginia",276,276,0,498,54,16132
"Coal City CDP, West Virginia",409,376,33,1461,54,16516
"Coal Fork CDP, West Virginia",759,501,258,1278,54,16612
"Colcord CDP, West Virginia",45,31,14,113,54,16972
"Colliers CDP, West Virginia",0,0,0,12,54,17140
"Comfort CDP, West Virginia",40,40,0,176,54,17380
"Corinne CDP, West Virginia",99,51,48,301,54,17836
"Cottageville CDP, West Virginia",49,49,0,183,54,18124
"Covel CDP, West Virginia",41,41,0,112,54,18388
"Cowen town, West Virginia",163,111,52,589,54,18412
"Crab Orchard CDP, West Virginia",868,666,202,1946,54,18508
"Craigsville CDP, West Virginia",685,685,0,2051,54,18604
"Crooked Creek CDP, West Virginia",116,86,30,400,54,19060
"Cross Lanes CDP, West Virginia",5337,5057,280,10037,54,19108
"Crum CDP, West Virginia",32,23,9,143,54,19300
"Crumpler CDP, West Virginia",8,8,0,399,54,19324
"Cucumber CDP, West Virginia",44,44,0,50,54,19492
"Culloden CDP, West Virginia",1235,1163,72,2902,54,19516
"Cunard CDP, West Virginia",27,27,0,222,54,19588
"Dailey CDP, West Virginia",0,0,0,0,54,19948
"Daniels CDP, West Virginia",675,649,26,1564,54,20164
"Danville town, West Virginia",213,182,31,682,54,20212
"Davis town, West Virginia",390,382,8,822,54,20428
"Davy town, West Virginia",69,63,6,271,54,20500
"Deep Water CDP, West Virginia",28,28,0,200,54,20764
"Delbarton town, West Virginia",185,149,36,537,54,20980
"Despard CDP, West Virginia",420,309,111,983,54,21316
"Dixie CDP, West Virginia",47,47,0,98,54,21628
"Dorothy CDP, West Virginia",45,45,0,205,54,21964
"Dunbar city, West Virginia",3729,3674,55,7418,54,22564
"Dupont City CDP, West Virginia",194,194,0,517,54,22828
"Durbin town, West Virginia",157,131,26,297,54,22852
"Earling CDP, West Virginia",66,66,0,288,54,23020
"East Bank town, West Virginia",405,366,39,810,54,23092
"East Dailey CDP, West Virginia",269,269,0,428,54,23140
"East View CDP, West Virginia",193,193,0,429,54,23524
"Eccles CDP, West Virginia",41,41,0,41,54,23644
"Eleanor town, West Virginia",614,608,6,1493,54,24292
"Elizabeth town, West Virginia",281,278,3,700,54,24364
"Elk Garden town, West Virginia",81,79,2,196,54,24484
"Elkins city, West Virginia",3411,3028,383,6935,54,24580
"Elkview CDP, West Virginia",386,386,0,774,54,24748
"Ellenboro town, West Virginia",88,88,0,213,54,24844
"Enterprise CDP, West Virginia",717,640,77,1185,54,25516
"Eskdale CDP, West Virginia",72,72,0,304,54,25732
"Fairlea CDP, West Virginia",491,467,24,1300,54,26428
"Fairmont city, West Virginia",9517,8762,755,18402,54,26452
"Fairview town, West Virginia",79,76,3,247,54,26524
"Falling Spring town, West Virginia",60,60,0,124,54,26692
"Falling Waters CDP, West Virginia",1119,985,134,2150,54,26716
"Falls View CDP, West Virginia",96,48,48,340,54,26812
"Farmington town, West Virginia",218,207,11,422,54,26932
"Fayetteville town, West Virginia",1111,1072,39,2890,54,27028
"Fenwick CDP, West Virginia",24,24,0,98,54,27196
"Flatwoods town, West Virginia",189,150,39,411,54,27868
"Flemington town, West Virginia",118,93,25,291,54,27940
"Follansbee city, West Virginia",1603,1526,77,2812,54,28204
"Fort Ashby CDP, West Virginia",639,639,0,1174,54,28444
"Fort Gay town, West Virginia",175,173,2,565,54,28516
"Frank CDP, West Virginia",47,47,0,122,54,28948
"Franklin town, West Virginia",133,133,0,342,54,29044
"Friendly town, West Virginia",41,41,0,102,54,29404
"Gallipolis Ferry CDP, West Virginia",97,86,11,563,54,29716
"Galloway CDP, West Virginia",34,34,0,109,54,29740
"Garten CDP, West Virginia",76,43,33,127,54,30148
"Gary city, West Virginia",291,270,21,910,54,30196
"Gassaway town, West Virginia",360,303,57,817,54,30220
"Gatewood CDP, West Virginia",182,182,0,374,54,30316
"Gauley Bridge town, West Virginia",168,154,14,471,54,30364
"Ghent CDP, West Virginia",238,238,0,390,54,30724
"Gilbert town, West Virginia",129,129,0,333,54,30772
"Gilbert Creek CDP, West Virginia",273,261,12,805,54,30777
"Glasgow town, West Virginia",282,261,21,805,54,31324
"Glen Dale city, West Virginia",749,703,46,1614,54,31492
"Glen Ferris CDP, West Virginia",49,49,0,120,54,31732
"Glen Fork CDP, West Virginia",50,50,0,326,54,31756
"Glen Jean CDP, West Virginia",31,31,0,61,54,31876
"Glenville town, West Virginia",526,504,22,1172,54,32044
"Glen White CDP, West Virginia",194,194,0,194,54,32068
"Grafton city, West Virginia",2111,1872,239,4711,54,32716
"Grantsville town, West Virginia",93,72,21,371,54,32884
"Grant Town town, West Virginia",148,136,12,439,54,32908
"Granville town, West Virginia",771,691,80,1384,54,32932
"Great Cacapon CDP, West Virginia",303,303,0,740,54,33100
"Green Bank CDP, West Virginia",32,32,0,59,54,33124
"Green Spring CDP, West Virginia",77,77,0,116,54,33436
"Greenview CDP, West Virginia",69,69,0,239,54,33580
"Greenville CDP, West Virginia",121,121,0,232,54,33604
"Gypsy CDP, West Virginia",11,6,5,45,54,34180
"Hambleton town, West Virginia",66,66,0,203,54,34492
"Hamlin town, West Virginia",514,490,24,1380,54,34516
"Handley town, West Virginia",162,162,0,412,54,34756
"Hansford CDP, West Virginia",43,43,0,134,54,34852
"Harman town, West Virginia",35,32,3,96,54,35092
"Harpers Ferry town, West Virginia",147,135,12,301,54,35284
"Harrisville town, West Virginia",589,558,31,1620,54,35428
"Hartford City town, West Virginia",234,228,6,586,54,35500
"Harts CDP, West Virginia",95,95,0,436,54,35596
"Hedgesville town, West Virginia",172,171,1,260,54,36220
"Helen CDP, West Virginia",0,0,0,22,54,36292
"Helvetia CDP, West Virginia",0,0,0,15,54,36340
"Henderson town, West Virginia",50,48,2,231,54,36436
"Hendricks town, West Virginia",96,88,8,323,54,36460
"Henlawson CDP, West Virginia",0,0,0,332,54,36484
"Hepzibah CDP, West Virginia",175,175,0,334,54,36628
"Hico CDP, West Virginia",61,61,0,383,54,37036
"Hillsboro town, West Virginia",62,46,16,187,54,37372
"Hilltop CDP, West Virginia",229,200,29,603,54,37444
"Hinkleville CDP, West Virginia",235,181,54,409,54,37612
"Hinton city, West Virginia",733,662,71,2167,54,37636
"Holden CDP, West Virginia",269,263,6,559,54,37948
"Hollygrove CDP, West Virginia",31,31,0,106,54,38092
"Hometown CDP, West Virginia",337,300,37,869,54,38260
"Hooverson Heights CDP, West Virginia",1019,986,33,2329,54,38476
"Hundred town, West Virginia",129,129,0,379,54,39340
"Huntersville CDP, West Virginia",11,11,0,27,54,39412
"Huntington city, West Virginia",21474,19801,1673,46637,54,39460
"Hurricane city, West Virginia",3242,3143,99,6908,54,39532
"Huttonsville town, West Virginia",91,91,0,185,54,39628
"Iaeger town, West Virginia",73,70,3,204,54,39652
"Idamay CDP, West Virginia",360,360,0,654,54,39676
"Institute CDP, West Virginia",231,231,0,582,54,40156
"Inwood CDP, West Virginia",1441,1287,154,2831,54,40204
"Itmann CDP, West Virginia",52,52,0,111,54,40444
"Jacksonburg CDP, West Virginia",35,35,0,112,54,40636
"Jane Lew town, West Virginia",246,243,3,616,54,40828
"Jefferson CDP, West Virginia",177,177,0,635,54,41010
"Junior town, West Virginia",119,86,33,352,54,42244
"Justice CDP, West Virginia",131,120,11,319,54,42292
"Justice Addition CDP, West Virginia",87,87,0,117,54,42316
"Kanawha CDP, West Virginia",134,134,0,288,54,42388
"Kenova city, West Virginia",1461,1440,21,3019,54,43180
"Kermit town, West Virginia",69,63,6,217,54,43300
"Keyser city, West Virginia",2194,2062,132,4879,54,43492
"Keystone city, West Virginia",25,22,3,99,54,43516
"Kimball town, West Virginia",51,42,9,281,54,43780
"Kimberly CDP, West Virginia",141,141,0,375,54,43828
"Kincaid CDP, West Virginia",23,23,0,288,54,43852
"Kingwood city, West Virginia",1464,1355,109,2997,54,44044
"Kistler CDP, West Virginia",62,47,15,264,54,44188
"Kopperston CDP, West Virginia",95,95,0,780,54,44548
"Lashmeet CDP, West Virginia",295,295,0,704,54,45292
"Lavalette CDP, West Virginia",375,375,0,991,54,45580
"Leon town, West Virginia",94,94,0,369,54,46300
"Lesage CDP, West Virginia",543,543,0,1030,54,46420
"Lester town, West Virginia",115,105,10,440,54,46468
"Lewisburg city, West Virginia",1465,1465,0,3890,54,46636
"Littleton CDP, West Virginia",67,67,0,96,54,47788
"Logan city, West Virginia",963,799,164,2213,54,48148
"Lost Creek town, West Virginia",209,191,18,386,54,48748
"Lubeck CDP, West Virginia",439,387,52,1290,54,49156
"Lumberport town, West Virginia",470,470,0,783,54,49252
"Mabscott town, West Virginia",590,577,13,1550,54,49492
"MacArthur CDP, West Virginia",611,568,43,1362,54,49564
"McConnell CDP, West Virginia",173,72,101,899,54,49732
"McMechen city, West Virginia",857,812,45,1812,54,50260
"Madison city, West Virginia",1290,1154,136,2880,54,50524
"Malden CDP, West Virginia",92,79,13,430,54,50836
"Mallory CDP, West Virginia",577,549,28,1353,54,50860
"Man town, West Virginia",439,358,81,1185,54,50932
"Mannington city, West Virginia",695,630,65,1677,54,51100
"Marlinton town, West Virginia",409,363,46,1139,54,51676
"Marmet city, West Virginia",626,566,60,1658,54,51724
"Martinsburg city, West Virginia",9681,8799,882,18678,54,52060
"Mason town, West Virginia",255,236,19,818,54,52180
"Masontown town, West Virginia",202,171,31,434,54,52228
"Matewan town, West Virginia",152,120,32,558,54,52324
"Matheny CDP, West Virginia",37,37,0,183,54,52372
"Matoaka town, West Virginia",25,22,3,118,54,52420
"Maybeury CDP, West Virginia",50,41,9,163,54,52588
"Meadow Bridge town, West Virginia",159,148,11,548,54,52780
"Middlebourne town, West Virginia",288,277,11,830,54,53572
"Middleway CDP, West Virginia",272,272,0,440,54,53692
"Mill Creek town, West Virginia",313,278,35,740,54,54100
"Milton town, West Virginia",1255,1154,101,2773,54,54484
"Mineralwells CDP, West Virginia",945,936,9,2549,54,54580
"Mitchell Heights town, West Virginia",200,191,9,414,54,54892
"Monaville CDP, West Virginia",152,140,12,666,54,55132
"Monongah town, West Virginia",556,531,25,1052,54,55276
"Montcalm CDP, West Virginia",277,257,20,714,54,55372
"Montgomery city, West Virginia",581,533,48,1706,54,55468
"Montrose town, West Virginia",59,59,0,314,54,55540
"Moorefield town, West Virginia",1490,1421,69,2846,54,55588
"Morgantown city, West Virginia",15869,14305,1564,30220,54,55756
"Moundsville city, West Virginia",3713,3507,206,8056,54,56020
"Mount Carbon CDP, West Virginia",66,66,0,200,54,56212
"Mount Gay-Shamrock CDP, West Virginia",429,327,102,1418,54,56342
"Mount Hope city, West Virginia",362,319,43,1032,54,56404
"Mullens city, West Virginia",1131,1088,43,2317,54,57148
"Neibert CDP, West Virginia",220,220,0,352,54,57916
"Nettie CDP, West Virginia",18,18,0,261,54,58180
"Newark CDP, West Virginia",124,124,0,337,54,58252
"Newburg town, West Virginia",114,114,0,237,54,58300
"New Cumberland city, West Virginia",433,394,39,1121,54,58372
"Newell CDP, West Virginia",412,342,70,1129,54,58420
"New Haven town, West Virginia",840,803,37,1761,54,58564
"New Martinsville city, West Virginia",2179,2032,147,5210,54,58684
"New Richmond CDP, West Virginia",0,0,0,20,54,58756
"Nitro city, West Virginia",3012,2762,250,6540,54,59068
"Northfork town, West Virginia",136,115,21,402,54,59428
"North Hills town, West Virginia",389,369,20,991,54,59458
"Norton CDP, West Virginia",75,75,0,198,54,59668
"Nutter Fort town, West Virginia",881,829,52,1700,54,59836
"Oak Hill city, West Virginia",3529,3236,293,8157,54,60028
"Oakvale town, West Virginia",60,53,7,214,54,60196
"Oceana town, West Virginia",480,444,36,1232,54,60364
"Omar CDP, West Virginia",122,98,24,243,54,60628
"Osage CDP, West Virginia",0,0,0,44,54,61180
"Paden City city, West Virginia",1175,1115,60,2740,54,61636
"Page CDP, West Virginia",47,47,0,176,54,61660
"Pageton CDP, West Virginia",0,0,0,0,54,61684
"Parcoal CDP, West Virginia",7,7,0,17,54,62044
"Parkersburg city, West Virginia",12883,11994,889,29685,54,62140
"Parsons city, West Virginia",646,557,89,1524,54,62284
"Paw Paw town, West Virginia",204,175,29,463,54,62332
"Pax town, West Virginia",25,25,0,79,54,62356
"Peach Creek CDP, West Virginia",42,42,0,62,54,62428
"Pea Ridge CDP, West Virginia",3643,3518,125,6884,54,62488
"Pennsboro city, West Virginia",526,492,34,1359,54,62764
"Pentress CDP, West Virginia",0,0,0,21,54,62788
"Petersburg city, West Virginia",1440,1357,83,2822,54,62956
"Peterstown town, West Virginia",148,132,16,673,54,63052
"Philippi city, West Virginia",1230,1132,98,2920,54,63292
"Pickens CDP, West Virginia",13,13,0,13,54,63484
"Piedmont town, West Virginia",581,532,49,997,54,63604
"Pinch CDP, West Virginia",1496,1469,27,4015,54,63772
"Pine Grove town, West Virginia",93,79,14,214,54,63892
"Pineville town, West Virginia",125,102,23,546,54,63940
"Piney View CDP, West Virginia",270,260,10,708,54,63988
"Pleasant Valley city, West Virginia",1546,1521,25,3480,54,64228
"Poca town, West Virginia",566,556,10,1133,54,64516
"Point Pleasant city, West Virginia",1559,1508,51,4067,54,64708
"Powellton CDP, West Virginia",113,113,0,463,54,65284
"Pratt town, West Virginia",174,155,19,423,54,65356
"Prichard CDP, West Virginia",187,187,0,450,54,65596
"Prince CDP, West Virginia",34,34,0,53,54,65668
"Princeton city, West Virginia",2543,2410,133,5833,54,65692
"Prosperity CDP, West Virginia",732,609,123,1531,54,65836
"Pullman town, West Virginia",93,93,0,303,54,65956
"Quinwood town, West Virginia",31,24,7,155,54,66412
"Rachel CDP, West Virginia",131,79,52,232,54,66460
"Racine CDP, West Virginia",221,124,97,457,54,66484
"Rainelle town, West Virginia",523,505,18,1424,54,66652
"Raleigh CDP, West Virginia",202,161,41,248,54,66748
"Rand CDP, West Virginia",365,347,18,941,54,66892
"Ranson corporation, West Virginia",3099,2947,152,5497,54,66988
"Ravenswood city, West Virginia",1570,1470,100,3853,54,67108
"Raymond City CDP, West Virginia",99,99,0,289,54,67204
"Raysal CDP, West Virginia",154,39,115,644,54,67228
"Reader CDP, West Virginia",0,0,0,126,54,67252
"Red Jacket CDP, West Virginia",110,93,17,512,54,67396
"Reedsville town, West Virginia",322,212,110,614,54,67636
"Reedy town, West Virginia",49,33,16,194,54,67660
"Reynoldsville CDP, West Virginia",135,122,13,307,54,67972
"Rhodell town, West Virginia",67,57,10,127,54,67996
"Richwood city, West Virginia",820,642,178,2567,54,68116
"Ridgeley town, West Virginia",181,171,10,386,54,68260
"Ripley city, West Virginia",1305,1249,56,3084,54,68596
"Rivesville town, West Virginia",393,352,41,679,54,68908
"Robinette CDP, West Virginia",101,91,10,471,54,69100
"Rock Cave CDP, West Virginia",104,104,0,295,54,69244
"Roderfield CDP, West Virginia",12,12,0,127,54,69844
"Romney city, West Virginia",617,531,86,2062,54,70084
"Ronceverte city, West Virginia",791,766,25,1426,54,70156
"Rossmore CDP, West Virginia",29,29,0,85,54,70468
"Rowlesburg town, West Virginia",266,225,41,585,54,70588
"Rupert town, West Virginia",451,440,11,1093,54,70828
"St. Albans city, West Virginia",4913,4608,305,10753,54,71212
"St. George CDP, West Virginia",51,51,0,83,54,71284
"St. Marys city, West Virginia",1211,1134,77,2281,54,71356
"Salem city, West Virginia",865,830,35,1873,54,71380
"Salt Rock CDP, West Virginia",0,0,0,148,54,71476
"Sand Fork town, West Virginia",40,40,0,112,54,71620
"Sarah Ann CDP, West Virginia",82,82,0,289,54,72004
"Scarbro CDP, West Virginia",119,102,17,250,54,72292
"Shady Spring CDP, West Virginia",1466,1313,153,3581,54,73108
"Shannondale CDP, West Virginia",1826,1722,104,3294,54,73252
"Shenandoah Junction CDP, West Virginia",695,695,0,1205,54,73444
"Shepherdstown town, West Virginia",768,651,117,1612,54,73468
"Shinnston city, West Virginia",1047,1002,45,2328,54,73636
"Shrewsbury CDP, West Virginia",139,139,0,381,54,73876
"Sissonville CDP, West Virginia",921,816,105,2680,54,74356
"Sistersville city, West Virginia",430,391,39,1261,54,74380
"Smithers city, West Virginia",247,234,13,838,54,74740
"Smithfield town, West Virginia",22,22,0,142,54,74788
"Sophia town, West Virginia",568,496,72,1730,54,75172
"South Charleston city, West Virginia",6823,6355,468,13527,54,75292
"Spelter CDP, West Virginia",39,39,0,79,54,75796
"Spencer city, West Virginia",592,450,142,2057,54,75820
"Sprague CDP, West Virginia",472,472,0,994,54,75868
"Springfield CDP, West Virginia",162,162,0,411,54,76084
"Stanaford CDP, West Virginia",547,495,52,1401,54,76444
"Star City town, West Virginia",1353,1340,13,2167,54,76516
"Stollings CDP, West Virginia",89,89,0,366,54,76996
"Stonewood city, West Virginia",1093,968,125,2428,54,77188
"Summersville city, West Virginia",1255,1189,66,3415,54,77980
"Sutton town, West Virginia",388,369,19,859,54,78580
"Switzer CDP, West Virginia",30,30,0,211,54,78796
"Sylvester town, West Virginia",50,40,10,169,54,78964
"Teays Valley CDP, West Virginia",6784,6551,233,13816,54,79545
"Terra Alta town, West Virginia",896,820,76,2040,54,79708
"Thomas city, West Virginia",283,247,36,624,54,80020
"Thurmond town, West Virginia",4,4,0,4,54,80284
"Tioga CDP, West Virginia",213,166,47,545,54,80476
"Tornado CDP, West Virginia",462,460,2,1029,54,80764
"Triadelphia town, West Virginia",344,320,24,735,54,80932
"Tunnelton town, West Virginia",212,193,19,350,54,81268
"Twilight CDP, West Virginia",33,20,13,83,54,81484
"Union town, West Virginia",169,145,24,486,54,81940
"Valley Bend CDP, West Virginia",313,301,12,585,54,82564
"Valley Grove village, West Virginia",243,229,14,526,54,82732
"Valley Head CDP, West Virginia",10,10,0,35,54,82756
"Van CDP, West Virginia",72,72,0,133,54,82852
"Verdunville CDP, West Virginia",238,186,52,528,54,83332
"Vienna city, West Virginia",5152,4855,297,10642,54,83500
"Vivian CDP, West Virginia",0,0,0,0,54,83764
"Wallace CDP, West Virginia",94,94,0,235,54,84172
"War city, West Virginia",119,98,21,672,54,84484
"Wardensville town, West Virginia",162,147,15,379,54,84580
"Washington CDP, West Virginia",410,392,18,1155,54,84724
"Waverly CDP, West Virginia",152,152,0,482,54,84916
"Wayne town, West Virginia",534,510,24,1335,54,84940
"Weirton city, West Virginia",9345,8616,729,18971,54,85156
"Welch city, West Virginia",508,464,44,3475,54,85228
"Wellsburg city, West Virginia",974,846,128,2180,54,85324
"West Dunbar CDP, West Virginia",294,238,56,515,54,85636
"West Hamlin town, West Virginia",180,170,10,553,54,85804
"West Liberty town, West Virginia",907,870,37,1764,54,85876
"West Logan town, West Virginia",157,151,6,349,54,85900
"West Milford town, West Virginia",286,277,9,501,54,85924
"Weston city, West Virginia",1807,1574,233,3922,54,85972
"Westover city, West Virginia",2427,2353,74,4012,54,85996
"West Union town, West Virginia",500,498,2,832,54,86116
"Wheeling city, West Virginia",12056,11314,742,26900,54,86452
"White Hall town, West Virginia",542,515,27,1025,54,86620
"White Sulphur Springs city, West Virginia",1153,1080,73,2707,54,86812
"Whitesville town, West Virginia",91,80,11,181,54,86836
"Whitmer CDP, West Virginia",0,0,0,93,54,86932
"Wiley Ford CDP, West Virginia",273,257,16,665,54,87316
"Williamson city, West Virginia",934,826,108,3035,54,87508
"Williamstown city, West Virginia",1472,1433,39,2980,54,87556
"Windsor Heights village, West Virginia",182,153,29,564,54,87892
"Winfield town, West Virginia",1457,1415,42,2975,54,87988
"Wolf Summit CDP, West Virginia",94,94,0,187,54,88276
"Womelsdorf (Coalton) town, West Virginia",64,61,3,173,54,88324
"Worthington town, West Virginia",45,40,5,98,54,88708
"Abbotsford city, Wisconsin",1128,1058,70,2186,55,00100
"Abrams CDP, Wisconsin",177,171,6,282,55,00150
"Adams city, Wisconsin",924,822,102,2204,55,00275
"Adell village, Wisconsin",234,232,2,462,55,00450
"Albany village, Wisconsin",601,601,0,1101,55,00750
"Algoma city, Wisconsin",1513,1459,54,3227,55,01000
"Allens Grove CDP, Wisconsin",75,75,0,154,55,01075
"Allenton CDP, Wisconsin",453,411,42,835,55,01100
"Allouez village, Wisconsin",6878,6717,161,14089,55,01150
"Alma city, Wisconsin",309,308,1,742,55,01225
"Alma Center village, Wisconsin",342,299,43,577,55,01300
"Almena village, Wisconsin",361,352,9,742,55,01325
"Almond village, Wisconsin",242,241,1,444,55,01400
"Alto CDP, Wisconsin",67,66,1,105,55,01500
"Altoona city, Wisconsin",4611,4453,158,8506,55,01550
"Amberg CDP, Wisconsin",34,34,0,125,55,01650
"Amery city, Wisconsin",1484,1417,67,2959,55,01725
"Amherst village, Wisconsin",511,494,17,988,55,01750
"Amherst Junction village, Wisconsin",175,173,2,309,55,01800
"Angelica CDP, Wisconsin",52,52,0,120,55,01950
"Aniwa village, Wisconsin",114,107,7,222,55,02075
"Antigo city, Wisconsin",3894,3631,263,8075,55,02250
"Appleton city, Wisconsin",41978,40342,1636,75133,55,02375
"Arcadia city, Wisconsin",1619,1548,71,3669,55,02500
"Arena village, Wisconsin",471,468,3,825,55,02550
"Argonne CDP, Wisconsin",48,46,2,82,55,02600
"Argyle village, Wisconsin",457,445,12,830,55,02650
"Arkansaw CDP, Wisconsin",163,156,7,373,55,02700
"Arkdale CDP, Wisconsin",57,57,0,203,55,02725
"Arlington village, Wisconsin",520,493,27,879,55,02800
"Arpin village, Wisconsin",172,163,9,284,55,03025
"Ashippun CDP, Wisconsin",550,538,12,955,55,03175
"Ashland city, Wisconsin",4196,4038,158,7903,55,03225
"Ashwaubenon village, Wisconsin",9480,9124,356,16939,55,03425
"Athens village, Wisconsin",494,490,4,1015,55,03550
"Auburndale village, Wisconsin",375,369,6,882,55,03775
"Augusta city, Wisconsin",518,496,22,1254,55,03825
"Avoca village, Wisconsin",234,231,3,519,55,04025
"Babcock CDP, Wisconsin",35,35,0,77,55,04150
"Bagley village, Wisconsin",156,146,10,335,55,04250
"Baileys Harbor CDP, Wisconsin",133,122,11,212,55,04300
"Baldwin village, Wisconsin",2242,2214,28,4280,55,04400
"Balsam Lake village, Wisconsin",357,329,28,834,55,04475
"Bancroft CDP, Wisconsin",288,282,6,693,55,04525
"Bangor village, Wisconsin",712,698,14,1317,55,04550
"Baraboo city, Wisconsin",6973,6575,398,12541,55,04625
"Barneveld village, Wisconsin",844,830,14,1454,55,04775
"Barron city, Wisconsin",1553,1470,83,3693,55,04875
"Barronett CDP, Wisconsin",43,43,0,88,55,04925
"Batavia CDP, Wisconsin",180,178,2,234,55,05275
"Bay City village, Wisconsin",211,206,5,362,55,05325
"Bayfield city, Wisconsin",267,259,8,617,55,05350
"Bayfront CDP, Wisconsin",65,48,17,119,55,05387
"Bayside village, Wisconsin",2196,2098,98,4506,55,05450
"Bear Creek village, Wisconsin",144,140,4,287,55,05575
"Beaver Dam city, Wisconsin",9894,9471,423,16652,55,05900
"Belgium village, Wisconsin",1450,1363,87,2573,55,06150
"Bell Center village, Wisconsin",34,33,1,92,55,06225
"Belleville village, Wisconsin",1539,1504,35,2712,55,06300
"Bellevue village, Wisconsin",9014,8739,275,16086,55,06350
"Belmont village, Wisconsin",562,544,18,983,55,06425
"Beloit city, Wisconsin",18142,17045,1097,36642,55,06500
"Benton village, Wisconsin",458,440,18,901,55,06825
"Berlin city, Wisconsin",2715,2625,90,5537,55,06925
"Big Bend village, Wisconsin",783,758,25,1407,55,07200
"Big Falls village, Wisconsin",101,97,4,149,55,07250
"Big Foot Prairie CDP, Wisconsin",66,66,0,99,55,07315
"Birch Hill CDP, Wisconsin",216,195,21,318,55,07532
"Birchwood village, Wisconsin",248,243,5,434,55,07550
"Birnamwood village, Wisconsin",333,326,7,762,55,07600
"Biron village, Wisconsin",297,285,12,776,55,07650
"Black Creek village, Wisconsin",653,633,20,1194,55,07725
"Black Earth village, Wisconsin",753,740,13,1694,55,07800
"Black River Falls city, Wisconsin",1499,1431,68,3488,55,07900
"Blair city, Wisconsin",654,624,30,1218,55,08075
"Blanchardville village, Wisconsin",439,434,5,712,55,08125
"Bloomer city, Wisconsin",1890,1847,43,3679,55,08225
"Bloomfield village, Wisconsin",2583,2396,187,4791,55,08265
"Bloomington village, Wisconsin",399,393,6,751,55,08375
"Blue Mounds village, Wisconsin",502,469,33,864,55,08475
"Blue River village, Wisconsin",230,226,4,510,55,08525
"Bluffview CDP, Wisconsin",273,266,7,616,55,08560
"Boaz village, Wisconsin",61,60,1,136,55,08600
"Bohners Lake CDP, Wisconsin",1241,1145,96,2415,55,08625
"Bonduel village, Wisconsin",770,749,21,1427,55,08725
"Boscobel city, Wisconsin",1352,1288,64,3275,55,08850
"Boulder Junction CDP, Wisconsin",103,103,0,204,55,08925
"Bowler village, Wisconsin",128,127,1,297,55,09025
"Boyceville village, Wisconsin",696,660,36,1286,55,09050
"Boyd village, Wisconsin",271,268,3,553,55,09075
"Brandon village, Wisconsin",495,475,20,842,55,09300
"Brice Prairie CDP, Wisconsin",1065,1048,17,1945,55,09465
"Briggsville CDP, Wisconsin",96,92,4,290,55,09575
"Brillion city, Wisconsin",1615,1591,24,3294,55,09725
"Bristol village, Wisconsin",2958,2723,235,5169,55,09800
"Brodhead city, Wisconsin",1676,1563,113,3221,55,09925
"Brookfield city, Wisconsin",20707,20122,585,41342,55,10025
"Brooklyn village, Wisconsin",778,749,29,1375,55,10075
"Brothertown CDP, Wisconsin",106,106,0,264,55,10325
"Brown Deer village, Wisconsin",6665,6411,254,12593,55,10375
"Browns Lake CDP, Wisconsin",896,896,0,1831,55,10425
"Brownsville village, Wisconsin",451,412,39,717,55,10450
"Browntown village, Wisconsin",128,116,12,210,55,10475
"Bruce village, Wisconsin",289,281,8,739,55,10500
"Brule CDP, Wisconsin",87,87,0,200,55,10550
"Buffalo City city, Wisconsin",487,476,11,835,55,11062
"Burlington city, Wisconsin",5883,5694,189,11000,55,11200
"Burnett CDP, Wisconsin",216,181,35,292,55,11250
"Butler village, Wisconsin",1162,1125,37,1906,55,11475
"Butte des Morts CDP, Wisconsin",510,506,4,907,55,11500
"Butternut village, Wisconsin",170,167,3,458,55,11525
"Cable CDP, Wisconsin",109,109,0,188,55,11650
"Cadott village, Wisconsin",797,791,6,1476,55,11750
"Caledonia village, Wisconsin",12792,12307,485,25277,55,11950
"Cambria village, Wisconsin",424,409,15,750,55,12200
"Cambridge village, Wisconsin",835,821,14,1442,55,12225
"Cameron village, Wisconsin",958,938,20,1800,55,12250
"Campbellsport village, Wisconsin",1050,1031,19,1932,55,12325
"Camp Douglas village, Wisconsin",311,300,11,739,55,12350
"Caroline CDP, Wisconsin",133,128,5,406,55,12675
"Cascade village, Wisconsin",372,369,3,650,55,12825
"Casco village, Wisconsin",374,367,7,598,55,12850
"Cashton village, Wisconsin",540,525,15,1303,55,12950
"Cassville village, Wisconsin",344,340,4,731,55,13050
"Cataract CDP, Wisconsin",101,101,0,174,55,13150
"Catawba village, Wisconsin",59,52,7,130,55,13175
"Cazenovia village, Wisconsin",123,116,7,232,55,13300
"Cecil village, Wisconsin",284,281,3,475,55,13325
"Cedarburg city, Wisconsin",6408,6314,94,12213,55,13375
"Cedar Grove village, Wisconsin",1477,1444,33,2433,55,13475
"Ceex Haci CDP, Wisconsin",5,5,0,27,55,13587
"Centuria village, Wisconsin",562,499,63,933,55,13850
"Chain O' Lakes CDP, Wisconsin",336,318,18,882,55,13880
"Chaseburg village, Wisconsin",206,205,1,299,55,14150
"Chelsea CDP, Wisconsin",28,26,2,80,55,14175
"Chenequa village, Wisconsin",275,272,3,783,55,14225
"Chetek city, Wisconsin",1148,1108,40,2264,55,14325
"Chief Lake CDP, Wisconsin",295,276,19,626,55,14440
"Chili CDP, Wisconsin",151,148,3,333,55,14450
"Chilton city, Wisconsin",2272,2252,20,4017,55,14475
"Chippewa Falls city, Wisconsin",7312,6918,394,14623,55,14575
"Clam Lake CDP, Wisconsin",4,4,0,49,55,14850
"Clarks Mills CDP, Wisconsin",62,62,0,130,55,14925
"Clayton village, Wisconsin",180,178,2,341,55,15100
"Clear Lake village, Wisconsin",514,494,20,1048,55,15250
"Cleveland village, Wisconsin",897,893,4,1686,55,15400
"Clinton village, Wisconsin",962,879,83,1938,55,15625
"Clintonville city, Wisconsin",2489,2408,81,4549,55,15725
"Clyman village, Wisconsin",238,226,12,385,55,15900
"Cobb village, Wisconsin",268,265,3,409,55,15975
"Cochrane village, Wisconsin",220,213,7,411,55,16025
"Colby city, Wisconsin",981,943,38,2132,55,16150
"Coleman village, Wisconsin",298,292,6,787,55,16250
"Colfax village, Wisconsin",838,766,72,1313,55,16275
"Collins CDP, Wisconsin",128,128,0,217,55,16350
"Coloma village, Wisconsin",308,294,14,524,55,16375
"Columbus city, Wisconsin",3300,3232,68,5481,55,16450
"Combined Locks village, Wisconsin",2021,1974,47,3620,55,16500
"Como CDP, Wisconsin",1336,1291,45,2309,55,16575
"Conrath village, Wisconsin",54,52,2,81,55,16775
"Coon Valley village, Wisconsin",514,498,16,914,55,16900
"Cornell city, Wisconsin",693,685,8,1395,55,17100
"Cornucopia CDP, Wisconsin",32,32,0,103,55,17150
"Cottage Grove village, Wisconsin",4466,4380,86,7567,55,17175
"Couderay village, Wisconsin",43,40,3,119,55,17225
"Crandon city, Wisconsin",762,752,10,1519,55,17425
"Crivitz village, Wisconsin",519,505,14,1187,55,17725
"Cross Plains village, Wisconsin",2430,2414,16,4053,55,17775
"Cuba City city, Wisconsin",1197,1196,1,2163,55,17950
"Cudahy city, Wisconsin",10093,9860,233,18087,55,17975
"Cumberland city, Wisconsin",1199,1112,87,2714,55,18025
"Curtiss village, Wisconsin",152,147,5,347,55,18125
"Dale CDP, Wisconsin",371,366,5,642,55,18500
"Dallas village, Wisconsin",185,177,8,379,55,18575
"Dalton CDP, Wisconsin",110,106,4,223,55,18625
"Danbury CDP, Wisconsin",40,35,5,92,55,18650
"Dane village, Wisconsin",741,728,13,1104,55,18700
"Darien village, Wisconsin",709,687,22,1271,55,18825
"Darlington city, Wisconsin",1196,1173,23,2462,55,18875
"Deerfield village, Wisconsin",1221,1194,27,2207,55,19250
"Deer Park village, Wisconsin",115,109,6,217,55,19325
"DeForest village, Wisconsin",6074,5942,132,10767,55,19350
"Dekorra CDP, Wisconsin",77,77,0,109,55,19365
"Delafield city, Wisconsin",3836,3778,58,7181,55,19400
"Delavan city, Wisconsin",4648,4450,198,8519,55,19450
"Delavan Lake CDP, Wisconsin",1435,1404,31,2926,55,19500
"Dellwood CDP, Wisconsin",139,139,0,547,55,19600
"Denmark village, Wisconsin",1403,1379,24,2400,55,19700
"De Pere city, Wisconsin",14185,13964,221,25373,55,19775
"De Soto village, Wisconsin",252,250,2,539,55,19850
"Diamond Bluff CDP, Wisconsin",103,83,20,209,55,20125
"Diaperville CDP, Wisconsin",43,43,0,46,55,20167
"Dickeyville village, Wisconsin",540,529,11,911,55,20175
"Dodge CDP, Wisconsin",52,52,0,226,55,20275
"Dodgeville city, Wisconsin",2995,2872,123,4994,55,20350
"Dorchester village, Wisconsin",409,396,13,852,55,20450
"Dousman village, Wisconsin",1014,998,16,2099,55,20550
"Downing village, Wisconsin",122,122,0,212,55,20675
"Downsville CDP, Wisconsin",128,77,51,263,55,20725
"Doylestown village, Wisconsin",131,129,2,204,55,20775
"Dresser village, Wisconsin",503,495,8,988,55,20850
"Drummond CDP, Wisconsin",92,92,0,167,55,20875
"Dunbar CDP, Wisconsin",25,25,0,86,55,20975
"Durand city, Wisconsin",836,822,14,1735,55,21225
"Dyckesville CDP, Wisconsin",179,172,7,343,55,21375
"Eagle village, Wisconsin",1248,1226,22,2050,55,21425
"Eagle Lake CDP, Wisconsin",571,555,16,954,55,21525
"Eagle River city, Wisconsin",696,648,48,1575,55,21625
"Eastman village, Wisconsin",158,148,10,332,55,21900
"Easton CDP, Wisconsin",33,33,0,57,55,21975
"East Troy village, Wisconsin",2672,2618,54,4669,55,22100
"Eau Claire city, Wisconsin",40416,38979,1437,69098,55,22300
"Eden village, Wisconsin",438,414,24,726,55,22475
"Edgar village, Wisconsin",729,726,3,1381,55,22550
"Edgerton city, Wisconsin",3186,3037,149,5878,55,22575
"Edmund CDP, Wisconsin",105,105,0,173,55,22700
"Egg Harbor village, Wisconsin",107,97,10,317,55,22850
"Eland village, Wisconsin",136,136,0,243,55,22975
"Elcho CDP, Wisconsin",87,75,12,199,55,23025
"Elderon village, Wisconsin",58,54,4,108,55,23075
"Eleva village, Wisconsin",383,365,18,744,55,23175
"Elkhart Lake village, Wisconsin",492,447,45,1170,55,23275
"Elkhorn city, Wisconsin",5980,5889,91,10253,55,23300
"Elk Mound village, Wisconsin",594,580,14,1092,55,23325
"Ellison Bay CDP, Wisconsin",76,76,0,142,55,23475
"Ellsworth village, Wisconsin",1727,1659,68,3323,55,23525
"Elm Grove village, Wisconsin",3075,3047,28,6445,55,23575
"Elmwood village, Wisconsin",294,288,6,683,55,23700
"Elmwood Park village, Wisconsin",166,159,7,533,55,23725
"Elroy city, Wisconsin",716,709,7,1543,55,23800
"Embarrass village, Wisconsin",163,161,2,506,55,23850
"Emerald CDP, Wisconsin",70,70,0,147,55,23900
"Endeavor village, Wisconsin",293,280,13,529,55,24075
"Ephraim village, Wisconsin",146,146,0,307,55,24150
"Ettrick village, Wisconsin",336,333,3,660,55,24400
"Eureka CDP, Wisconsin",151,151,0,280,55,24475
"Evansville city, Wisconsin",3346,3275,71,5720,55,24550
"Exeland village, Wisconsin",86,85,1,173,55,24700
"Fairchild village, Wisconsin",246,220,26,505,55,24825
"Fairwater village, Wisconsin",177,173,4,339,55,25075
"Fall Creek village, Wisconsin",872,848,24,1459,55,25125
"Fall River village, Wisconsin",921,893,28,1708,55,25150
"Fennimore city, Wisconsin",1454,1425,29,2746,55,25600
"Fenwood village, Wisconsin",83,73,10,148,55,25650
"Ferryville village, Wisconsin",84,79,5,173,55,25725
"Fitchburg city, Wisconsin",17882,17634,248,29826,55,25950
"Florence CDP, Wisconsin",163,136,27,477,55,26175
"Fond du Lac city, Wisconsin",22988,21855,1133,44527,55,26275
"Fontana-on-Geneva Lake village, Wisconsin",765,736,29,1545,55,26350
"Footville village, Wisconsin",470,456,14,939,55,26400
"Forest Junction CDP, Wisconsin",470,467,3,690,55,26575
"Forestville village, Wisconsin",282,274,8,558,55,26625
"Fort Atkinson city, Wisconsin",7531,7300,231,12522,55,26675
"Fountain City city, Wisconsin",458,453,5,734,55,26850
"Fox Crossing village, Wisconsin",10535,10396,139,18949,55,26982
"Fox Lake city, Wisconsin",1033,1021,12,1792,55,27000
"Fox Point village, Wisconsin",3363,3348,15,6811,55,27075
"Francis Creek village, Wisconsin",258,255,3,687,55,27125
"Franklin city, Wisconsin",18034,17426,608,36513,55,27300
"Franks Field CDP, Wisconsin",49,44,5,108,55,27412
"Frederic village, Wisconsin",552,531,21,1101,55,27500
"Fredonia village, Wisconsin",1497,1437,60,2446,55,27550
"Fremont village, Wisconsin",313,313,0,636,55,27800
"French Island CDP, Wisconsin",2376,2224,152,4266,55,27875
"Friendship village, Wisconsin",260,258,2,639,55,27950
"Friesland village, Wisconsin",139,130,9,261,55,28000
"Fulton CDP, Wisconsin",0,0,0,37,55,28050
"Galesville city, Wisconsin",916,913,3,1582,55,28200
"Gays Mills village, Wisconsin",227,210,17,549,55,28450
"Genoa village, Wisconsin",134,131,3,269,55,28625
"Genoa City village, Wisconsin",1663,1582,81,2975,55,28675
"Germantown village, Wisconsin",11776,11501,275,20885,55,28875
"Gibbsville CDP, Wisconsin",327,327,0,526,55,28925
"Gillett city, Wisconsin",656,633,23,1324,55,29050
"Gilman village, Wisconsin",217,213,4,469,55,29175
"Gilmanton CDP, Wisconsin",82,75,7,142,55,29200
"Glenbeulah village, Wisconsin",270,269,1,409,55,29350
"Glendale city, Wisconsin",6588,6317,271,13227,55,29400
"Glen Flora village, Wisconsin",39,36,3,85,55,29475
"Glen Haven CDP, Wisconsin",10,10,0,41,55,29500
"Glenwood City city, Wisconsin",620,587,33,1207,55,29625
"Glidden CDP, Wisconsin",90,90,0,203,55,29675
"Goodman CDP, Wisconsin",60,60,0,200,55,29750
"Gordon CDP, Wisconsin",45,45,0,97,55,29900
"Gotham CDP, Wisconsin",97,89,8,175,55,29950
"Grafton village, Wisconsin",7281,7136,145,12160,55,30000
"Grand Marsh CDP, Wisconsin",68,68,0,131,55,30100
"Grand View CDP, Wisconsin",32,32,0,102,55,30150
"Granton village, Wisconsin",192,179,13,376,55,30425
"Grantsburg village, Wisconsin",633,607,26,1385,55,30450
"Gratiot village, Wisconsin",102,95,7,186,55,30575
"Green Bay city, Wisconsin",56847,54516,2331,106846,55,31000
"Greenbush CDP, Wisconsin",110,108,2,137,55,31075
"Greendale village, Wisconsin",7394,7206,188,14722,55,31125
"Greenfield city, Wisconsin",20599,19887,712,37521,55,31175
"Green Lake city, Wisconsin",477,458,19,1000,55,31300
"Greenleaf CDP, Wisconsin",505,485,20,867,55,31375
"Green Valley CDP, Wisconsin",41,35,6,59,55,31475
"Greenville village, Wisconsin",5603,5491,112,10130,55,31525
"Greenwood city, Wisconsin",587,573,14,1043,55,31575
"Gresham village, Wisconsin",218,213,5,593,55,31675
"Hager City CDP, Wisconsin",142,139,3,227,55,31975
"Hales Corners village, Wisconsin",4228,4123,105,7677,55,32075
"Hammond village, Wisconsin",1040,974,66,2015,55,32325
"Hancock village, Wisconsin",158,141,17,413,55,32450
"Hanover CDP, Wisconsin",96,96,0,151,55,32550
"Harrison village, Wisconsin",7355,7154,201,12872,55,32790
"Harrisville CDP, Wisconsin",44,44,0,133,55,32950
"Hartford city, Wisconsin",8806,8525,281,15667,55,33000
"Hartland village, Wisconsin",5207,4960,247,9599,55,33100
"Hatfield CDP, Wisconsin",67,65,2,175,55,33150
"Hatley village, Wisconsin",316,314,2,549,55,33175
"Haugen village, Wisconsin",161,157,4,275,55,33225
"Hawkins village, Wisconsin",139,134,5,352,55,33275
"Hayward city, Wisconsin",1221,1155,66,2526,55,33450
"Hazel Green village, Wisconsin",555,542,13,1025,55,33500
"Hebron CDP, Wisconsin",165,165,0,338,55,33675
"Helenville CDP, Wisconsin",128,119,9,177,55,33825
"Herbster CDP, Wisconsin",61,61,0,107,55,33975
"Hewitt village, Wisconsin",454,449,5,844,55,34250
"Highland village, Wisconsin",443,443,0,875,55,34450
"Hilbert village, Wisconsin",565,552,13,1108,55,34575
"Hillsboro city, Wisconsin",637,603,34,1318,55,34825
"Hingham CDP, Wisconsin",486,482,4,855,55,35000
"Hixton village, Wisconsin",288,263,25,424,55,35075
"Hobart village, Wisconsin",5977,5968,9,10130,55,35150
"Holcombe CDP, Wisconsin",117,111,6,199,55,35225
"Hollandale village, Wisconsin",244,242,2,329,55,35400
"Holmen village, Wisconsin",5845,5742,103,10806,55,35450
"Horicon city, Wisconsin",2024,1924,100,3793,55,35750
"Hortonville village, Wisconsin",1806,1792,14,3110,55,35850
"Houlton CDP, Wisconsin",54,54,0,109,55,35900
"Howard village, Wisconsin",11355,11079,276,20022,55,35950
"Howards Grove village, Wisconsin",1773,1763,10,3241,55,36025
"Hudson city, Wisconsin",8365,8287,78,14763,55,36250
"Humbird CDP, Wisconsin",133,127,6,315,55,36400
"Hurley city, Wisconsin",634,595,39,1405,55,36525
"Hustisford village, Wisconsin",614,590,24,1094,55,36625
"Hustler village, Wisconsin",95,95,0,168,55,36675
"Independence city, Wisconsin",596,572,24,1267,55,36800
"Ingram village, Wisconsin",22,22,0,52,55,36925
"Iola village, Wisconsin",513,485,28,1148,55,37025
"Iron Belt CDP, Wisconsin",76,74,2,174,55,37125
"Iron Ridge village, Wisconsin",643,606,37,998,55,37150
"Iron River CDP, Wisconsin",294,283,11,699,55,37175
"Ironton village, Wisconsin",149,140,9,307,55,37225
"Ixonia CDP, Wisconsin",1218,1190,28,2064,55,37575
"Jackson village, Wisconsin",4779,4495,284,7814,55,37675
"Janesville city, Wisconsin",34628,33202,1426,65669,55,37825
"Jefferson city, Wisconsin",4258,4041,217,7778,55,37900
"Jim Falls CDP, Wisconsin",131,131,0,219,55,38225
"Johnson Creek village, Wisconsin",1942,1901,41,3337,55,38350
"Jolmaville CDP, Wisconsin",51,34,17,103,55,38487
"Juda CDP, Wisconsin",213,208,5,373,55,38600
"Jump River CDP, Wisconsin",8,7,1,55,55,38625
"Junction City village, Wisconsin",162,162,0,317,55,38650
"Juneau city, Wisconsin",1307,1246,61,2636,55,38675
"Kaukauna city, Wisconsin",9928,9714,214,17111,55,38800
"Kekoskee village, Wisconsin",611,560,51,975,55,38900
"Kellnersville village, Wisconsin",132,129,3,255,55,39000
"Kendall village, Wisconsin",191,185,6,388,55,39150
"Kennan village, Wisconsin",60,55,5,138,55,39175
"Kenosha city, Wisconsin",53141,50291,2850,99493,55,39225
"Keshena CDP, Wisconsin",510,467,43,1424,55,39250
"Kewaskum village, Wisconsin",2352,2224,128,4335,55,39300
"Kewaunee city, Wisconsin",1557,1553,4,2819,55,39350
"Kiel city, Wisconsin",2183,2136,47,3878,55,39525
"Kieler CDP, Wisconsin",246,230,16,420,55,39550
"Kimberly village, Wisconsin",3511,3332,179,7331,55,39650
"King CDP, Wisconsin",688,673,15,1703,55,39700
"Kingston village, Wisconsin",136,130,6,316,55,39750
"Knapp village, Wisconsin",277,262,15,544,55,39975
"Knowlton CDP, Wisconsin",30,30,0,62,55,40125
"Kohler village, Wisconsin",1088,1044,44,2142,55,40275
"Krakow CDP, Wisconsin",175,175,0,320,55,40450
"Kronenwetter village, Wisconsin",4940,4873,67,8335,55,40550
"Lac du Flambeau CDP, Wisconsin",770,687,83,1755,55,40675
"Lac La Belle village, Wisconsin",137,134,3,252,55,40750
"La Crosse city, Wisconsin",28981,27957,1024,52043,55,40775
"Ladysmith city, Wisconsin",1698,1557,141,3192,55,40850
"La Farge village, Wisconsin",287,268,19,750,55,40875
"Lake Arrowhead CDP, Wisconsin",343,335,8,866,55,41160
"Lake Camelot CDP, Wisconsin",378,378,0,1148,55,41210
"Lake Delton village, Wisconsin",2171,2136,35,3475,55,41300
"Lake Geneva city, Wisconsin",4572,4403,169,8335,55,41450
"Lake Hallie village, Wisconsin",4109,4080,29,7178,55,41525
"Lake Ivanhoe CDP, Wisconsin",339,329,10,538,55,41560
"Lake Koshkonong CDP, Wisconsin",556,551,5,995,55,41583
"Lake Lorraine CDP, Wisconsin",201,195,6,290,55,41645
"Lake Mills city, Wisconsin",3676,3658,18,6280,55,41675
"Lake Nebagamon village, Wisconsin",439,424,15,960,55,41725
"Lake Ripley CDP, Wisconsin",1145,1062,83,1982,55,41765
"Lake Sherwood CDP, Wisconsin",217,199,18,378,55,41772
"Lake Tomahawk CDP, Wisconsin",92,85,7,173,55,41875
"Lake Wazeecha CDP, Wisconsin",1216,1184,32,2682,55,41975
"Lake Wisconsin CDP, Wisconsin",2426,2379,47,4886,55,42012
"Lake Wissota CDP, Wisconsin",1738,1629,109,3001,55,42025
"Lakewood CDP, Wisconsin",151,133,18,278,55,42050
"Lancaster city, Wisconsin",2342,2308,34,3917,55,42250
"Lannon village, Wisconsin",878,864,14,1351,55,42450
"Laona CDP, Wisconsin",225,212,13,547,55,42475
"Lauderdale Lakes CDP, Wisconsin",724,711,13,1584,55,42805
"La Valle village, Wisconsin",205,197,8,339,55,42825
"Lebanon CDP, Wisconsin",34,32,2,134,55,43025
"Legend Lake CDP, Wisconsin",528,472,56,1530,55,43207
"Lena village, Wisconsin",317,286,31,572,55,43325
"Leopolis CDP, Wisconsin",30,30,0,51,55,43575
"Lewis CDP, Wisconsin",70,70,0,157,55,43725
"Lily Lake CDP, Wisconsin",354,354,0,593,55,44033
"Lime Ridge village, Wisconsin",102,102,0,186,55,44225
"Linden village, Wisconsin",253,247,6,557,55,44625
"Little Chute village, Wisconsin",6588,6420,168,11798,55,44950
"Little Round Lake CDP, Wisconsin",412,370,42,1026,55,45220
"Little Sturgeon CDP, Wisconsin",33,30,3,114,55,45225
"Livingston village, Wisconsin",259,254,5,493,55,45325
"Lodi city, Wisconsin",1870,1794,76,3196,55,45350
"Loganville village, Wisconsin",144,132,12,236,55,45400
"Lohrville village, Wisconsin",218,203,15,502,55,45425
"Lomira village, Wisconsin",1469,1465,4,2674,55,45475
"Lone Rock village, Wisconsin",445,437,8,834,55,45575
"Long Lake CDP, Wisconsin",37,37,0,46,55,45600
"Lowell village, Wisconsin",164,157,7,279,55,45950
"Loyal city, Wisconsin",686,683,3,1328,55,46075
"Lublin village, Wisconsin",57,57,0,105,55,46150
"Luck village, Wisconsin",631,619,12,1214,55,46200
"Luxemburg village, Wisconsin",1528,1506,22,2686,55,46400
"Lyndon Station village, Wisconsin",380,352,28,802,55,46600
"Lynxville village, Wisconsin",55,54,1,131,55,46675
"Lyons CDP, Wisconsin",537,519,18,1175,55,46700
"McFarland village, Wisconsin",5338,5124,214,9104,55,46850
"Madison city, Wisconsin",160915,156757,4158,268516,55,48000
"Maiden Rock village, Wisconsin",56,55,1,96,55,48175
"Maine village, Wisconsin",1514,1483,31,2608,55,48225
"Manawa city, Wisconsin",633,610,23,1238,55,48350
"Manitowoc city, Wisconsin",16663,16196,467,34500,55,48500
"Maple Bluff village, Wisconsin",670,661,9,1327,55,48750
"Marathon City village, Wisconsin",760,745,15,1398,55,49100
"Marengo CDP, Wisconsin",66,66,0,146,55,49175
"Maribel village, Wisconsin",216,214,2,379,55,49250
"Marinette city, Wisconsin",5614,5423,191,11065,55,49300
"Marion city, Wisconsin",595,578,17,1110,55,49400
"Markesan city, Wisconsin",552,526,26,1292,55,49450
"Marquette village, Wisconsin",96,90,6,357,55,49500
"Marshall village, Wisconsin",2485,2387,98,3818,55,49575
"Marshfield city, Wisconsin",9369,9088,281,18795,55,49675
"Mason village, Wisconsin",36,33,3,78,55,49900
"Mattoon village, Wisconsin",224,221,3,475,55,50000
"Mauston city, Wisconsin",2101,2053,48,4311,55,50025
"Mayville city, Wisconsin",2646,2477,169,5176,55,50200
"Mazomanie village, Wisconsin",933,921,12,1765,55,50225
"Medford city, Wisconsin",2223,2123,100,4317,55,50425
"Mellen city, Wisconsin",264,259,5,567,55,50700
"Melrose village, Wisconsin",324,313,11,596,55,50750
"Melvina village, Wisconsin",60,60,0,91,55,50800
"Menasha city, Wisconsin",10308,9973,335,18125,55,50825
"Menomonee Falls village, Wisconsin",20681,20239,442,38610,55,51000
"Menomonie city, Wisconsin",9576,9235,341,16563,55,51025
"Mequon city, Wisconsin",12510,12309,201,25102,55,51150
"Mercer CDP, Wisconsin",285,274,11,533,55,51175
"Merrill city, Wisconsin",4846,4611,235,9266,55,51250
"Merrillan village, Wisconsin",263,213,50,583,55,51300
"Merrimac village, Wisconsin",306,300,6,594,55,51325
"Merton village, Wisconsin",2049,1984,65,3463,55,51375
"Middleton city, Wisconsin",12338,12054,284,21864,55,51575
"Middle Village CDP, Wisconsin",64,60,4,173,55,51617
"Milladore village, Wisconsin",266,196,70,415,55,51875
"Millston CDP, Wisconsin",74,67,7,139,55,52025
"Milltown village, Wisconsin",434,417,17,809,55,52075
"Milton city, Wisconsin",3197,3170,27,5692,55,52200
"Milwaukee city, Wisconsin",282177,265657,16520,573299,55,53000
"Mindoro CDP, Wisconsin",177,172,5,348,55,53050
"Mineral Point city, Wisconsin",1377,1353,24,2569,55,53100
"Minocqua CDP, Wisconsin",225,225,0,439,55,53200
"Minong village, Wisconsin",230,223,7,611,55,53250
"Mishicot village, Wisconsin",770,767,3,1449,55,53325
"Mission CDP, Wisconsin",159,120,39,369,55,53358
"Mole Lake CDP, Wisconsin",203,182,21,525,55,53500
"Mondovi city, Wisconsin",1417,1382,35,2832,55,53600
"Monona city, Wisconsin",4610,4497,113,8592,55,53675
"Monroe city, Wisconsin",5669,5466,203,10622,55,53750
"Montello city, Wisconsin",556,513,43,1405,55,53875
"Montfort village, Wisconsin",309,306,3,587,55,53950
"Monticello village, Wisconsin",626,621,5,1135,55,54000
"Montreal city, Wisconsin",398,386,12,768,55,54075
"Mosinee city, Wisconsin",2667,2665,2,4467,55,54500
"Mountain CDP, Wisconsin",116,115,1,262,55,54625
"Mount Calvary village, Wisconsin",364,345,19,675,55,54650
"Mount Hope village, Wisconsin",118,115,3,223,55,54675
"Mount Horeb village, Wisconsin",4337,4250,87,7717,55,54725
"Mount Pleasant village, Wisconsin",14125,13700,425,27640,55,54875
"Mount Sterling village, Wisconsin",82,82,0,183,55,54900
"Mukwonago village, Wisconsin",4992,4748,244,8311,55,55050
"Muscoda village, Wisconsin",637,601,36,1194,55,55200
"Muskego city, Wisconsin",14033,13544,489,25073,55,55275
"Nashotah village, Wisconsin",707,700,7,1216,55,55550
"Navarino CDP, Wisconsin",66,65,1,142,55,55650
"Necedah village, Wisconsin",579,519,60,1124,55,55700
"Neenah city, Wisconsin",14777,14378,399,27309,55,55750
"Neillsville city, Wisconsin",1111,1071,40,2311,55,55800
"Nekoosa city, Wisconsin",1072,1015,57,2489,55,55875
"Nelson village, Wisconsin",154,154,0,341,55,55950
"Nelsonville village, Wisconsin",102,100,2,180,55,56000
"Neopit CDP, Wisconsin",216,197,19,685,55,56050
"Neosho village, Wisconsin",356,342,14,605,55,56075
"Neshkoro village, Wisconsin",132,126,6,418,55,56125
"Newald CDP, Wisconsin",37,35,2,114,55,56250
"New Auburn village, Wisconsin",294,279,15,568,55,56350
"New Berlin city, Wisconsin",21511,20946,565,40387,55,56375
"Newburg village, Wisconsin",742,716,26,1306,55,56450
"New Glarus village, Wisconsin",1250,1180,70,2360,55,56700
"New Holstein city, Wisconsin",1841,1802,39,3141,55,56800
"New Lisbon city, Wisconsin",640,574,66,1688,55,56900
"New London city, Wisconsin",3498,3464,34,7342,55,56925
"New Munster CDP, Wisconsin",121,121,0,235,55,57000
"New Odanah CDP, Wisconsin",207,180,27,362,55,57008
"New Post CDP, Wisconsin",135,86,49,299,55,57050
"New Richmond city, Wisconsin",5763,5636,127,10158,55,57100
"Niagara city, Wisconsin",668,627,41,1423,55,57325
"Nichols village, Wisconsin",149,148,1,251,55,57375
"North Bay village, Wisconsin",83,83,0,227,55,57700
"North Fond du Lac village, Wisconsin",2946,2817,129,5372,55,58000
"North Freedom village, Wisconsin",414,409,5,693,55,58025
"North Hudson village, Wisconsin",2199,2151,48,3837,55,58050
"North Lake CDP, Wisconsin",79,79,0,209,55,58100
"Northport CDP, Wisconsin",241,229,12,426,55,58375
"North Prairie village, Wisconsin",1369,1360,9,2485,55,58400
"Norwalk village, Wisconsin",290,282,8,658,55,58575
"Oak Creek city, Wisconsin",21309,21019,290,36286,55,58800
"Oakdale village, Wisconsin",158,156,2,259,55,58850
"Oakfield village, Wisconsin",686,675,11,1218,55,58900
"Oconomowoc city, Wisconsin",9960,9739,221,18178,55,59250
"Oconomowoc Lake village, Wisconsin",424,415,9,691,55,59300
"Oconto city, Wisconsin",2287,2250,37,4586,55,59350
"Oconto Falls city, Wisconsin",1374,1364,10,2959,55,59400
"Odanah CDP, Wisconsin",24,11,13,63,55,59450
"Ogdensburg village, Wisconsin",100,99,1,176,55,59475
"Ogema CDP, Wisconsin",125,125,0,233,55,59500
"Okauchee Lake CDP, Wisconsin",2611,2571,40,4690,55,59650
"Oliver village, Wisconsin",168,167,1,332,55,59800
"Omro city, Wisconsin",1976,1942,34,3639,55,59875
"Onalaska city, Wisconsin",10224,9904,320,18837,55,59925
"Ontario village, Wisconsin",182,180,2,415,55,60075
"Oostburg village, Wisconsin",1581,1525,56,3066,55,60100
"Oregon village, Wisconsin",6274,6178,96,11240,55,60200
"Orfordville village, Wisconsin",726,702,24,1523,55,60250
"Osceola village, Wisconsin",1478,1348,130,2785,55,60450
"Oshkosh city, Wisconsin",35947,34889,1058,66373,55,60500
"Osseo city, Wisconsin",929,916,13,1720,55,60575
"Owen city, Wisconsin",500,483,17,972,55,60825
"Oxford village, Wisconsin",283,268,15,511,55,60875
"Paac Ciinak CDP, Wisconsin",29,23,6,66,55,60912
"Packwaukee CDP, Wisconsin",68,68,0,208,55,60950
"Paddock Lake village, Wisconsin",1797,1744,53,2966,55,60975
"Palmyra village, Wisconsin",1217,1175,42,2097,55,61025
"Pardeeville village, Wisconsin",987,975,12,1794,55,61100
"Park Falls city, Wisconsin",918,893,25,2389,55,61200
"Park Ridge village, Wisconsin",209,198,11,479,55,61325
"Patch Grove village, Wisconsin",146,146,0,225,55,61425
"Pella CDP, Wisconsin",49,44,5,96,55,61675
"Pembine CDP, Wisconsin",59,59,0,223,55,61750
"Pence CDP, Wisconsin",35,33,2,121,55,61800
"Pepin village, Wisconsin",398,386,12,823,55,61925
"Peshtigo city, Wisconsin",1722,1691,31,3414,55,62175
"Pewaukee city, Wisconsin",8337,8123,214,15817,55,62240
"Pewaukee village, Wisconsin",4851,4744,107,8227,55,62250
"Phillips city, Wisconsin",608,581,27,1578,55,62450
"Pigeon Falls village, Wisconsin",153,151,2,334,55,62675
"Pine River CDP, Wisconsin",69,69,0,130,55,62975
"Pittsville city, Wisconsin",491,480,11,882,55,63100
"Plain village, Wisconsin",439,426,13,722,55,63125
"Plainfield village, Wisconsin",488,449,39,1008,55,63150
"Platteville city, Wisconsin",6673,6391,282,11543,55,63250
"Pleasant Prairie village, Wisconsin",11507,10971,536,21373,55,63300
"Plover village, Wisconsin",7027,6869,158,13549,55,63525
"Plum City village, Wisconsin",265,261,4,593,55,63600
"Plymouth city, Wisconsin",4541,4308,233,8907,55,63700
"Polonia CDP, Wisconsin",448,437,11,665,55,63925
"Poplar village, Wisconsin",265,242,23,591,55,63975
"Portage city, Wisconsin",5311,4945,366,10450,55,64100
"Port Edwards village, Wisconsin",745,724,21,1818,55,64175
"Port Washington city, Wisconsin",6629,6421,208,12446,55,64450
"Port Wing CDP, Wisconsin",89,86,3,172,55,64500
"Post Lake CDP, Wisconsin",122,116,6,279,55,64550
"Potosi village, Wisconsin",302,296,6,568,55,64625
"Potter village, Wisconsin",135,134,1,229,55,64675
"Potter Lake CDP, Wisconsin",452,452,0,879,55,64700
"Pound village, Wisconsin",183,181,2,313,55,64750
"Powers Lake CDP, Wisconsin",914,869,45,1381,55,64825
"Poynette village, Wisconsin",1500,1500,0,2585,55,64900
"Poy Sippi CDP, Wisconsin",139,133,6,390,55,64950
"Prairie du Chien city, Wisconsin",2438,2399,39,5502,55,65050
"Prairie du Sac village, Wisconsin",2475,2440,35,4392,55,65100
"Prairie Farm village, Wisconsin",288,286,2,506,55,65150
"Prentice village, Wisconsin",207,201,6,465,55,65325
"Prescott city, Wisconsin",2393,2358,35,4343,55,65375
"Princeton city, Wisconsin",638,574,64,1106,55,65600
"Pulaski village, Wisconsin",1718,1718,0,3861,55,65675
"Pulcifer CDP, Wisconsin",76,76,0,133,55,65725
"Racine city, Wisconsin",38012,35740,2272,77453,55,66000
"Radisson village, Wisconsin",84,74,10,254,55,66050
"Randolph village, Wisconsin",717,687,30,1509,55,66150
"Random Lake village, Wisconsin",839,787,52,1580,55,66200
"Raymond village, Wisconsin",2073,2043,30,3916,55,66350
"Readstown village, Wisconsin",166,153,13,400,55,66450
"Redgranite village, Wisconsin",630,614,16,2045,55,66625
"Reedsburg city, Wisconsin",5002,4895,107,10019,55,66800
"Reedsville village, Wisconsin",540,534,6,1166,55,66875
"Reeseville village, Wisconsin",408,371,37,826,55,66900
"Reserve CDP, Wisconsin",137,119,18,323,55,67050
"Rewey village, Wisconsin",130,116,14,247,55,67100
"Rhinelander city, Wisconsin",3627,3562,65,8236,55,67200
"Rib Lake village, Wisconsin",368,361,7,903,55,67275
"Rib Mountain CDP, Wisconsin",2772,2606,166,6153,55,67320
"Rice Lake city, Wisconsin",4339,4107,232,8990,55,67350
"Richfield village, Wisconsin",6758,6692,66,11757,55,67475
"Richland Center city, Wisconsin",2610,2563,47,5058,55,67625
"Ridgeland village, Wisconsin",104,99,5,250,55,67800
"Ridgeway village, Wisconsin",399,391,8,626,55,67875
"Rio village, Wisconsin",597,583,14,998,55,68100
"Ripon city, Wisconsin",3932,3832,100,7823,55,68175
"River Falls city, Wisconsin",9472,9164,308,16165,55,68275
"River Hills village, Wisconsin",702,692,10,1530,55,68325
"Roberts village, Wisconsin",1147,1139,8,1969,55,68475
"Rochester village, Wisconsin",2304,2288,16,3776,55,68550
"Rockdale village, Wisconsin",119,118,1,186,55,68725
"Rock Falls CDP, Wisconsin",106,106,0,189,55,68800
"Rockland village, Wisconsin",265,247,18,669,55,68900
"Rock Springs village, Wisconsin",200,194,6,330,55,68975
"Rome CDP, Wisconsin",297,297,0,582,55,69300
"Rosendale village, Wisconsin",577,556,21,1006,55,69525
"Rosholt village, Wisconsin",223,221,2,475,55,69575
"Rothschild village, Wisconsin",2869,2846,23,5537,55,69725
"Rubicon CDP, Wisconsin",74,74,0,119,55,69950
"Rudolph village, Wisconsin",222,217,5,448,55,70000
"St. Cloud village, Wisconsin",256,246,10,449,55,70500
"St. Croix Falls city, Wisconsin",1159,1112,47,2268,55,70550
"St. Francis city, Wisconsin",4588,4544,44,9288,55,70650
"St. Joseph CDP, Wisconsin",271,266,5,506,55,70800
"St. Nazianz village, Wisconsin",413,406,7,857,55,71025
"St. Peter CDP, Wisconsin",734,725,9,1365,55,71050
"Salem Lakes village, Wisconsin",8360,8008,352,14569,55,71163
"Sand Pillow CDP, Wisconsin",71,63,8,245,55,71512
"Sandy Hook CDP, Wisconsin",185,177,8,261,55,71585
"Sauk City village, Wisconsin",1923,1903,20,3506,55,71650
"Saukville village, Wisconsin",2503,2503,0,4274,55,71700
"Saxon CDP, Wisconsin",27,27,0,58,55,71850
"Sayner CDP, Wisconsin",82,82,0,169,55,71950
"Scandinavia village, Wisconsin",181,179,2,365,55,71975
"Schofield city, Wisconsin",1318,1240,78,2256,55,72150
"Seneca CDP, Wisconsin",122,117,5,302,55,72475
"Sextonville CDP, Wisconsin",200,200,0,397,55,72650
"Seymour CDP, Wisconsin",819,812,7,1356,55,72670
"Seymour city, Wisconsin",2292,2205,87,3534,55,72725
"Sharon village, Wisconsin",919,871,48,1601,55,72875
"Shawano city, Wisconsin",4311,4187,124,9212,55,72925
"Sheboygan city, Wisconsin",26526,25629,897,49805,55,72975
"Sheboygan Falls city, Wisconsin",4553,4488,65,8163,55,73025
"Sheldon village, Wisconsin",78,73,5,249,55,73175
"Shell Lake city, Wisconsin",641,620,21,1664,55,73200
"Sherwood village, Wisconsin",1911,1890,21,3224,55,73525
"Shiocton village, Wisconsin",485,472,13,886,55,73625
"Shopiere CDP, Wisconsin",112,112,0,193,55,73675
"Shorewood village, Wisconsin",8008,7703,305,13707,55,73725
"Shorewood Hills village, Wisconsin",1056,1039,17,2085,55,73750
"Shullsburg city, Wisconsin",557,519,38,1218,55,73825
"Siren village, Wisconsin",276,252,24,710,55,74175
"Sister Bay village, Wisconsin",376,366,10,951,55,74225
"Slinger village, Wisconsin",3645,3447,198,6055,55,74400
"Sobieski CDP, Wisconsin",101,101,0,276,55,74500
"Soldiers Grove village, Wisconsin",215,210,5,547,55,74550
"Solon Springs village, Wisconsin",378,351,27,768,55,74575
"Somers village, Wisconsin",4322,3895,427,8303,55,74625
"Somerset village, Wisconsin",1673,1601,72,3034,55,74675
"South Milwaukee city, Wisconsin",10800,10422,378,20678,55,75125
"South Wayne village, Wisconsin",235,221,14,422,55,75275
"Sparta city, Wisconsin",5326,5134,192,9943,55,75325
"Spencer village, Wisconsin",935,928,7,1669,55,75400
"Spooner city, Wisconsin",902,847,55,2062,55,75625
"Springbrook CDP, Wisconsin",37,37,0,74,55,75775
"Springfield CDP, Wisconsin",86,86,0,159,55,75975
"Spring Green village, Wisconsin",823,808,15,1538,55,76025
"Spring Valley village, Wisconsin",698,660,38,1284,55,76300
"Stanley city, Wisconsin",1015,990,25,3772,55,76625
"Star Prairie village, Wisconsin",365,352,13,602,55,76825
"Stetsonville village, Wisconsin",301,285,16,632,55,77100
"Steuben village, Wisconsin",63,61,2,147,55,77175
"Stevens Point city, Wisconsin",15747,14970,777,25549,55,77200
"Stockbridge village, Wisconsin",426,426,0,857,55,77400
"Stockholm village, Wisconsin",28,28,0,91,55,77475
"Stoddard village, Wisconsin",412,400,12,811,55,77550
"Stone Lake CDP, Wisconsin",42,42,0,83,55,77625
"Stoughton city, Wisconsin",6970,6800,170,13091,55,77675
"Stratford village, Wisconsin",834,819,15,1364,55,77750
"Strum village, Wisconsin",530,520,10,1194,55,77825
"Sturgeon Bay city, Wisconsin",5044,4790,254,9620,55,77875
"Sturtevant village, Wisconsin",2989,2742,247,6823,55,77925
"Suamico village, Wisconsin",6885,6710,175,12878,55,77975
"Sullivan village, Wisconsin",385,365,20,664,55,78175
"Summit village, Wisconsin",2354,2342,12,4914,55,78375
"Summit Lake CDP, Wisconsin",24,24,0,68,55,78425
"Sun Prairie city, Wisconsin",20353,20023,330,35847,55,78600
"Superior city, Wisconsin",14613,14077,536,26562,55,78650
"Superior village, Wisconsin",383,363,20,638,55,78660
"Suring village, Wisconsin",140,128,12,399,55,78725
"Sussex village, Wisconsin",6775,6530,245,11549,55,78750
"Tainter Lake CDP, Wisconsin",1442,1375,67,2789,55,78980
"Taycheedah CDP, Wisconsin",455,455,0,604,55,79100
"Taylor village, Wisconsin",206,197,9,363,55,79150
"Tennyson village, Wisconsin",194,190,4,374,55,79250
"Theresa village, Wisconsin",835,785,50,1379,55,79375
"Thiensville village, Wisconsin",1962,1940,22,3279,55,79475
"Thornton CDP, Wisconsin",30,30,0,44,55,79600
"Thorp city, Wisconsin",769,748,21,1753,55,79625
"Three Lakes CDP, Wisconsin",232,232,0,433,55,79675
"Tichigan CDP, Wisconsin",2933,2851,82,5060,55,79740
"Tigerton village, Wisconsin",304,280,24,679,55,79825
"Tilleda CDP, Wisconsin",29,29,0,59,55,79900
"Tomah city, Wisconsin",4908,4730,178,9527,55,80075
"Tomahawk city, Wisconsin",1644,1520,124,3413,55,80125
"Tony village, Wisconsin",53,52,1,127,55,80225
"Townsend CDP, Wisconsin",19,19,0,88,55,80300
"Trego CDP, Wisconsin",48,48,0,93,55,80425
"Trempealeau village, Wisconsin",958,938,20,1769,55,80475
"Tunnel City CDP, Wisconsin",57,57,0,128,55,81025
"Turtle Lake village, Wisconsin",442,438,4,942,55,81075
"Turtle Lake CDP, Wisconsin",133,130,3,268,55,81090
"Tustin CDP, Wisconsin",53,53,0,119,55,81150
"Twin Lakes village, Wisconsin",3447,3174,273,6341,55,81250
"Two Rivers city, Wisconsin",5827,5744,83,11252,55,81325
"Union Center village, Wisconsin",123,123,0,212,55,81725
"Union Grove village, Wisconsin",2691,2652,39,4916,55,81775
"Unity village, Wisconsin",234,217,17,408,55,81850
"Valders village, Wisconsin",473,467,6,880,55,82200
"Van Dyne CDP, Wisconsin",346,346,0,720,55,82450
"Vernon village, Wisconsin",3921,3845,76,7478,55,82575
"Verona city, Wisconsin",7788,7638,150,14040,55,82600
"Vesper village, Wisconsin",239,237,2,502,55,82650
"Viola village, Wisconsin",302,292,10,575,55,82900
"Viroqua city, Wisconsin",2347,2283,64,4493,55,82925
"Wabeno CDP, Wisconsin",85,81,4,243,55,83000
"Waldo village, Wisconsin",234,223,11,472,55,83100
"Wales village, Wisconsin",1491,1451,40,2880,55,83175
"Walworth village, Wisconsin",1468,1425,43,2778,55,83250
"Warrens village, Wisconsin",243,242,1,504,55,83450
"Washburn city, Wisconsin",1022,1001,21,1975,55,83525
"Waterford village, Wisconsin",3199,3125,74,5587,55,83825
"Waterloo city, Wisconsin",1968,1899,69,3511,55,83925
"Watertown city, Wisconsin",12790,12228,562,22978,55,83975
"Waubeka CDP, Wisconsin",345,318,27,528,55,84150
"Waukau CDP, Wisconsin",145,145,0,360,55,84200
"Waukesha city, Wisconsin",42547,41302,1245,70945,55,84250
"Waukesha village, Wisconsin",4966,4884,82,8480,55,84275
"Waumandee CDP, Wisconsin",38,36,2,71,55,84300
"Waunakee village, Wisconsin",7970,7867,103,14794,55,84350
"Waupaca city, Wisconsin",2862,2713,149,6294,55,84375
"Waupun city, Wisconsin",5347,5243,104,11109,55,84425
"Wausau city, Wisconsin",20604,19682,922,39906,55,84475
"Wausaukee village, Wisconsin",262,245,17,572,55,84525
"Wautoma city, Wisconsin",890,845,45,2003,55,84625
"Wauwatosa city, Wisconsin",25974,25397,577,47919,55,84675
"Wauzeka village, Wisconsin",361,338,23,727,55,84725
"Webster village, Wisconsin",286,286,0,665,55,85025
"West Allis city, Wisconsin",32572,31296,1276,59907,55,85300
"West Baraboo village, Wisconsin",969,932,37,1557,55,85325
"West Bend city, Wisconsin",17388,16775,613,31682,55,85350
"Westboro CDP, Wisconsin",96,94,2,234,55,85425
"Westby city, Wisconsin",1218,1187,31,2318,55,85475
"Westfield village, Wisconsin",677,664,13,1270,55,85575
"West Milwaukee village, Wisconsin",2198,2088,110,4096,55,85875
"Weston village, Wisconsin",9057,8691,366,15698,55,86025
"West Salem village, Wisconsin",2696,2631,65,5253,55,86275
"Weyauwega city, Wisconsin",951,946,5,1857,55,86400
"Weyerhaeuser village, Wisconsin",95,93,2,198,55,86450
"Wheeler village, Wisconsin",127,125,2,229,55,86575
"Whitefish Bay village, Wisconsin",7636,7394,242,14804,55,86700
"Whitehall city, Wisconsin",788,771,17,1565,55,86725
"White Lake village, Wisconsin",108,101,7,244,55,86750
"Whitelaw village, Wisconsin",490,465,25,871,55,86775
"Whitewater city, Wisconsin",9212,8889,323,15725,55,86925
"Whiting village, Wisconsin",712,687,25,1538,55,86975
"Whittlesey CDP, Wisconsin",47,44,3,95,55,87000
"Wild Rose village, Wisconsin",417,398,19,942,55,87075
"Williams Bay village, Wisconsin",1289,1236,53,2947,55,87200
"Wilson village, Wisconsin",139,124,15,224,55,87475
"Wilton village, Wisconsin",248,238,10,515,55,87525
"Winchester CDP, Wisconsin",321,318,3,632,55,87625
"Wind Lake CDP, Wisconsin",2946,2831,115,5094,55,87675
"Wind Point village, Wisconsin",842,827,15,1688,55,87700
"Windsor village, Wisconsin",5156,5051,105,8756,55,87725
"Winneconne village, Wisconsin",1321,1305,16,2520,55,87900
"Winter village, Wisconsin",136,132,4,277,55,87975
"Wiota CDP, Wisconsin",29,29,0,83,55,88025
"Wisconsin Dells city, Wisconsin",1556,1420,136,2703,55,88150
"Wisconsin Rapids city, Wisconsin",9488,8878,610,18783,55,88200
"Withee village, Wisconsin",320,267,53,511,55,88275
"Wittenberg village, Wisconsin",564,521,43,964,55,88325
"Wonewoc village, Wisconsin",314,304,10,706,55,88500
"Woodford CDP, Wisconsin",58,58,0,99,55,88675
"Woodman village, Wisconsin",143,61,82,219,55,88825
"Woodruff CDP, Wisconsin",335,335,0,628,55,88925
"Woodville village, Wisconsin",846,834,12,1537,55,89025
"Wrightstown village, Wisconsin",1808,1787,21,3196,55,89150
"Wyeville village, Wisconsin",43,42,1,116,55,89275
"Wyocena village, Wisconsin",363,361,2,673,55,89300
"Yorkville village, Wisconsin",1751,1630,121,3241,55,89550
"Yuba village, Wisconsin",32,32,0,44,55,89625
"Zoar CDP, Wisconsin",54,43,11,150,55,89760
"Afton town, Wyoming",1332,1248,84,2303,56,00245
"Albany CDP, Wyoming",4,4,0,16,56,00680
"Albin town, Wyoming",136,72,64,185,56,00825
"Alcova CDP, Wyoming",68,68,0,84,56,01115
"Alpine town, Wyoming",591,591,0,891,56,01695
"Alpine Northeast CDP, Wyoming",164,164,0,303,56,01888
"Alpine Northwest CDP, Wyoming",87,87,0,289,56,01936
"Alta CDP, Wyoming",353,353,0,581,56,01985
"Antelope Hills CDP, Wyoming",0,0,0,0,56,02877
"Arapahoe CDP, Wyoming",716,583,133,1596,56,03000
"Arlington CDP, Wyoming",1,1,0,1,56,03245
"Arrowhead Springs CDP, Wyoming",20,20,0,72,56,03652
"Arvada CDP, Wyoming",8,8,0,8,56,03725
"Atlantic City CDP, Wyoming",16,16,0,31,56,04015
"Auburn CDP, Wyoming",86,86,0,369,56,04160
"Baggs town, Wyoming",245,245,0,488,56,04740
"Bairoil town, Wyoming",52,44,8,162,56,04885
"Bar Nunn town, Wyoming",1500,1424,76,2945,56,05245
"Basin town, Wyoming",551,540,11,1275,56,05320
"Bear River town, Wyoming",399,390,9,873,56,05625
"Bedford CDP, Wyoming",142,142,0,225,56,06045
"Bessemer Bend CDP, Wyoming",67,67,0,118,56,06407
"Beulah CDP, Wyoming",0,0,0,0,56,06480
"Big Horn CDP, Wyoming",48,48,0,72,56,06770
"Big Piney town, Wyoming",223,206,17,450,56,07060
"Bondurant CDP, Wyoming",156,156,0,156,56,08365
"Boulder CDP, Wyoming",19,19,0,19,56,09235
"Boulder Flats CDP, Wyoming",216,183,33,513,56,09307
"Brookhurst CDP, Wyoming",41,41,0,91,56,10175
"Buffalo city, Wyoming",2007,1926,81,4475,56,10685
"Burlington town, Wyoming",119,114,5,249,56,11120
"Burns town, Wyoming",174,174,0,392,56,11265
"Byron town, Wyoming",227,218,9,549,56,11700
"Carpenter CDP, Wyoming",172,172,0,172,56,12860
"Carter CDP, Wyoming",0,0,0,0,56,13005
"Casper city, Wyoming",31439,30392,1047,58631,56,13150
"Casper Mountain CDP, Wyoming",320,320,0,671,56,13222
"Centennial CDP, Wyoming",98,98,0,345,56,13440
"Cheyenne city, Wyoming",33914,32765,1149,64795,56,13900
"Chugcreek CDP, Wyoming",5,5,0,87,56,14097
"Chugwater town, Wyoming",72,70,2,196,56,14165
"Clearmont town, Wyoming",40,40,0,99,56,15325
"Clearview Acres CDP, Wyoming",340,340,0,495,56,15400
"Cody city, Wyoming",5350,5185,165,10081,56,15760
"Cokeville town, Wyoming",191,178,13,423,56,15905
"Cora CDP, Wyoming",0,0,0,0,56,17210
"Cowley town, Wyoming",282,273,9,668,56,17645
"Crowheart CDP, Wyoming",117,106,11,174,56,18225
"Daniel CDP, Wyoming",93,93,0,158,56,18950
"Dayton town, Wyoming",443,440,3,871,56,19385
"Deaver town, Wyoming",76,71,5,142,56,19530
"Diamondville town, Wyoming",401,395,6,700,56,20110
"Dixon town, Wyoming",110,110,0,310,56,20690
"Douglas city, Wyoming",3269,3123,146,6356,56,21125
"Dubois town, Wyoming",381,360,21,778,56,21415
"East Thermopolis town, Wyoming",75,75,0,198,56,22720
"Eden CDP, Wyoming",156,156,0,236,56,23010
"Edgerton town, Wyoming",47,47,0,116,56,23155
"Elk Mountain town, Wyoming",52,52,0,91,56,24025
"El Rancho CDP, Wyoming",11,11,0,16,56,24350
"Encampment town, Wyoming",175,175,0,386,56,24750
"Esterbrook CDP, Wyoming",29,29,0,48,56,25185
"Ethete CDP, Wyoming",624,455,169,1471,56,25330
"Etna CDP, Wyoming",0,0,0,0,56,25475
"Evanston city, Wyoming",6069,5812,257,11801,56,25620
"Evansville town, Wyoming",1455,1377,78,2755,56,25765
"Fairview CDP, Wyoming",23,23,0,85,56,25910
"Farson CDP, Wyoming",116,116,0,217,56,26055
"Fontenelle CDP, Wyoming",19,19,0,37,56,27650
"Fort Bridger CDP, Wyoming",119,119,0,170,56,27940
"Fort Laramie town, Wyoming",76,75,1,151,56,28230
"Fort Washakie CDP, Wyoming",584,476,108,1481,56,28665
"Fox Farm-College CDP, Wyoming",2026,1987,39,4226,56,29300
"Fox Park CDP, Wyoming",7,7,0,7,56,29400
"Frannie town, Wyoming",83,78,5,213,56,29825
"Freedom CDP, Wyoming",80,80,0,186,56,30115
"Garland CDP, Wyoming",119,119,0,188,56,30985
"Gillette city, Wyoming",17487,16860,627,33158,56,31855
"Glendo town, Wyoming",95,91,4,209,56,32290
"Glenrock town, Wyoming",1465,1329,136,2863,56,32435
"Granger town, Wyoming",96,92,4,197,56,32870
"Green River city, Wyoming",5692,5344,348,11772,56,33740
"Greybull town, Wyoming",1014,891,123,2145,56,33885
"Grover CDP, Wyoming",451,451,0,1279,56,34030
"Guernsey town, Wyoming",350,347,3,985,56,34320
"Hanna town, Wyoming",321,278,43,734,56,35335
"Hartrandt CDP, Wyoming",656,570,86,903,56,35552
"Hartville town, Wyoming",21,21,0,58,56,35625
"Hawk Springs CDP, Wyoming",12,12,0,35,56,36060
"Hillsdale CDP, Wyoming",31,31,0,31,56,37510
"Hill View Heights CDP, Wyoming",94,80,14,217,56,37727
"Hoback CDP, Wyoming",1071,1058,13,1874,56,37945
"Homa Hills CDP, Wyoming",132,132,0,202,56,38307
"Hudson town, Wyoming",241,230,11,463,56,38960
"Hulett town, Wyoming",292,292,0,414,56,39105
"Huntley CDP, Wyoming",8,8,0,12,56,39250
"Hyattville CDP, Wyoming",0,0,0,46,56,39395
"Jackson town, Wyoming",7833,7769,64,10748,56,40120
"James Town CDP, Wyoming",267,267,0,508,56,40265
"Jeffrey City CDP, Wyoming",0,0,0,34,56,40555
"Johnstown CDP, Wyoming",123,117,6,231,56,40945
"Kaycee town, Wyoming",114,114,0,268,56,41353
"Kelly CDP, Wyoming",162,80,82,206,56,41860
"Kemmerer city, Wyoming",1209,1197,12,2640,56,42005
"Kirby town, Wyoming",20,12,8,47,56,42730
"La Barge town, Wyoming",143,111,32,259,56,43455
"LaGrange town, Wyoming",178,172,6,356,56,43745
"Lakeview North CDP, Wyoming",55,55,0,87,56,44252
"Lance Creek CDP, Wyoming",23,23,0,49,56,44615
"Lander city, Wyoming",3627,3472,155,7561,56,44760
"Laramie city, Wyoming",19519,18605,914,31735,56,45050
"Lingle town, Wyoming",216,212,4,351,56,46790
"Little America CDP, Wyoming",21,21,0,21,56,46935
"Lonetree CDP, Wyoming",0,0,0,10,56,47370
"Lost Springs town, Wyoming",2,2,0,2,56,47805
"Lovell town, Wyoming",965,937,28,2178,56,47950
"Lucerne CDP, Wyoming",231,231,0,596,56,48240
"Lusk town, Wyoming",669,607,62,1505,56,48530
"Lyman town, Wyoming",687,658,29,1736,56,48675
"McKinnon CDP, Wyoming",34,34,0,76,56,49400
"Mammoth CDP, Wyoming",69,69,0,69,56,49775
"Manderson town, Wyoming",84,83,1,121,56,49980
"Manville town, Wyoming",67,67,0,174,56,50270
"Marbleton town, Wyoming",522,454,68,1187,56,50415
"Meadow Acres CDP, Wyoming",77,76,1,107,56,51285
"Medicine Bow town, Wyoming",164,152,12,352,56,51575
"Meeteetse town, Wyoming",182,179,3,665,56,51720
"Midwest town, Wyoming",118,116,2,205,56,52445
"Mills town, Wyoming",2069,1942,127,4218,56,53460
"Moorcroft town, Wyoming",286,277,9,775,56,54185
"Moose Wilson Road CDP, Wyoming",584,564,20,1143,56,54402
"Mountain View CDP, Wyoming",0,0,0,0,56,55200
"Mountain View town, Wyoming",541,515,26,1114,56,55345
"Newcastle city, Wyoming",1492,1452,40,3380,56,56215
"Nordic CDP, Wyoming",132,132,0,132,56,56520
"North Rock Springs CDP, Wyoming",1524,1458,66,2529,56,56700
"Oakley CDP, Wyoming",62,62,0,113,56,57375
"Opal town, Wyoming",41,41,0,74,56,57810
"Orin CDP, Wyoming",60,60,0,91,56,58100
"Osage CDP, Wyoming",33,33,0,33,56,58680
"Osmond CDP, Wyoming",377,377,0,826,56,58970
"Owl Creek CDP, Wyoming",0,0,0,0,56,59332
"Parkman CDP, Wyoming",179,179,0,473,56,59985
"Pavillion town, Wyoming",116,111,5,290,56,60130
"Pine Bluffs town, Wyoming",580,576,4,1363,56,61435
"Pinedale town, Wyoming",965,965,0,1946,56,61580
"Pine Haven town, Wyoming",188,185,3,515,56,61610
"Point of Rocks CDP, Wyoming",68,68,0,68,56,62160
"Powder Horn CDP, Wyoming",488,488,0,1010,56,62269
"Powder River CDP, Wyoming",0,0,0,0,56,62305
"Powell city, Wyoming",3017,2825,192,6460,56,62450
"Purple Sage CDP, Wyoming",309,309,0,546,56,62812
"Rafter J Ranch CDP, Wyoming",769,769,0,1233,56,63100
"Ralston CDP, Wyoming",144,144,0,167,56,63465
"Ranchester town, Wyoming",512,504,8,967,56,63755
"Ranchettes CDP, Wyoming",2589,2546,43,5731,56,63800
"Rawlins city, Wyoming",3947,3667,280,8287,56,63900
"Red Butte CDP, Wyoming",260,260,0,758,56,64400
"Reliance CDP, Wyoming",79,40,39,79,56,65060
"Riverside town, Wyoming",6,6,0,36,56,66075
"Riverton city, Wyoming",5448,5062,386,10733,56,66220
"Robertson CDP, Wyoming",18,0,18,71,56,66655
"Rock River town, Wyoming",139,139,0,269,56,67090
"Rock Springs city, Wyoming",12715,12024,691,23361,56,67235
"Rolling Hills town, Wyoming",285,285,0,544,56,67440
"Ryan Park CDP, Wyoming",0,0,0,28,56,67670
"Saratoga town, Wyoming",852,852,0,1715,56,68685
"Shell CDP, Wyoming",0,0,0,0,56,69700
"Sheridan city, Wyoming",9512,9185,327,18807,56,69845
"Shoshoni town, Wyoming",276,260,16,640,56,70570
"Sinclair town, Wyoming",249,249,0,379,56,71150
"Slater CDP, Wyoming",0,0,0,54,56,71295
"Sleepy Hollow CDP, Wyoming",921,917,4,1390,56,71350
"Smoot CDP, Wyoming",334,252,82,503,56,71440
"South Greeley CDP, Wyoming",1766,1648,118,3787,56,71800
"South Park CDP, Wyoming",1094,1055,39,1899,56,71947
"Star Valley Ranch town, Wyoming",1019,1007,12,2231,56,73180
"Story CDP, Wyoming",629,629,0,983,56,73615
"Sundance town, Wyoming",495,495,0,1102,56,74195
"Superior town, Wyoming",104,104,0,220,56,74775
"Table Rock CDP, Wyoming",0,0,0,0,56,75355
"Taylor CDP, Wyoming",93,83,10,170,56,75572
"Ten Sleep town, Wyoming",90,90,0,236,56,75790
"Teton Village CDP, Wyoming",583,578,5,906,56,75935
"Thayne town, Wyoming",302,302,0,656,56,76370
"Thermopolis town, Wyoming",1271,1259,12,2722,56,76515
"Torrington city, Wyoming",2668,2536,132,6161,56,77530
"Turnerville CDP, Wyoming",250,250,0,328,56,78400
"Upton town, Wyoming",521,506,15,943,56,79125
"Urie CDP, Wyoming",21,21,0,154,56,79270
"Van Tassell town, Wyoming",14,14,0,17,56,79705
"Veteran CDP, Wyoming",0,0,0,0,56,80285
"Vista West CDP, Wyoming",349,349,0,817,56,80575
"Wamsutter town, Wyoming",174,162,12,251,56,81300
"Warren AFB CDP, Wyoming",617,544,73,2836,56,81640
"Washam CDP, Wyoming",0,0,0,47,56,81703
"Westview Circle CDP, Wyoming",49,49,0,62,56,82967
"Wheatland town, Wyoming",1594,1566,28,3575,56,83040
"Whiting CDP, Wyoming",0,0,0,75,56,83100
"Wilson CDP, Wyoming",753,753,0,1303,56,83765
"Woods Landing-Jelm CDP, Wyoming",92,92,0,182,56,84852
"Worland city, Wyoming",2559,2510,49,4812,56,84925
"Wright town, Wyoming",818,803,15,1509,56,85015
"Yoder town, Wyoming",37,35,2,112,56,86665
"Y-O Ranch CDP, Wyoming",161,100,61,313,56,86737
